代號,總成本,總損益(淨),獲利次數,損失次數,總交易次數,勝率%,平均報酬,平均持倉時間(日),平均帶寬
1101,1940,-5440,5,6,11,45.45,-0.0069181818181818155,26.363636363636363,0.13580510955351097
1102,1035,2215,3,2,5,60.0,0.012639999999999998,23.4,0.18413357998621688
1103,597,-5747,1,5,6,16.67,-0.045500000000000006,10.5,0.16802049831774868
1104,627,2823,2,3,5,40.0,0.021400000000000002,10.4,0.15746253241996877
1108,655,-215,5,5,10,50.0,0.006039999999999999,17.0,0.14804086495451343
1109,196,-66,1,2,3,33.33,-0.0018666666666666692,14.333333333333334,0.2544988928104281
1110,377,-1277,3,2,5,60.0,-0.0092,12.6,0.20833916246894688
1201,911,469,4,4,8,50.0,-0.0191125,18.125,0.2043606551531418
1203,768,-4418,3,2,5,60.0,-0.022439999999999998,13.2,0.18042641522285058
1210,1033,5817,4,3,7,57.14,0.03450000000000001,16.571428571428573,0.15583486318058
1213,901,-551,2,5,7,28.57,-0.0011714285714285752,13.0,0.18257767077230297
1215,958,342,5,5,10,50.0,-0.0026499999999999996,18.2,0.19942823308563665
1216,3268,-10318,8,9,17,47.06,-0.010358823529411766,18.0,0.16492478215028475
1217,777,2063,9,3,12,75.0,0.031375,16.583333333333332,0.17096984120827055
1218,372,-462,2,3,5,40.0,-0.0014600000000000001,16.4,0.16477392775359925
1219,146,654,1,1,2,50.0,0.04329999999999999,13.5,0.19993647378026225
1220,348,-798,1,4,5,20.0,-0.015220000000000001,6.2,0.13661374515042218
1225,334,-3284,2,1,3,66.67,0.007766666666666667,15.666666666666666,0.21905864616532442
1227,2237,-8187,2,4,6,33.33,-0.014433333333333333,17.333333333333332,0.1353547501790285
1229,96,-446,0,1,1,0.0,-0.0269,7.0,0.08552154915697341
1231,679,-979,2,2,4,50.0,-0.019200000000000002,28.75,0.1718804887051103
1232,358,-5708,1,1,2,50.0,-0.06914999999999999,28.0,0.219070139569994
1233,205,-55,0,1,1,0.0,-0.0016,32.0,0.10450887672430342
1234,703,-1253,2,2,4,50.0,-0.006575000000000001,8.25,0.12007077769136221
1235,397,-497,1,1,2,50.0,-0.0074,8.5,0.12427827004598146
1236,0,0,0,0,0,0.0,,,
1256,7847,-27747,5,3,8,62.5,0.009975000000000001,20.375,0.17179938652201537
1301,2006,4794,2,2,4,50.0,0.012624999999999999,19.5,0.1489060845414838
1303,3258,6442,5,4,9,55.56,0.011077777777777778,21.11111111111111,0.1468803694921621
1304,1161,9589,5,3,8,62.5,0.051562500000000004,10.0,0.20549470434253322
1305,564,-1514,3,4,7,42.86,-0.011999999999999999,15.142857142857142,0.23692060176703764
1307,817,3183,4,2,6,66.67,0.0246,15.0,0.20199174047928667
1308,828,-1728,4,4,8,50.0,-0.0002999999999999999,20.625,0.13948020239865438
1309,753,2987,5,5,10,50.0,0.02395,8.5,0.17731481637322527
1310,258,-378,2,1,3,66.67,0.029733333333333337,9.666666666666666,0.16684665715828687
1312,1234,-4684,4,7,11,36.36,-0.01868181818181818,14.454545454545455,0.16754007091051423
1313,549,-229,3,3,6,50.0,-0.0032166666666666663,28.0,0.16419156684072397
1314,1277,1993,7,9,16,43.75,-0.0006562499999999988,17.1875,0.21115324326596333
1315,701,3249,4,1,5,80.0,0.03812,12.2,0.16215224514447582
1316,98,-768,0,2,2,0.0,-0.11485000000000001,13.0,0.30140027760574606
1319,3132,18,7,5,12,58.33,0.0047250000000000035,22.833333333333332,0.1749076165652926
1321,315,-815,3,1,4,75.0,0.006225,11.75,0.17449172221347903
1323,463,437,1,2,3,33.33,0.0016999999999999977,18.666666666666668,0.21449646794568897
1324,792,-192,6,3,9,66.67,0.02008888888888889,13.444444444444445,0.24495508086373466
1325,354,996,3,2,5,60.0,0.011680000000000001,15.0,0.16429379624585433
1326,2029,-1129,2,3,5,40.0,-3.999999999999976e-05,21.2,0.11309180919587525
1337,2751,-16951,6,5,11,54.55,-0.01693636363636364,11.272727272727273,0.18038053311639368
1338,1853,19347,4,0,4,100.0,0.06645000000000001,20.25,0.19710863489282604
1339,684,-6134,1,2,3,33.33,-0.044833333333333336,15.333333333333334,0.14543419344631806
1340,2247,-8547,2,4,6,33.33,-0.0005333333333333336,20.333333333333332,0.2301840044957414
1341,352,3148,1,0,1,100.0,0.0547,39.0,0.1494266365917376
1342,0,0,0,0,0,0.0,,,
1402,283,-183,1,1,2,50.0,-0.000899999999999998,33.0,0.14042336926070564
1409,816,-466,6,5,11,54.55,0.0010090909090909054,9.818181818181818,0.16475982364195257
1410,759,-3069,2,8,10,20.0,-0.022800000000000004,10.6,0.15910644930781337
1413,199,-229,2,2,4,50.0,-0.026049999999999997,14.25,0.22407249210093705
1414,0,0,0,0,0,0.0,,,
1416,52,158,1,0,1,100.0,0.0405,4.0,0.09091811209422795
1417,376,-3696,1,5,6,16.67,-0.07416666666666667,14.166666666666666,0.1560251506534719
1418,154,-774,0,3,3,0.0,-0.06863333333333334,9.0,0.1479104206181888
1419,1433,3467,6,3,9,66.67,0.026099999999999998,10.11111111111111,0.17881619381083327
1423,357,-227,2,4,6,33.33,-0.009316666666666666,15.166666666666666,0.14455709608821754
1432,0,0,0,0,0,0.0,,,
1434,1195,-11795,0,8,8,0.0,-0.056975,11.875,0.18733684543217705
1435,298,-578,3,2,5,60.0,0.032819999999999995,11.6,0.25581598135718503
1436,437,2333,3,1,4,75.0,0.04072500000000001,17.0,0.1640626136043697
1437,473,317,4,1,5,80.0,0.019039999999999998,14.2,0.207106965316849
1438,0,0,0,0,0,0.0,,,
1439,1485,2715,8,3,11,72.73,0.0030818181818181825,16.09090909090909,0.18722805107391818
1440,568,1282,5,2,7,71.43,0.019885714285714288,19.0,0.17885375227981476
1441,0,0,0,0,0,0.0,,,
1442,176,1844,2,1,3,66.67,0.08376666666666667,18.333333333333332,0.22687609926341512
1443,349,-819,2,5,7,28.57,-0.034985714285714294,15.428571428571429,0.19248449928142614
1444,763,777,7,4,11,63.64,0.0021454545454545433,11.545454545454545,0.1616744935291954
1445,443,457,3,4,7,42.86,0.012614285714285713,11.571428571428571,0.2297848538256883
1446,0,0,0,0,0,0.0,,,
1447,688,-5438,2,8,10,20.0,-0.040999999999999995,14.9,0.19652046303626108
1449,96,-76,1,1,2,50.0,-0.02645,8.5,0.15159404029605072
1451,687,-487,2,3,5,40.0,-0.0113,14.2,0.15642573951193045
1452,967,-7497,5,5,10,50.0,-0.0283,14.6,0.2072266011722051
1453,0,0,0,0,0,0.0,,,
1454,237,-617,1,3,4,25.0,-0.018000000000000002,11.0,0.16800587766790537
1455,517,933,4,3,7,57.14,0.021957142857142852,14.285714285714286,0.20203854046467348
1456,0,0,0,0,0,0.0,,,
1457,107,-917,0,2,2,0.0,-0.0851,10.5,0.10746024904419926
1459,341,749,2,3,5,40.0,0.012940000000000002,9.8,0.1936160815577605
1460,303,-403,2,3,5,40.0,-0.01724,17.6,0.16987844998638596
1463,242,1758,3,1,4,75.0,0.07050000000000001,13.75,0.20381496111730946
1464,906,-2586,5,4,9,55.56,0.013455555555555554,21.333333333333332,0.1876033486337344
1465,327,-2527,1,3,4,25.0,-0.05415,20.75,0.15097431523615146
1466,0,0,0,0,0,0.0,,,
1467,987,943,8,6,14,57.14,0.012164285714285714,13.214285714285714,0.1686265657057787
1468,219,-379,1,2,3,33.33,-0.01333333333333333,13.666666666666666,0.17654631799979717
1470,0,0,0,0,0,0.0,,,
1471,728,-1928,4,5,9,44.44,-0.023533333333333333,14.777777777777779,0.15029274752537236
1472,187,-837,0,3,3,0.0,-0.04226666666666667,13.666666666666666,0.13062042532026355
1473,1246,5054,4,2,6,66.67,0.03326666666666667,20.166666666666668,0.15379616541596008
1474,454,-1144,3,4,7,42.86,-0.024785714285714282,13.142857142857142,0.25262141655300147
1475,125,-2025,0,1,1,0.0,-0.0888,33.0,0.10661794169708871
1476,17355,-66755,4,6,10,40.0,-0.030279999999999994,20.1,0.15383999217854172
1477,2953,-14653,1,3,4,25.0,-0.029849999999999998,33.25,0.17941656482795987
1503,702,-7452,0,4,4,0.0,-0.057575,26.25,0.16495643180968983
1504,1925,-795,6,9,15,40.0,-0.005413333333333333,18.533333333333335,0.17132308032818236
1506,296,664,3,1,4,75.0,0.014775,12.5,0.14895024131365242
1512,612,-2462,4,6,10,40.0,-0.02312,8.1,0.2285590638544101
1513,271,729,2,1,3,66.67,0.015366666666666667,8.333333333333334,0.2208022854314756
1514,389,-789,2,4,6,33.33,-0.019116666666666667,12.0,0.12762393023916616
1515,370,-1910,1,4,5,20.0,-0.03432,25.4,0.15025905041425083
1516,51,-151,0,1,1,0.0,-0.0408,13.0,0.11024941355608697
1517,528,-4878,2,3,5,40.0,-0.03768,16.8,0.16203078856662648
1519,1065,-1855,4,3,7,57.14,-0.0003428571428571425,15.142857142857142,0.17963411010013772
1521,2294,-2844,3,5,8,37.5,-0.015412499999999997,9.125,0.1533298314046595
1522,517,3433,3,0,3,100.0,0.0402,17.333333333333332,0.19197962563301005
1524,388,1552,3,2,5,60.0,0.03318,19.2,0.25989140189154336
1525,5171,-421,5,7,12,41.67,-0.0045499999999999985,14.333333333333334,0.1633423101095994
1526,70,1830,1,0,1,100.0,0.2245,15.0,0.2500742944439278
1527,3636,-15586,3,11,14,21.43,-0.02463571428571429,10.857142857142858,0.16239730413762601
1528,290,1160,2,2,4,50.0,0.014075000000000002,23.25,0.1716859468917622
1529,519,-479,4,5,9,44.44,-0.029844444444444437,8.444444444444445,0.1952876491530861
1530,1734,-9134,4,5,9,44.44,-0.01763333333333333,17.666666666666668,0.20043520947655125
1531,1587,-9287,4,5,9,44.44,-0.013455555555555554,26.666666666666668,0.1851270108635255
1532,1401,2899,4,3,7,57.14,0.00507142857142857,17.428571428571427,0.2027260934419095
1533,1034,8116,3,1,4,75.0,0.046925,13.5,0.2677104367157623
1535,1229,-8729,2,4,6,33.33,-0.03523333333333334,15.5,0.21464048113700795
1536,6170,-3170,8,7,15,53.33,0.004899999999999999,19.0,0.1467014377795506
1537,1548,-11948,0,6,6,0.0,-0.05541666666666667,12.166666666666666,0.19755693672884425
1538,1620,-16570,1,7,8,12.5,-0.05715,19.125,0.20466230748479605
1539,1007,-3697,2,7,9,22.22,-0.026577777777777773,18.22222222222222,0.1583867964091248
1540,94,556,1,0,1,100.0,0.0354,32.0,0.2417210072533258
1541,956,1264,2,4,6,33.33,-0.005283333333333332,12.666666666666666,0.16627850983232598
1558,1150,-5500,1,2,3,33.33,0.016366666666666668,3.3333333333333335,0.14097480703115908
1560,4405,-20805,2,8,10,20.0,-0.018359999999999998,18.8,0.17146468158214348
1568,624,826,3,1,4,75.0,0.015775,18.25,0.29408566435444344
1582,3510,-9310,3,4,7,42.86,-0.018228571428571427,14.857142857142858,0.1440237156945285
1583,1097,-7747,1,2,3,33.33,-0.037633333333333324,22.666666666666668,0.13244914749330997
1587,0,0,0,0,0,0.0,,,
1589,800,200,1,1,2,50.0,-0.0026499999999999996,22.5,0.13779346604343257
1590,23628,39372,6,3,9,66.67,0.0017222222222222196,10.88888888888889,0.16862360024775966
1597,5029,21121,8,3,11,72.73,0.03182727272727273,14.545454545454545,0.21168324875231193
1598,1104,1096,1,1,2,50.0,0.020300000000000006,11.0,0.24235701600049642
1603,366,-1496,2,4,6,33.33,-0.027816666666666667,11.5,0.22780664927941643
1604,184,606,2,1,3,66.67,0.0124,18.333333333333332,0.1301214018446828
1605,838,4012,6,4,10,60.0,0.023369999999999995,15.8,0.1554718318338664
1608,588,662,3,5,8,37.5,-0.011662500000000004,11.25,0.2003198415389083
1609,560,-2130,3,6,9,33.33,-0.0308,12.88888888888889,0.16488513085881076
1611,1074,-6124,4,8,12,33.33,-0.027025000000000004,11.0,0.17826198296684545
1612,506,3274,4,2,6,66.67,0.03535,12.333333333333334,0.22682889544391135
1614,116,-1116,0,1,1,0.0,-0.0542,7.0,0.14995352853365418
1615,370,4840,2,2,4,50.0,0.068775,14.25,0.2622837113464456
1616,463,-3053,2,5,7,28.57,-0.04385714285714286,16.285714285714285,0.1599972428841703
1617,349,-1409,2,3,5,40.0,-0.037020000000000004,13.0,0.17539000532918733
1618,372,1748,3,2,5,60.0,0.037160000000000006,14.8,0.1297529661327264
1626,683,-483,1,4,5,20.0,-0.003879999999999997,15.8,0.13390293912239154
1701,441,-391,4,1,5,80.0,0.006659999999999999,24.4,0.1690272001673503
1702,2279,-28179,1,11,12,8.33,-0.048075,20.416666666666668,0.16461686297188335
1707,605,1545,1,2,3,33.33,0.018766666666666664,14.666666666666666,0.14814214178915316
1708,118,-618,1,1,2,50.0,-0.052099999999999994,20.5,0.15562960916022817
1709,417,-67,2,2,4,50.0,0.014849999999999999,8.75,0.14185193487158082
1710,1582,-11082,3,7,10,30.0,-0.02915,12.6,0.1765436153721342
1711,559,441,3,3,6,50.0,0.020850000000000004,20.333333333333332,0.18325471112261868
1712,320,-1420,1,2,3,33.33,-0.024966666666666668,29.333333333333332,0.14068921632687026
1713,272,3018,2,1,3,66.67,0.05786666666666667,10.333333333333334,0.22402175634322075
1714,1070,-1510,6,8,14,42.86,-0.01947857142857143,15.928571428571429,0.19334749904942547
1717,1694,4756,5,5,10,50.0,0.002400000000000003,18.5,0.20692426874743602
1718,633,-1053,5,4,9,55.56,-0.0020333333333333336,15.222222222222221,0.20500003813510162
1720,720,930,3,2,5,60.0,0.014300000000000002,12.4,0.17461089027997306
1721,165,475,2,1,3,66.67,0.033466666666666665,21.0,0.18722147803992173
1722,1666,-9066,3,1,4,75.0,0.0017750000000000027,18.25,0.19445167709214617
1723,1921,12429,4,0,4,100.0,0.035,25.0,0.14090989556694672
1725,810,4090,5,2,7,71.43,0.020771428571428562,20.857142857142858,0.18748546496886015
1726,1053,-6253,1,3,4,25.0,-0.028725,9.0,0.11442358795144558
1727,525,-1075,3,3,6,50.0,0.002783333333333331,13.166666666666666,0.2250812267782284
1730,299,-2219,1,3,4,25.0,-0.048225,18.25,0.2658675612474185
1731,609,-1209,2,5,7,28.57,-0.005985714285714283,5.428571428571429,0.19595808178624335
1732,573,-5523,1,5,6,16.67,-0.04700000000000001,17.166666666666668,0.1763531164755863
1733,1800,3050,5,1,6,83.33,0.014716666666666668,17.166666666666668,0.1483360417515557
1734,1431,2569,5,3,8,62.5,0.028575,17.625,0.2014305125891373
1735,547,-237,2,5,7,28.57,-0.002457142857142856,12.714285714285714,0.17362837072708523
1736,3982,6718,5,5,10,50.0,0.006389999999999997,10.3,0.1596143338124445
1737,679,-2079,3,3,6,50.0,-0.012166666666666668,15.5,0.19078067405986962
1760,0,0,0,0,0,0.0,,,
1762,1073,-5123,1,3,4,25.0,-0.02735,9.75,0.12374228123449554
1773,2285,-8485,2,2,4,50.0,-0.0020499999999999997,11.75,0.10340169302409868
1776,95,255,1,0,1,100.0,0.016,7.0,0.10489005389865369
1783,279,-379,1,1,2,50.0,0.008749999999999994,26.0,0.22573645160713585
1786,1423,777,2,2,4,50.0,0.0069500000000000004,21.25,0.18742453251249536
1789,2151,4049,5,3,8,62.5,0.019487499999999998,15.5,0.15656674639169896
1795,1477,2923,2,2,4,50.0,-0.011500000000000003,16.0,0.22249967634988488
1802,920,-9370,1,5,6,16.67,-0.052616666666666666,10.5,0.20064567625683297
1805,90,-30,1,1,2,50.0,-0.025900000000000003,15.5,0.34170556714299294
1806,48,82,1,0,1,100.0,0.0327,4.0,0.15423609773569047
1808,0,0,0,0,0,0.0,,,
1809,449,4931,5,0,5,100.0,0.06586,17.8,0.16367118311668566
1810,59,-519,0,1,1,0.0,-0.0769,21.0,0.08766117023683817
1817,601,599,2,1,3,66.67,0.009033333333333332,21.666666666666668,0.243188064077252
1903,2131,-12681,3,6,9,33.33,-0.02015555555555555,18.333333333333332,0.21964082317929803
1904,442,-1072,3,3,6,50.0,-0.007616666666666667,14.666666666666666,0.18009916818989194
1905,556,-1956,3,3,6,50.0,-0.015716666666666667,15.166666666666666,0.20271214427858475
1906,0,0,0,0,0,0.0,,,
1907,1114,-6114,3,6,9,33.33,-0.033322222222222225,11.777777777777779,0.1702899022414997
1909,794,-4814,2,6,8,25.0,-0.0168875,13.875,0.21863837361518185
2002,398,-1148,1,2,3,33.33,-0.013800000000000002,21.333333333333332,0.1888287044245752
2006,857,-8357,1,4,5,20.0,-0.04832,19.0,0.1267782666497753
2007,116,524,2,0,2,100.0,0.0508,9.0,0.18220924844986397
2008,433,-1253,3,4,7,42.86,-0.012285714285714285,13.142857142857142,0.1743836464664378
2009,678,-3278,4,3,7,57.14,0.002614285714285714,15.142857142857142,0.18891083663177896
2010,647,1353,4,3,7,57.14,0.008971428571428571,8.0,0.16321600879489964
2012,737,5163,6,0,6,100.0,0.04676666666666667,13.166666666666666,0.17875838366100294
2013,638,-5588,0,3,3,0.0,-0.038099999999999995,3.3333333333333335,0.11290323858458888
2014,248,52,1,2,3,33.33,0.0009000000000000003,12.333333333333334,0.1790223199667289
2015,954,796,1,3,4,25.0,0.0008500000000000018,5.5,0.17636190492548343
2017,170,-200,1,2,3,33.33,-0.0027666666666666673,6.0,0.2481557000236906
2020,369,-1169,2,2,4,50.0,-0.008149999999999998,15.0,0.14413408553401802
2022,172,1228,3,0,3,100.0,0.07593333333333334,21.333333333333332,0.21764490017123875
2023,446,-4616,2,2,4,50.0,-0.039825,17.25,0.17542093277389031
2024,52,-362,0,1,1,0.0,-0.0825,2.0,0.13388362114621644
2025,708,-3368,3,9,12,25.0,-0.062083333333333324,13.666666666666666,0.20361075559915978
2027,0,0,0,0,0,0.0,,,
2028,54,-564,0,1,1,0.0,-0.1064,18.0,0.41463701948492204
2029,653,-2503,1,2,3,33.33,-0.012133333333333336,22.666666666666668,0.24578626639115705
2030,267,-1717,1,2,3,33.33,-0.03623333333333333,13.0,0.15845974633675222
2031,1437,-18887,2,6,8,25.0,-0.065,10.75,0.2293348600457378
2032,769,-3579,2,4,6,33.33,-0.009050000000000002,19.0,0.2420125160080756
2033,454,-1114,2,4,6,33.33,-0.006349999999999999,13.0,0.19296562098412887
2034,864,-1014,3,4,7,42.86,0.0003142857142857162,14.714285714285714,0.16259913995451056
2038,387,-1187,1,2,3,33.33,-0.013733333333333334,18.666666666666668,0.15539726899791004
2049,9273,-81073,4,4,8,50.0,-0.0338625,11.25,0.20194173813278052
2059,15193,14807,7,3,10,70.0,0.028360000000000007,24.1,0.20095792970673862
2062,1070,-5170,1,3,4,25.0,-0.010125000000000002,18.0,0.1688055885984555
2069,266,-5166,0,3,3,0.0,-0.10443333333333334,29.333333333333332,0.1809927843402858
2101,0,0,0,0,0,0.0,,,
2102,524,-1574,3,2,5,60.0,-0.020280000000000003,10.2,0.14728594241321594
2103,1323,11077,6,0,6,100.0,0.07483333333333334,17.0,0.15793260299530854
2104,1052,-7352,2,4,6,33.33,-0.041666666666666664,12.333333333333334,0.14707963247708986
2105,3373,577,6,6,12,50.0,0.0023833333333333345,14.0,0.19030819081806874
2106,1514,-3414,4,3,7,57.14,-0.010557142857142857,28.857142857142858,0.14371179295679506
2107,771,-4071,3,4,7,42.86,-0.02482857142857143,16.285714285714285,0.20687812572827022
2108,1827,-7277,5,3,8,62.5,-0.014412500000000002,16.375,0.13945511375778738
2109,742,538,5,5,10,50.0,0.001549999999999998,19.2,0.18719702355396023
2114,1017,-1817,1,2,3,33.33,-0.013900000000000001,22.333333333333332,0.1515690292604622
2115,768,-7318,1,2,3,33.33,-0.04066666666666666,11.333333333333334,0.22528527523558006
2201,3042,10508,7,3,10,70.0,0.025270000000000004,25.1,0.15094764722106602
2204,1311,89,3,5,8,37.5,-0.009562499999999998,12.0,0.1601461381796905
2206,717,-2567,3,4,7,42.86,-0.020300000000000002,11.571428571428571,0.1749124628437567
2207,15377,-67877,3,5,8,37.5,-0.0160125,18.0,0.15797075944209943
2208,594,-1394,2,2,4,50.0,-0.013325000000000004,10.25,0.11612868779735547
2227,5752,-27252,1,3,4,25.0,-0.031625,7.75,0.16677492895906082
2228,1042,-12642,1,1,2,50.0,-0.05005,36.0,0.2480140546870464
2231,10622,32578,6,4,10,60.0,0.01216,14.1,0.19197514927682655
2233,2418,-25718,1,4,5,20.0,-0.04868,8.6,0.17610140928746998
2236,489,-6789,0,2,2,0.0,-0.08755,6.5,0.19779297983424338
2239,2228,17272,3,1,4,75.0,0.0398,10.5,0.1814965523358173
2241,1242,4908,2,2,4,50.0,0.004550000000000002,16.0,0.2204473768512346
2243,488,-2588,1,3,4,25.0,-0.014850000000000002,5.5,0.16760747142305882
2247,1325,175,1,0,1,100.0,0.0008,10.0,0.19631320926983276
2301,1684,-4984,2,6,8,25.0,-0.0177125,24.5,0.16079379785019354
2302,115,485,1,1,2,50.0,0.0499,4.5,0.15164090295185484
2303,238,-2288,0,2,2,0.0,-0.0522,5.0,0.13707016924375182
2305,62,-862,0,1,1,0.0,-0.1077,12.0,0.31026891534271583
2308,7383,-46583,4,6,10,40.0,-0.025420000000000005,15.3,0.16448649356954334
2312,909,2291,7,5,12,58.33,0.014866666666666665,12.5,0.15304300226305637
2313,1713,1647,8,6,14,57.14,0.022050000000000007,13.785714285714286,0.16081097823854348
2314,292,-1782,2,2,4,50.0,-0.009599999999999997,11.0,0.22770582782839632
2316,701,-9201,2,4,6,33.33,-0.0499,25.5,0.17452588316041964
2317,6812,13388,6,4,10,60.0,0.0025399999999999997,21.5,0.1330064878479666
2321,587,113,5,4,9,55.56,-0.023577777777777777,15.333333333333334,0.23834505177510923
2323,199,811,2,1,3,66.67,0.0162,13.333333333333334,0.19691551524277137
2324,1370,-4370,4,5,9,44.44,-0.01182222222222222,10.777777777777779,0.15511986345447382
2327,497,3783,5,1,6,83.33,0.04613333333333333,13.666666666666666,0.184053800180956
2328,2209,-7009,4,7,11,36.36,-0.015936363636363637,7.7272727272727275,0.18983282640116536
2329,0,0,0,0,0,0.0,,,
2330,10332,35368,5,6,11,45.45,-0.010681818181818181,15.272727272727273,0.1217926636808769
2331,125,555,2,0,2,100.0,0.0399,15.0,0.13084511850196667
2332,915,-5515,3,3,6,50.0,0.0004666666666666662,14.833333333333334,0.17925943776256528
2337,66,884,1,0,1,100.0,0.1141,14.0,0.1864004865259421
2338,592,1008,4,2,6,66.67,0.005750000000000001,10.0,0.1560414592293049
2340,238,-1088,1,2,3,33.33,-0.017,9.666666666666666,0.2345790220353984
2342,54,286,1,0,1,100.0,0.0637,3.0,0.2575014353052758
2344,1156,-2386,5,9,14,35.71,-0.01575714285714286,14.214285714285714,0.15755707189227408
2345,2857,-28557,4,6,10,40.0,-0.023899999999999998,12.5,0.16138512347919381
2347,272,2628,1,0,1,100.0,0.0592,15.0,0.08021615158678386
2348,0,0,0,0,0,0.0,,,
2349,594,-3414,2,8,10,20.0,-0.051759999999999994,15.8,0.2370808171120254
2351,4294,1856,9,3,12,75.0,0.01951666666666667,15.583333333333334,0.20653970653113266
2352,1171,-971,5,4,9,55.56,0.002333333333333335,14.777777777777779,0.1844224585876627
2353,881,-11181,0,3,3,0.0,-0.08259999999999999,14.333333333333334,0.2330616211060804
2354,10886,-12486,6,4,10,60.0,-0.0036199999999999982,15.5,0.18330712418081083
2355,3773,777,8,10,18,44.44,-0.0033333333333333322,16.0,0.16158127588641835
2356,964,-3314,4,4,8,50.0,-0.022275,26.0,0.19985772688973222
2357,2629,371,3,3,6,50.0,0.0019999999999999996,10.166666666666666,0.15347838348898987
2358,43,-163,0,1,1,0.0,-0.1567,10.0,0.2623064880960779
2359,346,-3646,1,2,3,33.33,-0.03443333333333334,19.333333333333332,0.2320430170606366
2360,5568,4632,7,3,10,70.0,0.020260000000000007,18.2,0.2294075509445696
2362,2853,6697,7,7,14,50.0,0.017107142857142855,14.785714285714286,0.18735107890549002
2363,321,-3251,1,2,3,33.33,-0.04456666666666667,5.0,0.2690341410250156
2364,51,609,1,0,1,100.0,0.1952,20.0,0.2421756432757216
2365,405,-805,1,1,2,50.0,-0.013899999999999996,27.0,0.14645842720865965
2367,2018,-528,10,10,20,50.0,-0.0049050000000000005,12.8,0.20052312263303565
2368,1193,-4533,4,5,9,44.44,0.004155555555555555,15.777777777777779,0.2235049875970062
2369,639,5011,6,2,8,75.0,0.04725,7.375,0.19862959873040661
2371,249,-99,1,2,3,33.33,-0.007133333333333339,13.333333333333334,0.18106557106431484
2373,0,0,0,0,0,0.0,,,
2374,2601,3749,8,5,13,61.54,0.020761538461538463,16.53846153846154,0.22391936578527047
2375,55,705,1,0,1,100.0,0.1724,20.0,0.26260714351164394
2376,1649,3401,2,4,6,33.33,0.005033333333333333,17.833333333333332,0.1219993128087115
2377,3660,-4410,7,8,15,46.67,-0.00033999999999999726,14.066666666666666,0.2075756433402153
2379,9326,-76026,5,5,10,50.0,-0.019839999999999997,16.3,0.2022277744002335
2380,553,1847,5,3,8,62.5,0.030024999999999996,15.125,0.19819310601939652
2382,3763,737,5,5,10,50.0,0.0034199999999999994,22.1,0.15569311834707247
2383,4565,19315,4,6,10,40.0,0.004449999999999997,16.6,0.1644793368765061
2385,2011,-7311,2,3,5,40.0,-0.01174,29.4,0.16738469286738283
2387,1668,-8918,3,7,10,30.0,-0.02816,14.2,0.15920734394342068
2388,577,-2127,2,2,4,50.0,-0.023425,10.75,0.19231441576125585
2390,963,287,4,6,10,40.0,0.0038099999999999987,13.4,0.13174525812512922
2392,5692,-24492,6,8,14,42.86,-0.01719285714285714,15.285714285714286,0.21616195803782853
2393,4607,16243,6,5,11,54.55,0.016954545454545458,13.909090909090908,0.20919612745477495
2395,7828,-16628,3,6,9,33.33,-0.02866666666666666,13.11111111111111,0.17054904785117186
2397,108,1992,1,0,1,100.0,0.1186,24.0,0.19756354483502214
2399,789,-1069,4,4,8,50.0,-0.018187500000000002,13.0,0.20102996344198285
2401,1125,-4375,3,4,7,42.86,-0.02342857142857143,7.428571428571429,0.19704424444452948
2402,2386,3164,9,8,17,52.94,0.011982352941176473,11.941176470588236,0.20745126744284323
2404,1976,11524,3,1,4,75.0,0.02265,5.75,0.1117265543973735
2405,1290,-730,5,8,13,38.46,-0.02842307692307692,9.384615384615385,0.20762120635154094
2406,606,684,4,5,9,44.44,0.006055555555555553,14.444444444444445,0.22908120014911956
2408,177,-1967,0,2,2,0.0,-0.09445,2.5,0.21671978939665582
2409,2178,-3528,5,7,12,41.67,-0.005641666666666667,15.25,0.18263802944784144
2412,0,0,0,0,0,0.0,,,
2413,793,-633,5,4,9,55.56,-0.0019555555555555546,15.88888888888889,0.20258450232596797
2414,280,1270,2,1,3,66.67,0.02526666666666667,18.666666666666668,0.09778965986661348
2415,2272,-12472,8,10,18,44.44,-0.01908333333333333,11.055555555555555,0.1991448300208075
2417,1127,1273,6,1,7,85.71,0.021014285714285715,11.857142857142858,0.19437416224250606
2419,1131,-5031,5,6,11,45.45,-0.01620909090909091,10.272727272727273,0.17703099910095826
2420,1055,-105,4,3,7,57.14,-0.0016714285714285718,15.714285714285714,0.17582703683216647
2421,1605,-12705,3,10,13,23.08,-0.05078461538461538,18.615384615384617,0.1702143697418834
2423,1130,-4830,2,7,9,22.22,-0.0213,19.444444444444443,0.12890582569467599
2424,155,1695,2,0,2,100.0,0.07345,5.5,0.12899947079145835
2425,0,0,0,0,0,0.0,,,
2426,463,-4263,1,3,4,25.0,-0.0655,14.75,0.22950698135844488
2427,239,431,2,1,3,66.67,-0.0099,10.333333333333334,0.160128982073096
2428,6205,-31805,6,7,13,46.15,-0.014538461538461538,13.923076923076923,0.1670289493667868
2429,184,-734,1,3,4,25.0,-0.0848,18.25,0.2368009570598426
2430,948,5502,3,1,4,75.0,0.044700000000000004,27.5,0.23748760501230287
2431,540,-2470,1,5,6,16.67,-0.024583333333333336,8.166666666666666,0.19469066920549982
2433,0,0,0,0,0,0.0,,,
2434,844,-6094,3,5,8,37.5,-0.023737499999999995,7.875,0.16633974244795532
2436,469,331,3,1,4,75.0,0.006775000000000001,10.25,0.10897041011868586
2438,424,1426,4,3,7,57.14,0.02071428571428571,13.285714285714286,0.26469768030264923
2439,5423,41177,6,3,9,66.67,0.04342222222222222,17.555555555555557,0.1947559798064585
2440,50,-550,0,1,1,0.0,-0.1486,7.0,0.25591061357367617
2441,2271,-2471,3,6,9,33.33,-0.01501111111111111,13.0,0.18122179852837775
2442,287,3303,3,1,4,75.0,0.0882,11.75,0.22455257960018593
2443,173,-2463,0,3,3,0.0,-0.12066666666666666,14.0,0.1940569816112371
2444,113,-1563,0,1,1,0.0,-0.0764,6.0,0.22130770260479893
2449,1294,6656,9,2,11,81.82,0.03797272727272726,11.636363636363637,0.17092260101762127
2450,2024,-8074,4,5,9,44.44,-0.0163,9.777777777777779,0.12762767926770222
2451,5410,-42610,3,7,10,30.0,-0.0305,15.8,0.1810982866316673
2453,630,-330,3,4,7,42.86,-0.004457142857142856,21.142857142857142,0.18401323561760083
2454,20889,133611,8,1,9,88.89,0.04058888888888888,21.22222222222222,0.18765447483773323
2455,2738,12162,4,4,8,50.0,0.008699999999999998,11.25,0.2096243486966102
2457,703,3277,2,4,6,33.33,0.0018500000000000033,7.5,0.20995813810177866
2458,3948,-17598,2,8,10,20.0,-0.042010000000000006,14.6,0.17450874682333134
2459,1361,1239,4,3,7,57.14,0.001614285714285714,17.142857142857142,0.19710127359369456
2460,1448,-14698,1,7,8,12.5,-0.051475,15.625,0.1843474913012384
2461,1070,-3670,3,7,10,30.0,-0.022949999999999998,14.3,0.18024569064745954
2462,751,-7051,3,3,6,50.0,-0.004283333333333336,19.833333333333332,0.20533383707358902
2464,191,1909,1,0,1,100.0,0.0612,5.0,0.1987573349438918
2465,100,900,1,0,1,100.0,0.0552,8.0,0.1503030557539453
2466,589,-5339,1,3,4,25.0,-0.04335,8.25,0.1468824281144745
2467,1265,4985,6,2,8,75.0,0.021962499999999996,19.375,0.1952624696157419
2468,283,-1033,1,3,4,25.0,-0.02805,18.75,0.20828522650660353
2471,1031,-1621,6,7,13,46.15,-0.010392307692307692,13.153846153846153,0.21057544205103734
2472,900,-1100,3,4,7,42.86,-0.0019428571428571435,11.571428571428571,0.2178052328396123
2474,10036,-4036,5,5,10,50.0,-0.021039999999999996,10.9,0.19215666633710493
2476,1704,6296,5,3,8,62.5,0.0171625,13.5,0.19688133612410355
2477,2666,594,10,8,18,55.56,0.011983333333333334,17.555555555555557,0.18956188848898697
2478,1302,-4252,6,4,10,60.0,-0.007180000000000001,14.9,0.20058067722891018
2480,217,2483,1,0,1,100.0,0.0709,14.0,0.14387949097649644
2481,4245,15445,12,7,19,63.16,0.007442105263157896,15.210526315789474,0.2404693364486976
2482,983,-5483,4,4,8,50.0,-0.014150000000000003,10.125,0.2467736739938594
2483,876,-4076,3,5,8,37.5,-0.0263375,13.0,0.15317772452085418
2484,362,-5612,0,4,4,0.0,-0.0937,13.25,0.23151453624760626
2485,2533,-12133,3,9,12,25.0,-0.0291,11.25,0.162348514372926
2486,1326,8084,7,4,11,63.64,0.026063636363636365,17.09090909090909,0.20209054971019283
2488,71,-571,0,1,1,0.0,-0.0529,6.0,0.13137144472581697
2489,1047,-547,5,4,9,55.56,-0.0030222222222222217,15.555555555555555,0.1759345651447017
2491,0,0,0,0,0,0.0,,,
2492,4367,1453,9,4,13,69.23,0.010376923076923079,14.076923076923077,0.14869937577933914
2493,1015,885,6,3,9,66.67,0.008844444444444441,19.0,0.19613101745442263
2495,2122,-5972,6,4,10,60.0,0.006430000000000001,14.7,0.17242920709118176
2496,114,-1664,0,2,2,0.0,-0.14500000000000002,4.0,0.278005225705511
2497,3022,-26272,5,9,14,35.71,-0.03309285714285715,11.357142857142858,0.2048697776461758
2498,24411,39989,8,6,14,57.14,0.008492857142857144,8.857142857142858,0.18882787090281664
2501,666,-7516,1,6,7,14.29,-0.057942857142857136,9.857142857142858,0.19606948802180416
2504,619,-459,3,4,7,42.86,-0.029842857142857147,16.142857142857142,0.19946136843978898
2505,73,1727,1,0,1,100.0,0.1877,13.0,0.27513501952148567
2506,43,-33,0,1,1,0.0,-0.0371,2.0,0.2830528922645006
2509,0,0,0,0,0,0.0,,,
2511,852,958,5,5,10,50.0,0.010509999999999999,13.3,0.19741711265945872
2514,0,0,0,0,0,0.0,,,
2515,787,-3177,4,9,13,30.77,-0.027638461538461535,13.538461538461538,0.16297866646590795
2516,58,42,1,0,1,100.0,0.0072,18.0,0.21898899013815498
2520,455,-2795,1,4,5,20.0,-0.033940000000000005,7.4,0.22409026928061082
2524,1724,-6874,4,6,10,40.0,-0.0227,10.9,0.17412858314942659
2527,52,-202,0,1,1,0.0,-0.0499,27.0,0.19105099321708985
2528,0,0,0,0,0,0.0,,,
2530,0,0,0,0,0,0.0,,,
2534,1200,-2300,7,3,10,70.0,-0.0014499999999999977,20.8,0.18173744732954328
2535,596,-1046,4,3,7,57.14,0.017514285714285715,18.571428571428573,0.2389992586868334
2536,1021,-5921,2,3,5,40.0,-0.02218,24.0,0.22561272687966955
2537,0,0,0,0,0,0.0,,,
2538,621,-2021,2,6,8,25.0,-0.019925,23.0,0.13767883544698215
2539,0,0,0,0,0,0.0,,,
2540,0,0,0,0,0,0.0,,,
2542,164,386,1,0,1,100.0,0.014,5.0,0.11968413003123057
2543,592,-1632,2,7,9,22.22,-0.00777777777777778,16.88888888888889,0.15443484661717713
2545,638,-3838,1,3,4,25.0,-0.029249999999999998,12.75,0.24476241857370623
2546,1056,-386,4,4,8,50.0,-0.018549999999999997,19.875,0.22372606045941631
2547,821,6079,4,3,7,57.14,0.03451428571428571,22.0,0.19748777617795812
2548,3069,-35119,0,9,9,0.0,-0.060811111111111114,14.0,0.17114211255620457
2597,198,-1498,0,1,1,0.0,-0.043,36.0,0.1596992324801958
2601,0,0,0,0,0,0.0,,,
2603,1755,-15505,2,7,9,22.22,-0.03328888888888889,8.666666666666666,0.2124221973228217
2605,1434,566,3,5,8,37.5,-0.004875000000000003,8.0,0.14357782196145114
2606,1623,-8923,1,4,5,20.0,-0.02464,7.6,0.1652516124423248
2607,855,-4155,3,5,8,37.5,-0.0343125,13.875,0.21458144153707023
2608,1181,519,4,3,7,57.14,0.012928571428571432,16.0,0.14512002333512294
2609,864,-4804,4,5,9,44.44,-0.03141111111111111,13.444444444444445,0.1768733277309765
2610,318,132,2,2,4,50.0,0.005174999999999999,21.75,0.18108248159607443
2611,280,540,2,2,4,50.0,0.015575000000000002,20.0,0.1688882766395477
2612,0,0,0,0,0,0.0,,,
2613,862,-1512,5,4,9,55.56,0.0028000000000000017,19.22222222222222,0.21083962286973013
2614,0,0,0,0,0,0.0,,,
2615,637,2713,3,3,6,50.0,0.021183333333333332,16.5,0.1624267471274601
2616,444,-2144,2,3,5,40.0,-0.030619999999999998,19.4,0.12502327636711877
2617,1192,-4792,2,5,7,28.57,-0.019585714285714286,12.428571428571429,0.16426697278151534
2618,453,177,3,3,6,50.0,0.01908333333333333,18.333333333333332,0.1618766701237593
2630,0,0,0,0,0,0.0,,,
2633,275,125,1,1,2,50.0,0.0032500000000000003,42.5,0.11703632708996625
2634,585,-685,1,2,3,33.33,0.0009999999999999963,13.666666666666666,0.17487009649153432
2636,1213,-9363,1,3,4,25.0,-0.006600000000000002,8.5,0.16857442128165112
2637,296,-246,1,1,2,50.0,-0.0069,31.0,0.12703008743968314
2642,1052,-1152,3,3,6,50.0,-0.008650000000000003,20.0,0.22470601626013464
2701,268,3082,3,0,3,100.0,0.07103333333333334,29.0,0.18349943853927986
2702,859,3941,4,2,6,66.67,0.028749999999999998,16.333333333333332,0.18997994980669886
2704,1032,-2982,2,3,5,40.0,0.0012799999999999977,11.0,0.1875037846483897
2705,598,3312,5,1,6,83.33,0.016533333333333334,18.166666666666668,0.21521036919252934
2706,798,4602,4,2,6,66.67,0.034716666666666667,23.333333333333332,0.19223861629202418
2707,0,0,0,0,0,0.0,,,
2712,0,0,0,0,0,0.0,,,
2722,226,-176,0,1,1,0.0,-0.0046,4.0,0.09598994276645878
2723,7167,-11267,3,4,7,42.86,0.0021714285714285702,13.0,0.18305670298435697
2727,3744,-24744,2,1,3,66.67,-0.008233333333333334,11.666666666666666,0.15637075341633197
2731,1446,3354,1,1,2,50.0,0.0034999999999999996,28.5,0.26689303931594865
2739,151,2949,1,0,1,100.0,0.1255,12.0,0.10679137327807142
2748,243,4457,1,0,1,100.0,0.117,33.0,0.23487233581626743
2801,488,312,3,2,5,60.0,0.004159999999999999,19.4,0.10935018574824688
2809,902,-2462,2,6,8,25.0,-0.021050000000000003,16.625,0.1406463684742575
2812,72,928,1,0,1,100.0,0.0957,13.0,0.32691506114614355
2816,54,486,1,0,1,100.0,0.1221,8.0,0.18103274972762518
2820,185,-1925,0,3,3,0.0,-0.0797,12.333333333333334,0.14915683269783928
2832,0,0,0,0,0,0.0,,,
2834,0,0,0,0,0,0.0,,,
2836,711,2549,6,3,9,66.67,0.021422222222222218,20.555555555555557,0.13649660349868134
2838,111,-381,1,1,2,50.0,-0.042350000000000006,26.0,0.2624951027344937
2841,764,4906,9,2,11,81.82,0.042781818181818185,12.727272727272727,0.25159062871160565
2845,303,-2603,0,4,4,0.0,-0.077025,13.5,0.15435527960537276
2849,251,-21,3,1,4,75.0,0.013600000000000008,13.0,0.15087555657345042
2850,468,-2918,1,4,5,20.0,-0.03012,9.4,0.15803449468341504
2851,372,-372,2,1,3,66.67,0.009866666666666668,22.0,0.13352158943852133
2852,680,-3580,3,5,8,37.5,-0.02475,22.25,0.13390175427622716
2855,1013,-2213,3,7,10,30.0,-0.015759999999999996,18.3,0.11998260538221905
2867,313,-993,1,3,4,25.0,-0.0179,18.0,0.1050713836249706
2880,1075,-6925,3,5,8,37.5,-0.034112500000000004,21.875,0.13169238573476993
2881,1528,-2878,3,4,7,42.86,-0.0057714285714285714,25.857142857142858,0.14288690258279732
2882,1383,-1633,3,2,5,60.0,-0.005760000000000001,20.0,0.18945156697842833
2883,824,-2264,4,7,11,36.36,-0.021536363636363638,25.545454545454547,0.13325945950497495
2884,979,-1649,4,5,9,44.44,-0.013933333333333332,23.333333333333332,0.15111246319581736
2885,424,3526,4,0,4,100.0,0.052599999999999994,18.75,0.09025316679509526
2886,824,-3224,4,3,7,57.14,-0.02461428571428571,19.571428571428573,0.12597597227668483
2887,473,-6173,2,3,5,40.0,-0.061280000000000015,14.4,0.16593752725639943
2888,405,-215,2,3,5,40.0,-0.0040999999999999995,13.0,0.14496791234913994
2889,500,-190,3,4,7,42.86,0.0032142857142857142,22.0,0.1857693448842582
2890,1004,-554,4,8,12,33.33,-0.009758333333333332,14.75,0.16205376917967693
2891,397,3353,3,0,3,100.0,0.047066666666666666,14.333333333333334,0.13476580166528648
2892,442,-6642,1,2,3,33.33,-0.0722,30.0,0.2230519413986373
2897,131,929,2,0,2,100.0,0.055,28.5,0.08632815024354668
2901,650,-4200,0,5,5,0.0,-0.036019999999999996,18.2,0.18009605394488054
2903,1736,-986,5,9,14,35.71,-0.001471428571428573,17.714285714285715,0.14424747580900074
2904,97,-147,1,1,2,50.0,-0.016649999999999998,12.0,0.21756381365925725
2905,731,479,4,3,7,57.14,0.003785714285714286,22.0,0.13702389986592883
2906,0,0,0,0,0,0.0,,,
2908,538,-38,2,2,4,50.0,0.0007500000000000024,23.75,0.18592486841613193
2910,130,-1630,0,1,1,0.0,-0.0694,7.0,0.17879444506170095
2911,983,-2703,4,6,10,40.0,0.004800000000000001,17.5,0.20893331778560498
2912,5225,-25525,1,6,7,14.29,-0.0366,23.142857142857142,0.17774828376079302
2913,51,449,1,0,1,100.0,0.1361,37.0,0.41352042043975246
2915,3820,-1520,6,6,12,50.0,-0.0036666666666666653,14.166666666666666,0.13769261231564955
2923,742,3458,4,1,5,80.0,0.03284,11.2,0.19202345569491702
2929,1394,-6244,2,3,5,40.0,-0.0006799999999999972,17.0,0.17200253303241256
2939,0,0,0,0,0,0.0,,,
3002,285,965,2,1,3,66.67,0.03856666666666667,20.0,0.2262461754909514
3003,2675,14075,7,5,12,58.33,0.017566666666666664,17.25,0.1956566721717822
3004,345,-185,3,2,5,60.0,-0.01074,11.0,0.20484483166274928
3005,1783,-3383,5,6,11,45.45,-0.0107,18.09090909090909,0.18099872983019727
3006,2109,4841,2,6,8,25.0,-0.0338375,9.125,0.16463374546022622
3008,174329,925671,10,5,15,66.67,0.023973333333333336,14.933333333333334,0.176422551491485
3010,1341,-5591,2,3,5,40.0,-0.013600000000000001,10.0,0.1768166955242906
3011,455,1865,6,0,6,100.0,0.03675,10.5,0.18100485319389983
3013,669,3531,5,2,7,71.43,0.036514285714285714,20.142857142857142,0.19503918260662625
3014,1510,1840,3,3,6,50.0,0.009600000000000003,9.666666666666666,0.21188298731818234
3015,1275,-625,4,3,7,57.14,-0.012342857142857142,20.285714285714285,0.18476709385063844
3016,2775,1345,6,6,12,50.0,-0.0053916666666666635,12.25,0.20126037259120885
3017,1762,-762,5,6,11,45.45,-0.009090909090909092,12.545454545454545,0.1694905818810872
3018,217,203,2,2,4,50.0,-0.017075,11.5,0.28633721207921564
3019,6966,-38066,5,9,14,35.71,-0.023707142857142854,13.0,0.16184967963293612
3021,292,-1772,2,3,5,40.0,-0.050960000000000005,10.6,0.2818031406822386
3022,1903,-2803,3,5,8,37.5,-0.004212500000000001,14.25,0.20297853810266583
3023,442,-1642,1,3,4,25.0,-0.0314,13.75,0.19830904002554378
3024,1239,311,4,8,12,33.33,-0.014000000000000004,7.666666666666667,0.16776687256420916
3025,1102,-5152,2,7,9,22.22,-0.03223333333333333,11.666666666666666,0.21728477398881477
3026,896,-796,2,2,4,50.0,-0.01395,15.25,0.15179606311817345
3027,777,443,5,2,7,71.43,0.023157142857142855,15.571428571428571,0.2557868701064647
3028,780,-5330,2,4,6,33.33,-0.04625000000000001,13.5,0.14576417920424348
3029,1911,-1561,5,9,14,35.71,0.00016428571428571404,19.285714285714285,0.19831799871144207
3030,1689,-3839,3,3,6,50.0,-0.017366666666666666,10.833333333333334,0.15212207351106646
3031,1649,-18799,3,7,10,30.0,-0.06467,11.4,0.2036029359459218
3032,228,-2148,1,2,3,33.33,-0.04766666666666667,21.666666666666668,0.13936835750040277
3033,714,-2694,1,5,6,16.67,-0.03518333333333333,19.166666666666668,0.2706009561490189
3034,12219,-106119,3,11,14,21.43,-0.04407142857142856,15.642857142857142,0.18433673235759857
3035,3122,-14122,4,4,8,50.0,-0.012775000000000003,14.125,0.18649873999134126
3036,1690,-7290,3,6,9,33.33,-0.027644444444444444,14.666666666666666,0.15131397736385466
3037,2389,4861,5,3,8,62.5,-0.006475,14.0,0.1774911059445808
3038,861,3629,7,4,11,63.64,0.028409090909090908,11.636363636363637,0.26036319357592186
3040,748,1762,4,4,8,50.0,0.0033375,9.5,0.17453771135438537
3041,1540,-17840,1,5,6,16.67,-0.0595,14.833333333333334,0.17811519288129915
3042,2692,-22242,2,5,7,28.57,-0.03648571428571429,9.0,0.18875659828145114
3043,1039,-1519,5,5,10,50.0,-0.024890000000000002,9.3,0.22789830300120908
3044,5448,-18798,5,8,13,38.46,-0.00643076923076923,12.076923076923077,0.18312772737246613
3045,680,-2480,1,2,3,33.33,-0.0178,37.333333333333336,0.11198100884311775
3046,711,-6411,2,6,8,25.0,-0.0553125,8.0,0.14798079953015073
3047,1025,-575,5,5,10,50.0,0.0008199999999999999,17.4,0.18662173572670587
3048,1447,-4247,5,6,11,45.45,-0.023827272727272728,16.90909090909091,0.16430016345748286
3049,73,-1223,0,1,1,0.0,-0.1002,9.0,0.2842476792082582
3050,413,-2173,1,5,6,16.67,-0.04911666666666666,13.166666666666666,0.13862223305206298
3051,671,-7671,0,1,1,0.0,-0.0639,5.0,0.3038991090992347
3052,769,-1179,6,5,11,54.55,-0.01310909090909091,12.454545454545455,0.19897079354663133
3054,0,0,0,0,0,0.0,,,
3055,287,-1737,0,2,2,0.0,-0.034600000000000006,14.0,0.18358034324545658
3056,111,-1261,0,2,2,0.0,-0.1062,25.5,0.21465523431920952
3057,1841,2909,6,4,10,60.0,0.004080000000000002,10.8,0.2538172686545824
3058,824,746,5,5,10,50.0,0.008999999999999998,19.5,0.2024554714354463
3059,2684,-11584,4,9,13,30.77,-0.02126923076923077,13.23076923076923,0.2077200892236069
3060,3899,-2349,7,3,10,70.0,0.0023199999999999983,14.6,0.24578940839548863
3062,2029,6921,7,6,13,53.85,0.0024307692307692333,14.923076923076923,0.172454233308126
3090,1205,-505,3,3,6,50.0,-0.0031,18.0,0.12860808068425666
3094,2120,6030,5,5,10,50.0,-0.004880000000000001,13.9,0.2064387032943536
3130,3023,13477,3,1,4,75.0,0.025325,12.5,0.16842700966600205
3138,0,0,0,0,0,0.0,,,
3149,864,4906,3,1,4,75.0,0.14785,17.5,0.19031708503585637
3164,1402,-3352,3,4,7,42.86,-0.0011571428571428566,12.714285714285714,0.17200350945993748
3167,1339,10711,4,1,5,80.0,0.04496,22.4,0.24110147776506974
3189,4943,26357,6,2,8,75.0,0.033425,15.625,0.17805858336905833
3209,954,-454,4,3,7,57.14,0.00018571428571428707,12.142857142857142,0.211955955427965
3229,971,-7191,3,5,8,37.5,-0.0255625,12.25,0.15745356683979933
3231,2396,7704,6,5,11,54.55,0.021463636363636362,11.545454545454545,0.1753870264119151
3257,2584,12516,4,2,6,66.67,0.028466666666666668,17.333333333333332,0.18624667392451114
3266,543,-4593,0,3,3,0.0,-0.04873333333333333,5.333333333333333,0.19533607855849203
3296,2255,-2755,8,7,15,53.33,-0.011959999999999998,16.466666666666665,0.22255283517532848
3305,2357,10493,4,2,6,66.67,0.025833333333333333,10.0,0.17803294015370216
3308,553,-4863,3,4,7,42.86,-0.0428,7.714285714285714,0.13193463811130485
3311,4308,-9958,3,7,10,30.0,-0.015600000000000003,17.4,0.22932628697745455
3312,604,816,5,3,8,62.5,0.010087500000000003,16.125,0.20618492882934333
3321,153,297,1,1,2,50.0,0.013949999999999999,24.0,0.2926365671926592
3338,2679,17871,7,2,9,77.78,0.03177777777777778,9.666666666666666,0.2385277120666412
3346,996,6504,3,0,3,100.0,0.03633333333333333,18.0,0.2441147494361724
3356,2570,24480,3,2,5,60.0,0.060320000000000006,14.2,0.2807141511206869
3376,6884,-112184,0,10,10,0.0,-0.09003000000000001,13.2,0.2260128780379033
3380,728,372,3,2,5,60.0,0.0006599999999999995,9.8,0.15526122450749447
3383,808,-478,2,6,8,25.0,-0.053625000000000006,8.625,0.26443182186328595
3406,10632,4868,4,3,7,57.14,0.010357142857142858,12.142857142857142,0.27320059414102527
3413,5785,10715,2,3,5,40.0,0.010160000000000002,14.0,0.2521285047031038
3416,1674,-4174,1,3,4,25.0,-0.01415,7.0,0.12278365814316738
3419,748,102,4,3,7,57.14,-0.0027285714285714335,11.0,0.19690288235303094
3432,401,-1151,1,2,3,33.33,-0.026833333333333334,9.0,0.2520940464927817
3437,680,-3480,2,4,6,33.33,-0.030916666666666662,11.833333333333334,0.24472894620375482
3443,5199,63901,5,0,5,100.0,0.0763,14.8,0.22908063887083657
3450,5910,27390,9,2,11,81.82,0.030127272727272728,20.181818181818183,0.17948139025549018
3454,4324,-10324,5,5,10,50.0,-0.006230000000000002,10.2,0.1608035986986883
3481,365,5,2,3,5,40.0,-0.0005999999999999969,13.8,0.15063965408934007
3494,1351,-11321,4,7,11,36.36,-0.03518181818181818,11.545454545454545,0.2296454519935649
3501,467,6083,2,0,2,100.0,0.08265,18.0,0.3095860263814785
3504,5353,-33103,7,7,14,50.0,-0.003721428571428572,17.071428571428573,0.2637858028677484
3515,3395,-13345,3,2,5,60.0,0.003240000000000001,13.4,0.19113129210876245
3518,2111,989,1,6,7,14.29,-0.02538571428571429,7.142857142857143,0.212143794072337
3528,165,-1165,0,1,1,0.0,-0.04,14.0,0.09238378174590678
3530,487,-3387,1,2,3,33.33,-0.02123333333333333,8.333333333333334,0.3825104744181169
3532,4543,5857,3,6,9,33.33,-0.01588888888888889,9.88888888888889,0.25779675257046736
3533,9660,35440,5,3,8,62.5,0.002887500000000001,12.0,0.18582896760304535
3535,1414,-5114,9,4,13,69.23,0.004207692307692307,14.461538461538462,0.2042213771869187
3536,121,-901,0,2,2,0.0,-0.0654,5.0,0.11017446993172153
3543,649,1151,1,1,2,50.0,0.039150000000000004,5.0,0.18296771573734893
3545,2679,12371,8,4,12,66.67,0.029933333333333336,11.75,0.18962239604756825
3550,848,4202,6,3,9,66.67,0.033100000000000004,19.22222222222222,0.16215549273590849
3557,314,1076,3,2,5,60.0,0.038680000000000006,13.0,0.21203783236265172
3563,3402,34298,4,0,4,100.0,0.04375,23.25,0.19645960146042707
3576,546,2904,4,2,6,66.67,0.028133333333333333,23.166666666666668,0.1700225424018772
3583,2566,8734,5,2,7,71.43,0.022914285714285713,13.0,0.19895527064361196
3588,1810,-14060,2,3,5,40.0,-0.035660000000000004,10.0,0.2197821618125378
3591,1258,-7408,6,3,9,66.67,0.011144444444444446,17.11111111111111,0.21122808556659278
3593,1355,5645,6,4,10,60.0,0.04544,12.3,0.2061701814532176
3596,2010,-3010,4,3,7,57.14,-0.012014285714285712,13.571428571428571,0.17727791074782576
3605,1465,-3065,3,4,7,42.86,-0.004071428571428566,9.428571428571429,0.2290722935702924
3607,923,577,2,2,4,50.0,-0.013800000000000002,16.25,0.11793915863021937
3617,980,10320,2,0,2,100.0,0.0624,15.5,0.16784187768561099
3622,962,-11562,0,5,5,0.0,-0.058640000000000005,9.8,0.17460749930008707
3645,1062,-7112,2,3,5,40.0,-0.03865999999999999,15.8,0.1880364631753711
3653,5986,1114,4,3,7,57.14,4.2857142857142104e-05,13.857142857142858,0.19498335051452395
3661,0,0,0,0,0,0.0,,,
3665,7508,-17508,4,3,7,57.14,-0.006714285714285714,10.428571428571429,0.15736778939969018
3669,423,3577,2,1,3,66.67,0.055200000000000006,20.666666666666668,0.17664239376478177
3673,15835,-13335,6,6,12,50.0,0.014008333333333336,13.583333333333334,0.1915854522287265
3679,2480,17220,4,1,5,80.0,0.03704,14.8,0.16074753282926993
3682,339,591,3,2,5,60.0,0.01726,19.6,0.17918787383146043
3686,1381,-16441,4,7,11,36.36,-0.025636363636363634,10.363636363636363,0.1761027016533174
3694,522,2378,3,1,4,75.0,0.02545,19.0,0.14965442136925133
3701,0,0,0,0,0,0.0,,,
3702,1299,2751,5,2,7,71.43,0.022157142857142854,23.0,0.12341294161169983
3703,147,-847,0,2,2,0.0,-0.0359,16.0,0.1301448367391551
3704,1077,-5277,4,6,10,40.0,-0.02778,15.9,0.1478045825610403
3705,602,2598,2,0,2,100.0,0.02515,29.5,0.178631136664526
3706,820,1580,3,2,5,60.0,0.011319999999999998,24.2,0.1760802148925324
3708,1126,6774,1,1,2,50.0,0.0378,22.0,0.10386227905912926
3711,1018,-118,1,1,2,50.0,-0.011849999999999996,7.5,0.18640509924849968
3712,700,800,2,2,4,50.0,0.006825000000000001,13.25,0.27653113648171246
3714,898,3302,2,0,2,100.0,0.024,7.5,0.1190665776715264
4104,671,-4271,0,2,2,0.0,-0.03655,7.0,0.18235818991082275
4106,1310,2240,4,3,7,57.14,-0.0008428571428571432,20.142857142857142,0.13232571577615923
4108,1181,1569,3,4,7,42.86,0.014042857142857147,15.0,0.19315211556335748
4119,2296,3904,3,2,5,60.0,0.008879999999999999,14.8,0.14018578724573
4133,2815,-30415,1,8,9,11.11,-0.04685555555555556,18.11111111111111,0.1394048858840343
4137,8131,-50631,3,4,7,42.86,-0.0324,13.571428571428571,0.21030081895260144
4142,836,-6286,1,3,4,25.0,-0.025225,9.25,0.18506307043662595
4155,2239,1081,6,4,10,60.0,0.012870000000000003,13.0,0.17956412281489328
4164,1724,4276,3,1,4,75.0,0.020600000000000004,29.25,0.24281503666811521
4190,2139,10861,2,2,4,50.0,0.027650000000000004,6.0,0.20535881340378964
4306,409,-2209,1,4,5,20.0,-0.0293,18.0,0.12345621377802903
4414,115,-955,0,2,2,0.0,-0.08235,3.5,0.22010695459145846
4426,2822,37368,7,1,8,87.5,0.0753,19.625,0.21172959381944548
4438,962,-5462,0,1,1,0.0,-0.0325,3.0,0.08105445001629241
4439,2561,-8561,1,2,3,33.33,-0.004533333333333334,14.333333333333334,0.1952952178601227
4526,1694,356,4,5,9,44.44,-0.006822222222222226,21.444444444444443,0.14732731942147953
4532,817,-2347,3,4,7,42.86,-0.009928571428571424,17.142857142857142,0.16710480069703673
4536,2209,-3809,1,2,3,33.33,-0.0015000000000000013,17.333333333333332,0.12114310246067084
4540,123,-1263,0,1,1,0.0,-0.0577,67.0,0.10361692413516987
4545,373,6577,2,0,2,100.0,0.1124,5.0,0.14774771821900434
4551,3556,-2856,1,4,5,20.0,-0.00878,11.6,0.149146641777448
4552,2053,-8303,3,2,5,60.0,-0.010960000000000001,16.4,0.12366931952252185
4555,406,-3206,0,1,1,0.0,-0.0448,4.0,0.1468535784635674
4557,0,0,0,0,0,0.0,,,
4560,0,0,0,0,0,0.0,,,
4562,104,-654,0,1,1,0.0,-0.0358,21.0,0.10422149498903921
4564,985,-9735,1,3,4,25.0,-0.05885,13.5,0.2113807752152011
4566,219,1731,1,0,1,100.0,0.048,13.0,0.0871749424674495
4571,1440,-6040,0,3,3,0.0,-0.02606666666666667,6.333333333333333,0.12455157918628183
4572,1517,-16017,0,2,2,0.0,-0.059550000000000006,10.5,0.09582119781156229
4576,1727,373,1,2,3,33.33,-0.005866666666666666,21.0,0.24084024874480256
4581,208,-2208,0,1,1,0.0,-0.0597,2.0,0.08733167955459309
4720,740,-1090,4,4,8,50.0,-0.0013249999999999963,12.375,0.210000110769144
4722,771,8819,4,2,6,66.67,0.07316666666666667,11.833333333333334,0.13191486849140208
4737,3288,-33988,1,7,8,12.5,-0.0553125,28.25,0.16313261685156094
4739,2731,30069,7,1,8,87.5,0.0541875,10.0,0.16843939123836624
4746,3495,-12045,3,6,9,33.33,-0.02157777777777778,17.0,0.15424862539689901
4755,0,0,0,0,0,0.0,,,
4763,2444,8556,2,1,3,66.67,0.019966666666666664,12.0,0.24280838539772645
4764,0,0,0,0,0,0.0,,,
4766,0,0,0,0,0,0.0,,,
4807,1135,-9965,1,2,3,33.33,-0.03813333333333333,11.333333333333334,0.26028567836070277
4904,217,333,1,0,1,100.0,0.0091,65.0,0.13127035967742762
4906,2757,3593,9,3,12,75.0,0.028883333333333334,18.083333333333332,0.21660338738711707
4912,4657,29643,6,2,8,75.0,0.034600000000000006,8.875,0.20503516825995005
4915,2485,815,6,4,10,60.0,0.017169999999999998,8.6,0.16654894380647386
4916,553,-4803,2,2,4,50.0,-0.0347,9.25,0.3115240004651234
4919,2498,13252,7,1,8,87.5,0.031025000000000004,25.375,0.20848860514641093
4927,628,1822,2,0,2,100.0,0.020200000000000003,10.0,0.10074244644351782
4930,147,-4747,0,1,1,0.0,-0.1654,6.0,0.2637620110372161
4934,303,1107,3,1,4,75.0,0.047075,22.25,0.23759452074417953
4935,1124,5376,1,2,3,33.33,0.0037333333333333337,8.0,0.2330759811055476
4938,1106,-11006,2,1,3,66.67,-0.02436666666666666,23.0,0.2074483939078473
4942,1862,488,3,5,8,37.5,0.0023999999999999994,16.875,0.14247213098073724
4943,1589,-19089,0,1,1,0.0,-0.067,11.0,0.175190305474491
4952,1125,9575,4,1,5,80.0,0.05202,12.6,0.20077842641037386
4956,924,4226,5,2,7,71.43,0.030200000000000005,14.0,0.1930294842738663
4958,4673,-13673,3,6,9,33.33,-0.014355555555555554,9.444444444444445,0.17463400674458043
4960,965,4555,6,3,9,66.67,0.03344444444444445,19.0,0.1841268793590961
4961,4337,-5227,5,3,8,62.5,0.002899999999999998,15.5,0.24213098066420205
4967,0,0,0,0,0,0.0,,,
4968,931,-6231,1,1,2,50.0,-0.035949999999999996,22.0,0.19745891106965818
4976,954,2896,1,3,4,25.0,-0.00935,18.5,0.2580418600636862
4977,1651,-3951,1,3,4,25.0,-0.0184,16.5,0.22624319975847446
4989,0,0,0,0,0,0.0,,,
4994,3544,12356,1,4,5,20.0,0.0031199999999999965,10.8,0.18779007115924723
4999,526,2674,1,1,2,50.0,0.043800000000000006,58.5,0.2083781790097885
5007,1320,3030,2,4,6,33.33,-0.011466666666666665,16.333333333333332,0.15470869188331005
5203,5942,-16942,4,4,8,50.0,-0.0102875,15.375,0.20589073312686065
5215,335,2715,1,1,2,50.0,0.04335,39.0,0.27765275638624975
5225,552,6648,2,1,3,66.67,0.07859999999999999,7.666666666666667,0.23192892875371726
5234,423,-3473,0,2,2,0.0,-0.048100000000000004,13.0,0.10115988233106998
5243,412,-1062,1,1,2,50.0,-0.012049999999999998,15.5,0.1169192718924098
5258,406,294,1,1,2,50.0,0.01975,9.0,0.18032420538313476
5269,13474,95026,6,1,7,85.71,0.04,11.571428571428571,0.2353865884945421
5283,0,0,0,0,0,0.0,,,
5284,795,4405,2,0,2,100.0,0.0338,20.0,0.10172742862237871
5285,1726,18024,4,1,5,80.0,0.03974,11.0,0.1526268537510625
5288,2081,9419,2,1,3,66.67,0.03596666666666666,12.666666666666666,0.1860141068938271
5388,1137,-7787,3,4,7,42.86,-0.025042857142857148,15.285714285714286,0.18113639397534773
5434,2654,-9154,3,4,7,42.86,-0.0029142857142857134,16.0,0.12450195790072198
5469,776,-6776,0,6,6,0.0,-0.0534,12.833333333333334,0.19381588076277412
5471,2077,20923,4,2,6,66.67,0.04576666666666666,15.666666666666666,0.20439113006739718
5484,1375,-13875,2,7,9,22.22,-0.04708888888888889,17.666666666666668,0.16287368068443317
5515,874,-2574,4,6,10,40.0,-0.011300000000000004,14.6,0.16912777809325336
5519,63,37,1,0,1,100.0,0.0049,6.0,0.10600654512418828
5521,644,-3974,1,8,9,11.11,-0.0422,14.0,0.14648009107401336
5522,1795,3405,3,3,6,50.0,0.0036500000000000018,27.333333333333332,0.1402379291346062
5525,296,2604,3,0,3,100.0,0.08876666666666667,9.333333333333334,0.11563854817863765
5531,1272,528,4,3,7,57.14,-0.001857142857142857,12.285714285714286,0.1840394411076692
5533,662,-4072,2,4,6,33.33,-0.039716666666666664,24.0,0.23122500702139573
5534,2411,-8961,3,4,7,42.86,-0.015085714285714286,12.0,0.15022660495883275
5538,677,-3577,1,3,4,25.0,-0.028525000000000002,14.0,0.1841266154081938
5546,680,3820,1,1,2,50.0,0.034,21.0,0.08087760573102076
5607,978,5772,4,2,6,66.67,0.03233333333333333,14.666666666666666,0.172295137528774
5608,1471,-4321,4,2,6,66.67,-0.0032833333333333325,10.333333333333334,0.18764536287692477
5706,1735,10915,5,1,6,83.33,0.04780000000000001,11.0,0.1939992001398518
5871,1833,-27733,0,2,2,0.0,-0.07585,16.0,0.11721555215680657
5876,267,-2717,0,1,1,0.0,-0.0573,5.0,0.08710788078591758
5880,0,0,0,0,0,0.0,,,
5906,192,-462,1,1,2,50.0,0.002100000000000001,4.5,0.21880708580353503
5907,968,-8868,1,4,5,20.0,-0.04443999999999999,15.0,0.13215402288887473
6005,489,1211,4,2,6,66.67,0.028033333333333337,27.166666666666668,0.1306496706324556
6024,218,-1018,0,1,1,0.0,-0.0269,11.0,0.0800520180370976
6108,1390,-1040,5,4,9,55.56,0.013344444444444443,12.88888888888889,0.18323033594273685
6112,229,1651,3,0,3,100.0,0.0483,20.0,0.12476349544533878
6115,1519,-14519,2,5,7,28.57,-0.05574285714285714,11.714285714285714,0.21226141434392676
6116,75,775,1,0,1,100.0,0.0724,10.0,0.21384540069708224
6117,635,4415,6,1,7,85.71,0.0612,11.428571428571429,0.1870231680755419
6120,1614,-4464,7,6,13,53.85,-0.009200000000000002,13.692307692307692,0.18933266931266143
6128,476,-5026,0,4,4,0.0,-0.063175,20.25,0.2243406207492878
6133,695,-1815,3,4,7,42.86,-0.014157142857142854,13.428571428571429,0.17042384517215772
6136,1220,-12320,0,4,4,0.0,-0.0546,6.5,0.13151712991162573
6139,1351,-6201,2,5,7,28.57,-0.012657142857142858,21.714285714285715,0.19736336495042933
6141,2130,-15930,5,10,15,33.33,-0.026773333333333323,23.666666666666668,0.19993946889848324
6142,1081,-3111,3,6,9,33.33,-0.013577777777777779,9.444444444444445,0.2127460210623674
6152,1837,-13747,4,11,15,26.67,-0.03457333333333333,16.333333333333332,0.2110203244465291
6153,2560,2140,8,7,15,53.33,0.010466666666666664,16.133333333333333,0.15497930762752307
6155,1826,-9826,5,7,12,41.67,-0.02313333333333333,14.083333333333334,0.19173969459072246
6164,938,3562,6,3,9,66.67,0.024144444444444437,11.444444444444445,0.18528240525342313
6165,288,-2568,0,4,4,0.0,-0.07064999999999999,21.75,0.22069037346788867
6166,1455,3945,4,3,7,57.14,0.010914285714285711,12.0,0.1631571646174368
6168,2060,-8610,7,8,15,46.67,-0.007833333333333333,13.733333333333333,0.24496479266700413
6176,4215,-1615,5,5,10,50.0,-0.01048,15.7,0.2054333269387228
6177,1436,-5986,3,6,9,33.33,-0.024311111111111106,18.666666666666668,0.13725435853867832
6183,138,342,2,0,2,100.0,0.018099999999999998,31.0,0.1355799515009517
6184,0,0,0,0,0,0.0,,,
6189,708,-608,2,1,3,66.67,0.004266666666666668,18.0,0.15030809968834205
6191,1877,-13527,4,6,10,40.0,-0.012370000000000004,12.5,0.19163761103711613
6192,1697,-9647,3,3,6,50.0,-0.0337,12.833333333333334,0.20887349010223888
6196,5393,1207,7,9,16,43.75,-0.006625,12.8125,0.18682066941694703
6197,1859,-15659,2,3,5,40.0,-0.031619999999999995,19.0,0.2081998322197125
6201,1195,-16195,1,7,8,12.5,-0.0665625,15.625,0.19230084924446358
6202,671,-3471,1,2,3,33.33,-0.014066666666666667,6.0,0.1463817821341237
6205,2831,4719,8,5,13,61.54,0.03215384615384616,21.0,0.18045879434820103
6206,1186,-19386,1,2,3,33.33,-0.08663333333333333,12.0,0.15381072892189596
6209,2695,8805,4,6,10,40.0,-0.01046,10.1,0.19064133717804171
6213,3679,39771,10,2,12,83.33,0.06579166666666666,10.083333333333334,0.17054516979359258
6214,715,-1165,1,2,3,33.33,-0.0189,25.0,0.1543760587292092
6215,1006,4644,5,3,8,62.5,0.0235,13.625,0.21340296952164967
6216,593,2307,3,1,4,75.0,0.027175000000000005,15.5,0.1780636067507852
6224,3547,-31447,4,5,9,44.44,-0.020066666666666663,6.222222222222222,0.18694505010164222
6225,568,6432,2,0,2,100.0,0.0708,19.5,0.13495404060145622
6226,1218,-8318,6,11,17,35.29,-0.029476470588235288,11.823529411764707,0.2146714638557329
6230,9538,3712,7,8,15,46.67,-0.009519999999999999,16.066666666666666,0.19943157665726816
6235,244,126,2,1,3,66.67,-0.011666666666666665,10.0,0.2598323868312466
6239,3046,-3896,3,3,6,50.0,-0.0010333333333333306,18.333333333333332,0.1863956282640397
6243,1725,-16025,1,7,8,12.5,-0.0515875,10.125,0.21398323728803653
6251,632,-1082,3,2,5,60.0,-0.01804,14.2,0.14083799191817725
6257,1019,-3069,4,4,8,50.0,-0.005300000000000003,14.375,0.19655981863071662
6269,4639,-38039,3,7,10,30.0,-0.04725,10.0,0.2236642659558258
6271,8411,2989,4,8,12,33.33,-0.0109,12.416666666666666,0.19402159248745865
6277,419,-4919,0,1,1,0.0,-0.0656,18.0,0.18820882589089472
6278,2886,-10486,4,5,9,44.44,-0.009966666666666667,11.11111111111111,0.15640898336621287
6281,757,5143,2,0,2,100.0,0.0409,41.5,0.17629205828493433
6282,2096,3204,8,7,15,53.33,0.005713333333333335,16.333333333333332,0.1797371859788256
6283,617,-6357,2,5,7,28.57,-0.06312857142857144,18.428571428571427,0.225649528071966
6285,4964,12536,6,6,12,50.0,0.013675,15.583333333333334,0.17834897754392812
6288,0,0,0,0,0,0.0,,,
6289,968,1382,4,6,10,40.0,-0.01656,13.2,0.2309073933898754
6405,1407,-6357,2,6,8,25.0,-0.009924999999999998,7.125,0.23015722018538115
6409,19486,215014,4,1,5,80.0,0.06356,9.8,0.1481456098020208
6412,586,-5536,0,2,2,0.0,-0.05355,32.5,0.0938877360619702
6414,5794,74206,3,0,3,100.0,0.08440000000000002,16.0,0.24080600524128712
6415,24839,-423839,2,2,4,50.0,-0.026075,12.5,0.20757877793275809
6416,1486,-1156,1,2,3,33.33,-0.0009333333333333323,10.333333333333334,0.18013944296660048
6431,502,-5552,2,2,4,50.0,-0.010774999999999996,8.25,0.19212473262863722
6438,828,-6328,1,1,2,50.0,-0.03865,20.5,0.1951405797297937
6442,304,-4304,0,1,1,0.0,-0.0783,7.0,0.14528101200286092
6443,0,0,0,0,0,0.0,,,
6449,1149,4301,2,2,4,50.0,0.035525,11.5,0.19204741557213528
6451,3109,4891,2,3,5,40.0,0.01396,7.8,0.14808642459872026
6456,3317,7783,3,2,5,60.0,0.013199999999999995,7.6,0.21674753728423787
6464,746,-2746,0,1,1,0.0,-0.0213,28.0,0.08644936980657847
6477,0,0,0,0,0,0.0,,,
6491,849,-4459,1,1,2,50.0,-0.02755,53.5,0.29129191488612005
6504,2204,-36204,0,2,2,0.0,-0.08465,9.0,0.12337448584248845
6505,4206,-406,4,4,8,50.0,0.002174999999999999,20.75,0.13010545571645418
6515,0,0,0,0,0,0.0,,,
6525,2304,-10804,2,4,6,33.33,-0.03538333333333333,8.333333333333334,0.1349548897376174
6531,12345,-89445,2,4,6,33.33,-0.043083333333333335,7.666666666666667,0.3406026657046583
6533,5874,-29674,1,4,5,20.0,-0.045180000000000005,10.0,0.2018066611831491
6541,944,-884,1,1,2,50.0,0.011249999999999998,15.5,0.14670900580803614
6552,0,0,0,0,0,0.0,,,
6558,1700,-3750,3,4,7,42.86,-0.0028142857142857197,14.428571428571429,0.26429594426480935
6573,968,-418,2,2,4,50.0,-0.00545,18.5,0.21047100598159685
6579,0,0,0,0,0,0.0,,,
6581,0,0,0,0,0,0.0,,,
6582,1424,-27524,0,2,2,0.0,-0.1078,15.5,0.2879456471058234
6591,2350,22650,5,0,5,100.0,0.05726,5.2,0.24343342790295766
6592,501,5999,1,0,1,100.0,0.0743,35.0,0.1477942872286644
6598,288,-2988,0,1,1,0.0,-0.0581,5.0,0.12104565299662329
6605,2838,2262,3,2,5,60.0,2.0000000000000574e-05,6.6,0.13403545028685074
6625,549,4201,1,1,2,50.0,0.0429,6.5,0.22227127624770793
6641,0,0,0,0,0,0.0,,,
6655,0,0,0,0,0,0.0,,,
6666,2099,-2099,1,1,2,50.0,-0.005600000000000001,21.0,0.11612497824222656
6668,578,-578,0,2,2,0.0,-0.005900000000000001,17.0,0.12579610295564936
6669,5865,65135,1,0,1,100.0,0.0686,41.0,0.1915985325258236
6670,1049,-549,0,1,1,0.0,-0.0031,28.0,0.09117026850258014
6671,502,-1152,1,1,2,50.0,-0.0115,5.5,0.13253243509874668
6672,471,6829,1,0,1,100.0,0.0912,15.0,0.3862852569677291
6674,0,0,0,0,0,0.0,,,
6698,0,0,0,0,0,0.0,,,
6706,544,-26944,0,1,1,0.0,-0.2384,18.0,0.3353606091777446
6715,1456,9044,1,1,2,50.0,0.034449999999999995,8.5,0.11493608186616522
6743,789,3711,1,0,1,100.0,0.0282,4.0,0.21230999283284113
6754,0,0,0,0,0,0.0,,,
6756,0,0,0,0,0,0.0,,,
8011,898,8492,4,2,6,66.67,0.032400000000000005,20.5,0.2665402348197512
8016,4682,-56582,3,4,7,42.86,-0.0323,7.285714285714286,0.2160813849094391
8021,1748,-15998,3,4,7,42.86,-0.02334285714285714,14.142857142857142,0.18355050930002628
8028,0,0,0,0,0,0.0,,,
8033,904,4126,8,3,11,72.73,0.028381818181818185,13.818181818181818,0.1823840338504488
8039,3188,1612,6,5,11,54.55,0.005363636363636362,19.363636363636363,0.2133960852298107
8046,5340,12560,3,4,7,42.86,-0.014871428571428567,6.714285714285714,0.17208776083815241
8070,2883,-21683,1,3,4,25.0,-0.048,16.75,0.11956666161578539
8072,2377,-12177,2,4,6,33.33,-0.021216666666666665,12.833333333333334,0.13061845289041674
8081,8638,-91438,3,7,10,30.0,-0.04443999999999999,8.0,0.2611549813483921
8101,473,-6603,0,5,5,0.0,-0.0834,14.6,0.18994317475393677
8103,1506,3694,4,3,7,57.14,0.00898571428571429,10.0,0.1753161718227905
8104,1568,117232,2,2,4,50.0,9.787624999999998,910.0,0.30642214446123284
8105,1823,-10603,9,8,17,52.94,-0.003435294117647057,13.352941176470589,0.22363283324234992
8110,517,-997,2,5,7,28.57,-0.0169,12.714285714285714,0.21122856091703193
8112,1121,2319,7,3,10,70.0,0.013069999999999998,11.5,0.1594399667586517
8114,5792,-5592,4,4,8,50.0,-0.0119,18.125,0.14186497382804308
8131,1010,-13410,1,4,5,20.0,-0.06620000000000001,9.0,0.22033516732254013
8150,1557,2643,5,3,8,62.5,0.008524999999999998,15.625,0.21295337128101632
8163,721,179,3,2,5,60.0,0.02476,10.2,0.144011771047002
8201,695,3145,4,1,5,80.0,0.05406,9.2,0.22043446087216328
8210,2293,7407,8,4,12,66.67,0.006333333333333334,18.666666666666668,0.2025940224103463
8213,1605,-4105,2,3,5,40.0,-0.01764,16.8,0.21921260612410767
8215,1309,-6209,3,6,9,33.33,-0.014511111111111107,16.333333333333332,0.16213694189342004
8222,306,3194,2,0,2,100.0,0.05435,21.5,0.17225042668209545
8249,877,-5427,1,3,4,25.0,-0.048799999999999996,11.75,0.15282770859634276
8261,789,-5439,1,5,6,16.67,-0.023016666666666658,18.833333333333332,0.23699506334071052
8271,1068,7082,4,1,5,80.0,0.033560000000000006,12.2,0.10780970007927233
8341,5489,-30989,1,4,5,20.0,-0.0319,13.4,0.12229394962209024
8367,362,-6662,0,1,1,0.0,-0.0999,6.0,0.21092375314057987
8374,832,9068,5,1,6,83.33,0.07261666666666668,14.833333333333334,0.24383488525474847
8404,0,0,0,0,0,0.0,,,
8411,0,0,0,0,0,0.0,,,
8422,5265,-20765,2,3,5,40.0,-0.01296,26.8,0.15037527686298838
8429,2895,-11995,3,6,9,33.33,-0.025377777777777777,13.444444444444445,0.16387306906775537
8442,235,-835,0,1,1,0.0,-0.0205,5.0,0.1109026364657304
8443,82,418,1,0,1,100.0,0.0312,20.0,0.08134727171587719
8454,9243,-93743,2,3,5,40.0,-0.054099999999999995,15.0,0.1882295982247177
8462,2079,-17579,0,3,3,0.0,-0.052,10.666666666666666,0.21451051100564267
8463,719,-69,2,3,5,40.0,0.007620000000000007,16.2,0.14584136321177538
8464,18554,52446,6,4,10,60.0,0.024979999999999995,13.0,0.13691336733738052
8466,785,7515,2,0,2,100.0,0.060149999999999995,31.5,0.20445870383321063
8467,360,-5810,0,2,2,0.0,-0.0843,24.0,0.11269062811124975
8473,666,-4466,0,2,2,0.0,-0.03925,39.0,0.10529333526659157
8478,0,0,0,0,0,0.0,,,
8480,0,0,0,0,0,0.0,,,
8481,495,5405,1,0,1,100.0,0.0675,29.0,0.1988448706656738
8482,799,-2799,0,1,1,0.0,-0.0203,60.0,0.14243026161379713
8488,0,0,0,0,0,0.0,,,
8499,2174,3326,2,1,3,66.67,0.008433333333333334,31.0,0.20226315036010015
8926,0,0,0,0,0,0.0,,,
8940,466,2134,2,2,4,50.0,0.0225,18.25,0.16875463905052057
8996,2409,-7559,4,5,9,44.44,-0.0035888888888888915,11.333333333333334,0.15694170040877906
9802,3295,-11495,3,3,6,50.0,-0.0124,6.333333333333333,0.10579969841780223
9902,0,0,0,0,0,0.0,,,
9904,1277,5773,5,2,7,71.43,0.02722857142857143,17.571428571428573,0.23053376441703669
9905,442,-742,1,2,3,33.33,-0.0198,25.333333333333332,0.1694657625885545
9906,43,47,1,0,1,100.0,0.049,3.0,0.4591639544428969
9907,936,-816,5,4,9,55.56,0.0034444444444444453,13.444444444444445,0.16587608299473625
9908,84,1216,1,0,1,100.0,0.0928,5.0,0.14976352085718148
9910,4150,-35550,2,5,7,28.57,-0.03517142857142857,17.428571428571427,0.1727345812380608
9911,522,-2172,2,3,5,40.0,-0.019659999999999997,10.2,0.15130762386007318
9912,57,-807,0,1,1,0.0,-0.1271,14.0,0.2574472786505837
9914,11788,-88,6,7,13,46.15,-0.002369230769230774,19.923076923076923,0.16459839415503616
9917,905,4895,2,1,3,66.67,0.03203333333333333,13.0,0.13156729918377552
9918,0,0,0,0,0,0.0,,,
9919,305,1045,1,1,2,50.0,0.0049499999999999995,21.0,0.1916529493623027
9921,455,-3555,1,1,2,50.0,-0.04255,20.0,0.12370014704461096
9924,301,-101,1,1,2,50.0,0.0028000000000000004,16.5,0.14235243509901474
9925,669,1681,2,2,4,50.0,0.014625,21.75,0.10623124770648745
9926,80,520,1,0,1,100.0,0.0403,5.0,0.20763168890232575
9927,1501,-12951,3,2,5,60.0,-0.03562,11.2,0.2323958581505588
9928,64,-404,0,1,1,0.0,-0.0484,11.0,0.12263933208199473
9929,811,1089,9,4,13,69.23,0.023453846153846155,17.076923076923077,0.20313807541028306
9930,95,-1095,0,1,1,0.0,-0.064,39.0,0.20988991655473965
9931,0,0,0,0,0,0.0,,,
9933,97,1803,1,0,1,100.0,0.1194,20.0,0.22396974625776478
9934,842,-442,4,3,7,57.14,0.00014285714285714495,18.142857142857142,0.16498911076154843
9935,576,-3086,3,3,6,50.0,-0.020133333333333326,11.333333333333334,0.2432814042275302
9937,319,181,1,1,2,50.0,0.00335,14.0,0.08769621290193774
9938,3106,-7486,3,6,9,33.33,-0.004444444444444443,9.444444444444445,0.1522809432720017
9939,1591,2859,3,2,5,60.0,0.004380000000000004,22.0,0.1325367294619643
9940,2103,-12153,2,4,6,33.33,-0.015483333333333337,9.166666666666666,0.12491473499340593
9941,596,4904,2,0,2,100.0,0.04715,31.5,0.21535131007967212
9942,3120,-820,4,3,7,57.14,-0.009128571428571429,19.714285714285715,0.20164380587399236
9943,457,-4207,1,3,4,25.0,-0.06265000000000001,15.0,0.1665911477970206
9944,853,2997,4,1,5,80.0,0.01136,10.6,0.18000446117809393
9945,2395,-4955,3,8,11,27.27,-0.027054545454545453,15.545454545454545,0.17396093242134897
9946,623,1167,4,3,7,57.14,0.0219,10.714285714285714,0.21047408183280067
9955,1345,-8395,2,6,8,25.0,-0.022274999999999996,15.875,0.19195926132801344
9958,1523,-14293,1,7,8,12.5,-0.040912500000000004,17.5,0.16938658266856443
1312A,210,820,2,1,3,66.67,0.02613333333333333,10.0,0.16623410491570198
2002A,249,-2399,0,1,1,0.0,-0.0543,4.0,0.21501729475233078
2836A,0,0,0,0,0,0.0,,,
2838A,0,0,0,0,0,0.0,,,
2881A,370,1630,1,0,1,100.0,0.0264,26.0,0.11993815137307728
2881B,361,839,1,0,1,100.0,0.0138,26.0,0.1320268464058416
2882A,0,0,0,0,0,0.0,,,
2882B,0,0,0,0,0,0.0,,,
2887E,0,0,0,0,0,0.0,,,
2887F,0,0,0,0,0,0.0,,,
2888A,0,0,0,0,0,0.0,,,
2888B,0,0,0,0,0,0.0,,,
2891B,0,0,0,0,0,0.0,,,
2891C,0,0,0,0,0,0.0,,,
2897A,0,0,0,0,0,0.0,,,
3702A,0,0,0,0,0,0.0,,,
5871A,0,0,0,0,0,0.0,,,
9941A,0,0,0,0,0,0.0,,,
1240,0,0,0,0,0,0.0,,,
1258,272,-2822,0,2,2,0.0,-0.058300000000000005,16.5,0.1063261153005447
1259,895,-9395,0,1,1,0.0,-0.0589,13.0,0.11914158844894884
1264,3261,4739,2,1,3,66.67,0.00683333333333333,21.333333333333332,0.19292247433414875
1268,797,703,1,0,1,100.0,0.0052,35.0,0.2542001197420716
1336,375,185,3,2,5,60.0,0.0032200000000000006,16.6,0.16522457478915756
1565,28159,-120159,2,10,12,16.67,-0.021966666666666666,10.166666666666666,0.15862770791814892
1569,938,-8488,2,2,4,50.0,-0.0216,15.0,0.23724442535078888
1570,361,-1061,2,3,5,40.0,-0.021379999999999996,14.4,0.19886400317403594
1580,3361,-22111,1,5,6,16.67,-0.02455,29.0,0.1664698460602468
1584,728,-2528,3,5,8,37.5,-0.0150625,17.75,0.14434988541431354
1586,1091,2609,2,3,5,40.0,0.008859999999999996,17.0,0.2515307426803637
1591,599,-749,1,2,3,33.33,0.01113333333333334,17.333333333333332,0.27105884057991064
1593,145,205,1,0,1,100.0,0.0084,32.0,0.31008724553369627
1595,2582,7468,3,4,7,42.86,0.010814285714285712,13.428571428571429,0.15676891304394885
1599,807,-8407,0,3,3,0.0,-0.05843333333333334,33.333333333333336,0.15124081394321717
1742,840,-440,2,6,8,25.0,0.04056250000000001,9.5,0.1910783404010365
1752,2122,5628,6,4,10,60.0,0.012330000000000002,18.4,0.18706605031555573
1777,1218,5982,3,0,3,100.0,0.05306666666666666,22.0,0.1465463021538802
1781,2291,-1131,6,9,15,40.0,0.02530666666666666,12.466666666666667,0.1747164739033571
1784,239,1861,1,0,1,100.0,0.0472,14.0,0.1749901323499201
1785,1897,2603,3,5,8,37.5,-0.0018624999999999978,17.75,0.1688650013290277
1788,1274,-74,2,1,3,66.67,0.0088,22.666666666666668,0.19566581014166187
1796,244,-2594,0,1,1,0.0,-0.0597,12.0,0.13220384255933926
1799,1260,-2540,4,6,10,40.0,-0.001970000000000001,10.6,0.14659874026192077
1813,505,-5205,1,2,3,33.33,-0.0346,12.0,0.14347050805695347
1815,609,4861,4,2,6,66.67,0.0479,19.0,0.2518182303092864
2035,0,0,0,0,0,0.0,,,
2061,67,-247,0,1,1,0.0,-0.0268,6.0,0.11075604259253513
2063,1209,-12909,0,4,4,0.0,-0.07015,13.0,0.18381534115500409
2064,0,0,0,0,0,0.0,,,
2065,536,6264,2,0,2,100.0,0.07145,15.5,0.2379553289328662
2066,1102,1998,1,1,2,50.0,0.0006499999999999995,13.5,0.18479124411821468
2067,198,1252,1,1,2,50.0,0.07114999999999999,4.0,0.13577197545485298
2070,173,-973,0,1,1,0.0,-0.0322,5.0,0.14653135466722245
2221,436,-2736,1,2,3,33.33,-0.01783333333333333,25.0,0.1141668626656045
2230,335,5365,3,0,3,100.0,0.11499999999999999,23.0,0.23782903832275334
2235,661,-4661,0,1,1,0.0,-0.0402,18.0,0.15583432167093614
2596,79,-279,0,1,1,0.0,-0.0213,15.0,0.14286641923483612
2640,2224,-15024,1,2,3,33.33,-0.0387,12.0,0.12890604999472507
2641,354,46,1,1,2,50.0,-0.00115,2.0,0.2852792825985869
2643,567,133,1,1,2,50.0,0.025000000000000005,11.0,0.19912458971677316
2718,0,0,0,0,0,0.0,,,
2719,380,-2840,0,3,3,0.0,-0.04323333333333334,27.666666666666668,0.15767772461525284
2724,52,-252,0,1,1,0.0,-0.0621,7.0,0.12457025404318278
2726,1845,-2845,2,2,4,50.0,-0.008100000000000001,15.75,0.12290443694694658
2729,1384,12616,1,0,1,100.0,0.0558,25.0,0.10549371457640833
2732,2729,-45729,0,4,4,0.0,-0.08940000000000001,7.5,0.2126204135597184
2734,1005,-2055,3,4,7,42.86,-0.004314285714285716,13.428571428571429,0.20775406173175806
2736,402,-1302,2,1,3,66.67,-0.0019333333333333331,7.333333333333333,0.11450704910866527
2740,314,486,2,1,3,66.67,-0.014099999999999996,6.0,0.2659338881962226
2743,89,501,1,0,1,100.0,0.0343,28.0,0.1919185524002771
2745,713,-7513,1,4,5,20.0,-0.0524,9.4,0.28150712707470105
2752,0,0,0,0,0,0.0,,,
2754,376,6924,1,0,1,100.0,0.1182,14.0,0.2375590807179424
2755,0,0,0,0,0,0.0,,,
2916,75,325,1,0,1,100.0,0.0285,2.0,0.15295354119813687
2924,435,-3335,0,1,1,0.0,-0.0435,29.0,0.19522229174921302
2926,0,0,0,0,0,0.0,,,
2937,104,-604,0,1,1,0.0,-0.033,12.0,0.1384412789536802
3064,1909,3841,4,3,7,57.14,0.010442857142857141,8.857142857142858,0.1743158025487105
3066,723,-9303,1,6,7,14.29,-0.06277142857142858,23.0,0.2424933618384529
3067,656,3344,3,1,4,75.0,0.025425000000000003,20.0,0.15779211044891933
3071,248,-1448,1,2,3,33.33,-0.032766666666666666,14.666666666666666,0.20184239636927362
3073,1229,1471,3,4,7,42.86,0.009200000000000003,11.285714285714286,0.21347040799220837
3078,1059,1591,3,3,6,50.0,0.002533333333333333,23.166666666666668,0.15482510571669805
3081,7152,37348,3,1,4,75.0,0.037,19.0,0.18191903049868663
3083,5042,-9092,6,5,11,54.55,0.003972727272727272,9.636363636363637,0.1763985294235682
3085,2013,27,5,8,13,38.46,-0.010469230769230769,6.3076923076923075,0.1932692785047466
3086,1063,3547,7,4,11,63.64,0.028454545454545458,14.272727272727273,0.21694903456602166
3088,1976,-13576,3,4,7,42.86,-0.03378571428571428,9.571428571428571,0.19097810260790174
3089,883,-333,3,5,8,37.5,-0.0002124999999999974,10.75,0.181134967479049
3092,2062,-6312,3,9,12,25.0,-0.028450000000000003,13.916666666666666,0.16319621126442194
3093,2157,-7257,3,5,8,37.5,-0.0065749999999999975,17.75,0.19129063109062125
3095,1058,2142,3,2,5,60.0,0.03282,14.6,0.19139039899279928
3105,1299,-20499,0,4,4,0.0,-0.089025,8.5,0.22081151841441876
3114,1414,-664,5,8,13,38.46,-0.002576923076923078,16.153846153846153,0.16988142679433416
3115,230,-480,1,2,3,33.33,-0.018733333333333334,10.333333333333334,0.1113396608627814
3118,961,-2161,1,3,4,25.0,-0.015325,8.0,0.16030398035762733
3122,250,-4000,0,3,3,0.0,-0.0872,17.333333333333332,0.15092049353074444
3128,662,-1612,2,4,6,33.33,-0.004150000000000001,5.833333333333333,0.1925304997974371
3131,12037,-57537,3,4,7,42.86,-0.020628571428571423,15.857142857142858,0.1905057636134319
3141,105,1495,1,0,1,100.0,0.089,15.0,0.4771864635551839
3147,0,0,0,0,0,0.0,,,
3152,1849,8651,2,1,3,66.67,0.036866666666666666,7.0,0.19739303744986106
3162,265,-6205,0,2,2,0.0,-0.1269,12.5,0.1891287192641521
3163,1927,-17477,3,2,5,60.0,-0.012899999999999995,17.8,0.199708834815039
3169,1364,-9564,1,6,7,14.29,-0.03335714285714286,13.0,0.22647373720416394
3171,858,-1358,4,5,9,44.44,-0.014533333333333334,17.88888888888889,0.18726839314573554
3176,5743,-51543,2,5,7,28.57,-0.03501428571428572,13.0,0.24988419194390685
3178,0,0,0,0,0,0.0,,,
3188,1090,250,5,8,13,38.46,-0.004584615384615387,16.076923076923077,0.20611246907370603
3191,1451,-9901,4,5,9,44.44,-0.029500000000000002,12.777777777777779,0.1915984731577078
3202,848,-5798,1,5,6,16.67,-0.03193333333333333,8.0,0.14870957055528175
3205,0,0,0,0,0,0.0,,,
3206,853,5747,4,1,5,80.0,0.040659999999999995,20.4,0.1704674211709117
3207,755,495,5,5,10,50.0,0.009470000000000003,10.3,0.22853657337625424
3211,4940,-55890,0,8,8,0.0,-0.06223750000000001,11.125,0.18579642579068728
3213,2151,15549,4,1,5,80.0,0.0446,11.6,0.10965445962976399
3217,1201,749,2,3,5,40.0,-0.012660000000000001,9.0,0.2038575963827657
3218,1595,1055,5,4,9,55.56,0.004233333333333331,20.666666666666668,0.17610014632450552
3219,243,-4143,0,2,2,0.0,-0.09375,8.5,0.2630306444314515
3221,1299,2751,4,4,8,50.0,0.017475,9.75,0.18283502783396705
3224,360,2630,3,1,4,75.0,0.0356,13.5,0.15720896216646707
3226,308,-2708,1,1,2,50.0,-0.02805,7.5,0.22662728729637627
3227,5677,42823,4,2,6,66.67,0.03006666666666667,18.0,0.1940807347285776
3228,6345,-54245,5,5,10,50.0,0.0016100000000000003,10.6,0.20601443280828566
3230,1093,-593,3,5,8,37.5,0.0031624999999999986,20.375,0.22401759203933724
3232,1370,-9630,3,4,7,42.86,0.0071142857142857075,14.428571428571429,0.2401635390158474
3234,0,0,0,0,0,0.0,,,
3236,1280,940,5,5,10,50.0,-0.011380000000000003,11.8,0.2025484358044321
3252,309,-2259,1,2,3,33.33,-0.017366666666666666,8.333333333333334,0.30222398289915314
3259,1534,-9284,2,8,10,20.0,-0.03837,10.8,0.23572475728812262
3260,3631,5669,6,5,11,54.55,0.01979090909090909,12.727272727272727,0.18975772666858867
3264,1932,2568,6,5,11,54.55,0.004245454545454546,13.636363636363637,0.21266895380600373
3265,156,-1296,1,1,2,50.0,-0.015050000000000001,8.0,0.25924787624820333
3268,2451,4849,3,6,9,33.33,-0.01637777777777778,18.88888888888889,0.24144145144296145
3272,730,4170,2,0,2,100.0,0.03665,16.5,0.18804790458260645
3276,77,-327,0,1,1,0.0,-0.0262,29.0,0.1937894662589419
3284,523,3627,3,2,5,60.0,0.03866000000000001,9.0,0.19372882087092638
3285,222,1128,2,0,2,100.0,0.03285,24.5,0.2210148840581645
3287,617,-4137,0,7,7,0.0,-0.04397142857142857,17.571428571428573,0.20244254241224055
3288,1653,2157,5,8,13,38.46,-0.009446153846153844,11.0,0.22053096063138067
3289,1190,-15590,0,4,4,0.0,-0.08115,9.75,0.1590447429898746
3290,1160,3770,9,4,13,69.23,0.013361538461538463,11.384615384615385,0.16377187235588928
3293,11125,-83125,2,5,7,28.57,-0.03535714285714286,17.714285714285715,0.19448822913004785
3294,441,1009,3,2,5,60.0,0.01874,12.6,0.20357973151171865
3297,983,-883,3,4,7,42.86,0.0006285714285714307,9.428571428571429,0.21823716945749655
3303,284,216,1,1,2,50.0,0.00655,4.5,0.10777779761456407
3306,1969,-11269,2,5,7,28.57,-0.029842857142857143,5.142857142857143,0.18699706545707837
3310,395,-2905,2,2,4,50.0,0.009899999999999999,14.5,0.22372597347907625
3313,752,8048,5,1,6,83.33,0.06238333333333334,11.166666666666666,0.1653272165112001
3317,874,-3224,2,3,5,40.0,-0.02188,15.0,0.14946168394706622
3322,170,100,1,1,2,50.0,-0.024949999999999996,17.0,0.3686018126346452
3323,394,-1944,2,1,3,66.67,0.010766666666666666,20.666666666666668,0.21484865677647336
3324,3976,18174,6,3,9,66.67,0.011488888888888887,7.444444444444445,0.2444399305563021
3325,771,-2021,3,3,6,50.0,-0.002050000000000001,10.333333333333334,0.20187213553710048
3332,187,-4187,0,1,1,0.0,-0.1196,31.0,0.31933800994927375
3339,1804,3976,6,6,12,50.0,-0.00040000000000000045,15.5,0.21397150757105607
3354,788,-3658,3,3,6,50.0,0.0028166666666666635,15.833333333333334,0.15823363105526422
3360,724,-944,3,5,8,37.5,-0.005625000000000005,11.625,0.25266196369953087
3362,684,-1484,3,2,5,60.0,0.011919999999999997,6.2,0.1558619106165482
3363,470,780,2,1,3,66.67,0.014533333333333337,24.333333333333332,0.2922561410261261
3372,564,-2144,4,5,9,44.44,-0.023833333333333335,15.777777777777779,0.18279078532188936
3373,2170,12180,6,1,7,85.71,0.05118571428571429,11.285714285714286,0.17336180996208467
3374,1366,-10166,1,2,3,33.33,-0.0226,7.333333333333333,0.2676783618618031
3379,138,-1048,0,2,2,0.0,-0.05105,6.0,0.12926942601777536
3388,2779,3321,3,2,5,60.0,-0.010079999999999997,23.0,0.21849418597290016
3390,730,-7930,1,3,4,25.0,-0.050775,14.5,0.11039631832065022
3402,692,-1392,3,2,5,60.0,-0.009219999999999997,14.0,0.10794041678492183
3426,300,-2900,0,1,1,0.0,-0.0546,6.0,0.09464604755325023
3434,681,-3011,3,6,9,33.33,-0.0216,8.222222222222221,0.21952600903404745
3438,1742,-2742,5,2,7,71.43,0.021557142857142855,14.714285714285714,0.21367411281665497
3441,650,1500,3,2,5,60.0,0.01388,6.2,0.28336365767431354
3444,925,2175,2,4,6,33.33,0.005716666666666666,11.166666666666666,0.17246599042192856
3455,2072,8078,5,1,6,83.33,0.03936666666666667,20.833333333333332,0.21951538042897134
3465,65,235,1,0,1,100.0,0.0294,35.0,0.2560058650124921
3466,1306,-3206,4,4,8,50.0,-0.007987500000000002,15.375,0.1672747918341837
3479,2120,5080,4,4,8,50.0,0.01815,23.0,0.20096034607813484
3483,2434,-10184,3,5,8,37.5,-0.019725,21.375,0.2111803430719049
3484,1809,1641,3,4,7,42.86,-0.009028571428571426,11.714285714285714,0.20880925688632826
3489,337,-3927,1,2,3,33.33,-0.07363333333333333,20.666666666666668,0.29814287115988836
3490,2264,-21664,3,8,11,27.27,-0.04154545454545455,10.363636363636363,0.22838291576275035
3491,4412,20288,7,2,9,77.78,0.03584444444444444,11.666666666666666,0.2032219756478434
3492,502,4598,2,1,3,66.67,0.050266666666666675,18.333333333333332,0.21114608105259594
3498,2419,2131,5,4,9,55.56,0.008477777777777777,22.0,0.2097330654368895
3499,895,-55,5,4,9,55.56,0.012333333333333332,17.444444444444443,0.1964489737613343
3508,1270,15530,4,1,5,80.0,0.05856,9.8,0.17433571325632574
3511,1137,-5137,4,4,8,50.0,-0.0196625,13.0,0.22056132216444388
3512,451,6499,2,0,2,100.0,0.09230000000000001,13.5,0.1800336109602283
3516,249,-1899,0,3,3,0.0,-0.04703333333333334,12.0,0.12426841168824258
3520,2636,8854,5,5,10,50.0,0.02336,12.3,0.24025445940961226
3521,559,-1259,2,4,6,33.33,-0.0034833333333333335,12.166666666666666,0.26749570683354706
3522,1030,-5880,1,7,8,12.5,-0.051525,4.75,0.19711947168151273
3523,1263,-12373,2,7,9,22.22,-0.003277777777777777,8.666666666666666,0.25689849761831685
3526,3095,1705,3,5,8,37.5,-0.015375,18.0,0.2602047597431313
3527,7159,16541,7,4,11,63.64,0.024463636363636364,8.909090909090908,0.2005853087181724
3529,18354,162846,5,5,10,50.0,0.005230000000000001,18.4,0.22113679629266086
3531,606,-3406,1,3,4,25.0,-0.020625000000000004,7.25,0.19661843198036505
3537,1020,-4270,4,3,7,57.14,-0.026571428571428572,6.857142857142857,0.16001778158327457
3540,1013,-7113,1,2,3,33.33,-0.046066666666666665,8.0,0.15721652316946386
3541,226,1724,1,0,1,100.0,0.0463,20.0,0.1109852409217249
3546,5520,-46720,2,9,11,18.18,-0.05979090909090909,11.727272727272727,0.15218286042427895
3548,2326,-11976,3,6,9,33.33,-0.022766666666666668,12.0,0.19998703582737146
3551,1279,5071,3,2,5,60.0,0.019160000000000003,20.8,0.17900562079605692
3552,2134,-13434,1,3,4,25.0,-0.030674999999999997,20.5,0.1619752513339508
3555,137,-1837,0,1,1,0.0,-0.0747,22.0,0.18425054182613754
3556,3667,22533,6,2,8,75.0,0.045287499999999994,16.25,0.21105549943795943
3558,3165,3035,2,2,4,50.0,0.0017499999999999998,18.25,0.11371822196188108
3564,648,-9198,0,3,3,0.0,-0.07583333333333332,15.333333333333334,0.2721900635826311
3567,519,4681,3,0,3,100.0,0.055266666666666665,24.0,0.2441773742238802
3570,1345,-20245,0,4,4,0.0,-0.085575,7.0,0.2234558061796454
3577,1120,1480,4,2,6,66.67,0.012916666666666667,11.666666666666666,0.17840113720396547
3580,897,-13247,1,4,5,20.0,-0.06048,17.0,0.26583479400223886
3581,488,3762,3,1,4,75.0,0.053625,21.0,0.2644173206390443
3587,3922,24128,6,2,8,75.0,0.050375,9.0,0.22393456886465557
3594,388,-8338,0,2,2,0.0,-0.1403,15.5,0.16534276189514674
3597,0,0,0,0,0,0.0,,,
3609,374,-924,2,1,3,66.67,0.015,10.666666666666666,0.1377541661740096
3611,8637,-60737,2,5,7,28.57,-0.02855714285714286,30.714285714285715,0.19910966722980822
3615,1671,11879,3,4,7,42.86,0.017685714285714284,8.857142857142858,0.13833202713341472
3623,607,93,3,1,4,75.0,-0.006625000000000004,10.75,0.15103432660847754
3624,744,2056,2,2,4,50.0,0.025450000000000004,23.5,0.25204072918142756
3625,241,-1091,0,3,3,0.0,-0.03326666666666667,16.0,0.1459360700023876
3628,2126,-17226,0,4,4,0.0,-0.04005,11.25,0.1789859197776703
3629,150,-820,1,1,2,50.0,-0.018000000000000002,8.0,0.15967129246781708
3630,1985,27115,4,1,5,80.0,0.07478,11.0,0.312609364657828
3631,742,-11392,0,3,3,0.0,-0.08256666666666666,13.0,0.17099324719604617
3632,1057,2113,3,6,9,33.33,0.0016888888888888865,10.444444444444445,0.1621359647646681
3642,519,-2619,2,3,5,40.0,-0.029740000000000006,7.0,0.21550682601203305
3646,992,8,4,4,8,50.0,0.019325000000000002,17.875,0.22673960981502894
3652,446,-2996,1,3,4,25.0,-0.026524999999999996,9.5,0.18889105354511504
3663,835,-3785,3,2,5,60.0,-0.020640000000000002,12.2,0.1857396770830529
3664,775,1175,5,2,7,71.43,0.049542857142857145,8.857142857142858,0.1840706974360193
3666,842,-13392,0,5,5,0.0,-0.09638,13.4,0.29243579612192194
3672,430,-280,2,1,3,66.67,-0.0018333333333333337,15.0,0.1713093472111018
3675,1492,-3392,3,3,6,50.0,-0.005133333333333333,21.833333333333332,0.20038969894488937
3680,3325,-3775,1,3,4,25.0,-0.03434999999999999,11.75,0.1944335066883725
3684,966,4634,2,1,3,66.67,0.027866666666666668,17.0,0.13392738756949915
3685,1330,1020,3,2,5,60.0,-0.001999999999999999,16.0,0.1655686096262834
3687,4672,-21872,3,4,7,42.86,-0.019114285714285712,8.142857142857142,0.1589653039394423
3689,687,11463,3,0,3,100.0,0.09673333333333334,20.666666666666668,0.2673269027610637
3691,19170,-196170,3,7,10,30.0,-0.045899999999999996,15.9,0.2072067689116092
3693,1240,-6290,2,3,5,40.0,-0.02904,7.6,0.2586096717339018
3707,1427,-10497,1,3,4,25.0,-0.038,10.5,0.26316351592355575
3709,0,0,0,0,0,0.0,,,
3710,64,-114,0,1,1,0.0,-0.014,5.0,0.1745231545560073
3713,213,-3263,0,1,1,0.0,-0.0841,15.0,0.1363809710687982
4102,1783,-3383,9,4,13,69.23,0.01233076923076923,13.307692307692308,0.1883288984290705
4105,2008,8292,3,2,5,60.0,0.020079999999999997,10.2,0.1295134504058783
4107,992,-6062,2,4,6,33.33,-0.026433333333333333,10.833333333333334,0.19454808055122277
4109,1253,-7753,4,7,11,36.36,-0.027845454545454548,13.545454545454545,0.14115785041158735
4111,1025,975,3,4,7,42.86,0.010557142857142853,23.0,0.1777532230994038
4113,95,-265,1,1,2,50.0,-0.048499999999999995,10.5,0.39968443479292504
4114,1926,-8226,6,6,12,50.0,-0.016816666666666664,14.583333333333334,0.15761909855504633
4116,0,0,0,0,0,0.0,,,
4120,3272,-3722,5,6,11,45.45,-0.011581818181818181,15.454545454545455,0.17643629868845895
4121,1016,-1566,5,5,10,50.0,0.0001999999999999988,13.4,0.20294785008527985
4123,989,6111,2,1,3,66.67,0.021433333333333335,10.333333333333334,0.20506327360451335
4126,551,-5251,0,2,2,0.0,-0.06185,13.0,0.2957348555793996
4127,540,-5340,1,4,5,20.0,-0.07188,7.2,0.13784340654567795
4128,2834,6166,6,5,11,54.55,0.004263636363636361,11.545454545454545,0.1984375082987917
4129,2249,2101,5,3,8,62.5,0.0189875,16.5,0.14634846720974704
4130,1861,-461,4,3,7,57.14,0.010071428571428568,18.714285714285715,0.2124382267727336
4131,69,1681,1,0,1,100.0,0.2155,14.0,0.14078866776633836
4138,1943,-8943,3,1,4,75.0,0.008649999999999998,20.75,0.11449497068736231
4139,1614,2086,1,3,4,25.0,-7.499999999999868e-05,18.25,0.13103946788328047
4147,868,-11368,0,2,2,0.0,-0.07045,18.5,0.14204577839238508
4153,1135,-15085,1,2,3,33.33,-0.046033333333333336,22.333333333333332,0.2025740700181308
4154,312,2388,2,0,2,100.0,0.0513,13.5,0.11393712849813731
4157,1513,-12363,2,6,8,25.0,-0.0408875,6.875,0.1884764805169074
4160,461,589,1,2,3,33.33,0.009433333333333332,19.333333333333332,0.15611417545607562
4161,3204,-30354,2,6,8,25.0,-0.027337500000000004,18.625,0.16519805499070583
4162,8094,-21994,4,5,9,44.44,-0.017033333333333334,20.22222222222222,0.19345147489541117
4163,2792,-19392,1,3,4,25.0,-0.029425000000000003,28.75,0.12446778587358831
4167,1112,-3512,4,4,8,50.0,-0.016399999999999998,9.875,0.16059809799263142
4168,2368,-2968,5,6,11,45.45,-0.014818181818181815,14.636363636363637,0.1856607807961167
4171,1557,-17407,2,3,5,40.0,-0.027459999999999995,19.6,0.14680882979588422
4173,371,779,1,2,3,33.33,0.010700000000000001,9.666666666666666,0.15033613990240466
4174,6686,-34686,3,1,4,75.0,0.0154,7.25,0.20812886403575426
4175,1144,-6644,0,3,3,0.0,-0.03186666666666667,13.333333333333334,0.08649739735054889
4183,0,0,0,0,0,0.0,,,
4188,313,-1863,0,2,2,0.0,-0.0368,11.5,0.11655314515834247
4192,208,2892,1,0,1,100.0,0.0871,20.0,0.16078946239872915
4198,500,-2300,1,4,5,20.0,-0.06484,10.6,0.1459002704374331
4205,157,-57,0,1,1,0.0,-0.0021,45.0,0.10828032759557571
4207,590,-200,3,5,8,37.5,-0.003462500000000002,20.25,0.16563105158275707
4303,280,-730,2,4,6,33.33,-0.040783333333333345,5.0,0.2065546043302605
4304,146,154,1,1,2,50.0,0.00485,4.5,0.0901738939416824
4305,102,-502,0,1,1,0.0,-0.0282,2.0,0.1390257911834023
4401,3194,-30864,3,5,8,37.5,-0.030925,9.25,0.16948429295249806
4402,340,-1390,1,6,7,14.29,-0.06188571428571429,8.714285714285714,0.17603442472150815
4406,366,-1206,3,3,6,50.0,-0.02273333333333333,20.333333333333332,0.18037335549951217
4413,109,-709,0,2,2,0.0,-0.06495000000000001,20.0,0.19385933478061934
4416,65,585,1,0,1,100.0,0.075,42.0,0.35626358514802803
4417,739,-5029,4,3,7,57.14,0.004357142857142853,26.0,0.18480688764348563
4419,310,240,2,2,4,50.0,0.00037500000000000207,17.75,0.12929057676733796
4420,0,0,0,0,0,0.0,,,
4430,567,5783,1,1,2,50.0,0.0489,9.0,0.24600747516113353
4432,676,15474,2,0,2,100.0,0.1294,9.5,0.23859619441852953
4433,1264,5036,5,2,7,71.43,0.021614285714285714,12.0,0.20411159390691253
4502,173,-1473,0,3,3,0.0,-0.07276666666666666,12.0,0.17895221061367125
4503,227,1673,3,0,3,100.0,0.04903333333333334,11.666666666666666,0.21915876169843376
4506,0,0,0,0,0,0.0,,,
4510,681,1769,5,2,7,71.43,0.022071428571428568,20.142857142857142,0.16674486486697995
4513,1139,-889,6,8,14,42.86,-0.00945,17.071428571428573,0.18959897086687322
4523,1252,3648,4,5,9,44.44,0.020200000000000003,13.555555555555555,0.17077142934991385
4527,754,-5504,1,6,7,14.29,-0.049485714285714286,28.857142857142858,0.12362425564518409
4528,2884,9766,7,4,11,63.64,0.04060909090909091,10.727272727272727,0.13167403260530477
4529,265,-3635,0,4,4,0.0,-0.093675,17.5,0.17336130026974927
4530,304,-294,3,2,5,60.0,-0.004840000000000002,18.2,0.25351087217310625
4533,1072,-1522,5,6,11,45.45,-0.008790909090909089,21.272727272727273,0.18085665031136353
4534,439,71,2,3,5,40.0,-0.0256,10.8,0.2495635975293097
4535,710,-210,1,2,3,33.33,-0.0023999999999999994,20.666666666666668,0.10542989982629059
4538,0,0,0,0,0,0.0,,,
4541,760,-610,2,2,4,50.0,0.017825,10.5,0.1596913392730131
4542,220,380,1,1,2,50.0,0.014450000000000001,10.5,0.16500049635157243
4543,0,0,0,0,0,0.0,,,
4549,2853,-3053,2,3,5,40.0,-0.001979999999999997,23.8,0.24236391739956384
4550,238,-38,0,2,2,0.0,-0.0009499999999999999,28.0,0.13422815461819215
4554,387,-3687,0,2,2,0.0,-0.0532,10.0,0.21497142885084985
4556,188,1712,1,0,1,100.0,0.0559,21.0,0.2805489235464955
4561,299,-5099,0,2,2,0.0,-0.09325,14.5,0.22954422254707008
4563,192,758,1,0,1,100.0,0.0237,41.0,0.1539433473421321
4568,0,0,0,0,0,0.0,,,
4580,0,0,0,0,0,0.0,,,
4609,561,-3801,2,5,7,28.57,-0.02118571428571429,11.428571428571429,0.23769743267222337
4702,103,-513,1,1,2,50.0,-0.06999999999999999,18.5,0.22031668648567226
4706,315,-1625,1,3,4,25.0,-0.031325,17.5,0.194661936660126
4707,1216,-2286,7,4,11,63.64,0.009427272727272729,15.181818181818182,0.22555685457130045
4711,525,-2425,2,4,6,33.33,-0.024683333333333335,19.5,0.1407851749056678
4712,402,1288,3,3,6,50.0,0.016233333333333332,12.5,0.1315889776122607
4714,442,-1512,2,4,6,33.33,-0.028200000000000003,9.166666666666666,0.1887383619373373
4716,78,672,1,0,1,100.0,0.0572,6.0,0.14105064753342966
4721,4568,-19918,8,8,16,50.0,-0.012168749999999999,11.1875,0.17503936900479183
4726,1030,420,2,3,5,40.0,0.0036200000000000026,19.2,0.21942130403914012
4728,347,-647,1,1,2,50.0,0.0015499999999999993,18.0,0.1697048857658804
4729,1066,-166,5,5,10,50.0,-0.0010800000000000004,13.8,0.24267333066424857
4735,1156,4144,3,2,5,60.0,-0.00746,11.6,0.18708298524131028
4736,4373,11827,3,3,6,50.0,0.009750000000000002,17.333333333333332,0.20470570955462275
4741,0,0,0,0,0,0.0,,,
4743,2051,-5351,2,3,5,40.0,-0.011459999999999994,9.6,0.16460867780488267
4744,0,0,0,0,0,0.0,,,
4745,806,-4156,1,2,3,33.33,-0.008299999999999997,23.666666666666668,0.16705373121430026
4747,242,2558,1,0,1,100.0,0.0654,35.0,0.19007526348254822
4754,564,-1964,1,1,2,50.0,-0.02115,13.0,0.18524764814020034
4760,0,0,0,0,0,0.0,,,
4767,0,0,0,0,0,0.0,,,
4804,539,-3689,0,3,3,0.0,-0.0502,5.666666666666667,0.1824000822056985
4806,558,772,2,2,4,50.0,-0.014825000000000001,17.0,0.37572990038231274
4903,46,14,1,0,1,100.0,0.0074,22.0,0.20883434441944448
4905,341,-1391,2,2,4,50.0,-0.0289,26.0,0.19766190747437218
4907,62,-362,0,1,1,0.0,-0.047,8.0,0.18833594696027967
4908,76,-726,0,1,1,0.0,-0.0578,6.0,0.09574706789302279
4909,2448,-14198,4,8,12,33.33,-0.019125000000000003,14.0,0.20294764408156354
4911,1104,8146,1,1,2,50.0,0.0137,13.5,0.13616592840979402
4924,500,-1780,3,1,4,75.0,-0.0010750000000000024,12.0,0.1727074664133168
4931,0,0,0,0,0,0.0,,,
4933,3104,-15304,6,5,11,54.55,-0.0026727272727272715,15.818181818181818,0.23339638083907205
4939,831,2559,4,3,7,57.14,0.015228571428571426,17.571428571428573,0.23514014967153726
4944,355,315,2,1,3,66.67,0.029799999999999997,7.666666666666667,0.18343878509517073
4945,0,0,0,0,0,0.0,,,
4946,2734,-9934,4,5,9,44.44,-0.00017777777777777825,12.555555555555555,0.23731113464272
4950,671,979,3,2,5,60.0,0.023980000000000005,21.6,0.2292928245483234
4953,1450,-4300,2,2,4,50.0,0.022125,11.0,0.15752520536239945
4966,13772,51728,4,1,5,80.0,0.03578,9.8,0.13949360473859834
4971,2764,9836,4,2,6,66.67,0.015100000000000002,11.166666666666666,0.15464585247783666
4972,196,654,1,0,1,100.0,0.02,24.0,0.10221770806726438
4973,1090,1660,4,3,7,57.14,0.016542857142857144,13.571428571428571,0.13875180434158277
4974,1226,14374,4,0,4,100.0,0.070725,18.75,0.24907917567446675
4979,1455,-1155,3,2,5,60.0,-0.01812,20.0,0.19249405747116555
4987,1886,8564,2,3,5,40.0,0.007339999999999998,16.2,0.22047832531137387
4991,2028,-6828,3,3,6,50.0,-0.007033333333333335,12.0,0.198085482323715
4995,981,-7931,1,4,5,20.0,-0.03849999999999999,8.4,0.1392184913483449
5009,729,1371,3,3,6,50.0,0.0049166666666666655,8.666666666666666,0.1826958664296311
5011,0,0,0,0,0,0.0,,,
5013,522,2478,4,1,5,80.0,0.028280000000000007,5.4,0.11066144822213744
5014,819,9921,6,2,8,75.0,0.04925,14.5,0.1864240089878593
5015,475,-7125,0,4,4,0.0,-0.06945,20.25,0.19973018720333074
5016,314,2436,3,0,3,100.0,0.05043333333333333,32.666666666666664,0.23111709117322077
5201,106,-116,1,1,2,50.0,-0.014499999999999999,10.0,0.1824959035538134
5202,688,-4418,2,7,9,22.22,-0.034322222222222226,16.444444444444443,0.22250898658341484
5205,170,-1370,0,3,3,0.0,-0.08056666666666666,14.333333333333334,0.24804864711781027
5206,56,644,1,0,1,100.0,0.1431,2.0,0.22736237355028077
5209,151,2449,2,0,2,100.0,0.1159,15.5,0.1357658916319212
5210,542,-3182,1,6,7,14.29,-0.03477142857142857,8.714285714285714,0.17920637669876374
5211,97,803,1,0,1,100.0,0.0508,4.0,0.1285553642676358
5212,581,-2431,2,3,5,40.0,-0.02122,13.8,0.1596536642517953
5213,53,-323,0,1,1,0.0,-0.0723,2.0,0.10730834142104784
5220,232,818,1,0,1,100.0,0.021,32.0,0.38480204562696363
5223,426,3474,1,0,1,100.0,0.0497,10.0,0.11518766816660997
5227,1412,45348,5,4,9,55.56,0.1504111111111111,7.777777777777778,0.20078087157675095
5230,259,841,1,0,1,100.0,0.0194,4.0,0.09381646871422022
5245,1428,1022,2,3,5,40.0,0.01098,9.0,0.22784333961741216
5251,80,720,1,0,1,100.0,0.0571,12.0,0.3827661522705361
5263,6083,-10583,2,3,5,40.0,-0.0011200000000000016,12.6,0.25345635408246886
5272,840,-8440,1,2,3,33.33,-0.039700000000000006,8.666666666666666,0.2179728132516212
5274,43948,-578448,2,7,9,22.22,-0.049166666666666664,16.0,0.20443834012052695
5276,324,-5124,0,2,2,0.0,-0.0852,17.5,0.23034684792900906
5278,2169,2531,1,3,4,25.0,-0.000625000000000004,7.0,0.1886541949274626
5281,404,-9404,0,1,1,0.0,-0.1237,19.0,0.18842187146902956
5287,5570,-9070,2,2,4,50.0,-0.0048000000000000004,9.25,0.12954114506962366
5289,3811,-10311,2,4,6,33.33,-0.012966666666666663,19.5,0.13335577870940127
5291,376,324,1,2,3,33.33,-0.0018000000000000006,13.666666666666666,0.1672025080186829
5299,0,0,0,0,0,0.0,,,
5301,425,-4705,0,6,7,0.0,-0.0943857142857143,9.285714285714286,0.2075656653410182
5302,72,28,1,0,1,100.0,0.0027,39.0,0.1635777607934501
5306,182,778,2,1,3,66.67,0.018699999999999994,8.333333333333334,0.23141904932363158
5309,55,-165,0,1,1,0.0,-0.0324,4.0,0.18334770360441732
5310,240,-700,1,3,4,25.0,-0.04605,8.0,0.14874511184287975
5312,0,0,0,0,0,0.0,,,
5314,51,-1,0,1,1,0.0,-0.0003,8.0,0.2148622579701196
5315,222,1248,3,1,4,75.0,0.062725,7.0,0.26416347858796424
5321,105,-1345,0,2,2,0.0,-0.1417,6.5,0.24415327153318722
5324,309,-829,2,4,6,33.33,-0.04826666666666666,14.166666666666666,0.244385481649974
5328,0,0,0,0,0,0.0,,,
5340,934,3456,4,4,8,50.0,0.019974999999999993,11.25,0.1762145841148661
5344,0,0,0,0,0,0.0,,,
5345,341,-1301,3,3,6,50.0,-0.033716666666666666,14.666666666666666,0.2165035635929762
5347,237,-1887,1,2,3,33.33,-0.04523333333333333,11.666666666666666,0.2323949513259176
5348,0,0,0,0,0,0.0,,,
5351,1282,-13282,3,6,9,33.33,-0.046000000000000006,10.0,0.2260682770888663
5353,367,-3717,1,4,5,20.0,-0.05846,16.0,0.1754605710959523
5355,827,-5877,4,6,10,40.0,-0.007110000000000001,16.8,0.15645308739729108
5356,1908,2492,5,5,10,50.0,0.014340000000000002,18.2,0.15553072945374827
5364,56,-856,0,1,1,0.0,-0.1427,8.0,0.3059549764323335
5371,2306,-8556,4,6,10,40.0,-0.01915,10.7,0.16825262249120554
5381,916,-2536,7,10,17,41.18,-0.02768235294117647,12.823529411764707,0.183085878762864
5383,667,-5687,2,7,9,22.22,-0.04781111111111111,18.666666666666668,0.1937384421700593
5386,240,-640,1,1,2,50.0,-0.01625,12.0,0.1500609026964409
5392,125,-2025,0,2,2,0.0,-0.11410000000000001,5.0,0.40212135741741184
5398,220,590,2,2,4,50.0,0.0070750000000000006,11.25,0.2962748329475986
5403,722,-3172,2,5,7,28.57,-0.022557142857142855,18.428571428571427,0.14538688641231384
5410,0,0,0,0,0,0.0,,,
5425,3210,-14910,7,10,17,41.18,-0.021876470588235292,21.0,0.20627371909836062
5426,366,-266,2,3,5,40.0,-0.014619999999999994,12.4,0.2083397162727524
5432,190,-1950,0,2,2,0.0,-0.06705,8.5,0.21615798721082935
5438,1179,4021,6,3,9,66.67,0.03015555555555556,14.11111111111111,0.22541513751071296
5439,2669,9531,9,6,15,60.0,0.029706666666666662,15.266666666666667,0.1804811589157925
5443,458,142,2,3,5,40.0,-0.01192,13.8,0.20019212805378245
5450,544,36,2,5,7,28.57,0.0159,14.571428571428571,0.1446355017843002
5452,1012,78,7,4,11,63.64,0.0020090909090909087,13.0,0.19079501934782375
5455,53,-523,0,1,1,0.0,-0.1074,7.0,0.4834748435275529
5457,3608,-1268,11,6,17,64.71,0.0175,11.705882352941176,0.21664619849671207
5460,445,-425,3,2,5,60.0,0.0025599999999999998,30.2,0.2080011055087186
5464,862,-4012,1,5,6,16.67,-0.024999999999999998,19.5,0.13407469123074392
5465,402,2578,4,2,6,66.67,0.057150000000000006,8.166666666666666,0.13995345738166318
5468,64,786,1,0,1,100.0,0.1123,17.0,0.3460141639093799
5474,2495,14355,11,4,15,73.33,0.05519333333333334,12.266666666666667,0.2193661775877942
5475,1329,-4979,8,12,20,40.0,-0.006060000000000003,9.9,0.22948376763629907
5478,4769,-46769,2,7,9,22.22,-0.04048888888888889,10.666666666666666,0.1586347609210006
5481,919,4961,5,5,10,50.0,0.01484,14.9,0.23748852217765068
5483,3853,2297,7,4,11,63.64,0.008018181818181815,14.0,0.19850367436488367
5487,435,-3835,0,4,4,0.0,-0.047825,16.5,0.18273652795796058
5488,696,-5756,1,8,9,11.11,-0.0621111111111111,15.88888888888889,0.15659160486324622
5489,1476,-2876,3,3,6,50.0,-0.00203333333333333,22.666666666666668,0.14176511465241948
5490,577,-1277,2,2,4,50.0,0.0060249999999999965,10.25,0.22933707363822342
5493,621,2229,1,3,4,25.0,0.0003250000000000017,11.0,0.19098525743322575
5498,627,-5377,1,7,8,12.5,-0.0567875,12.0,0.17973607108353318
5508,721,-271,1,2,3,33.33,-0.013099999999999999,21.666666666666668,0.09773812738637593
5511,327,503,2,2,4,50.0,0.0024000000000000002,13.75,0.1997946572048146
5512,231,-1501,1,2,3,33.33,-0.03613333333333333,5.333333333333333,0.17236252871669433
5514,571,-321,5,2,7,71.43,0.018400000000000003,24.142857142857142,0.16189530282421408
5516,382,2818,3,2,5,60.0,0.05271999999999999,8.2,0.2045171071270297
5520,263,-1563,2,1,3,66.67,-0.029066666666666657,10.666666666666666,0.11112637722190666
5523,374,-3974,1,4,5,20.0,-0.034339999999999996,9.8,0.2280886338936065
5529,0,0,0,0,0,0.0,,,
5530,379,-1179,1,1,2,50.0,0.001550000000000001,25.5,0.12663265491375397
5536,2046,16954,2,0,2,100.0,0.049350000000000005,41.5,0.1309025933137502
5543,0,0,0,0,0,0.0,,,
5601,116,-216,0,2,2,0.0,-0.017849999999999998,4.0,0.12084335129961787
5603,565,1635,5,2,7,71.43,0.018214285714285714,13.142857142857142,0.15790542386860845
5604,0,0,0,0,0,0.0,,,
5609,1946,5654,5,5,10,50.0,0.011259999999999996,10.4,0.15946094572565733
5701,972,-612,6,6,12,50.0,-0.004933333333333332,11.25,0.23237528801438131
5703,0,0,0,0,0,0.0,,,
5704,0,0,0,0,0,0.0,,,
5820,187,-207,2,1,3,66.67,-0.006866666666666667,18.0,0.11886924392042027
5864,283,617,2,2,4,50.0,0.008275,7.5,0.16367458430077692
5878,258,-358,0,1,1,0.0,-0.0081,4.0,0.08104562494374412
5902,123,-223,1,1,2,50.0,-0.0206,6.0,0.10977165646329912
5903,0,0,0,0,0,0.0,,,
5904,178,-1878,0,1,1,0.0,-0.0592,15.0,0.10362776518840033
5905,723,147,2,6,8,25.0,0.001412499999999997,26.125,0.19627284383593224
6015,0,0,0,0,0,0.0,,,
6016,820,-2090,4,8,12,33.33,-0.020791666666666667,11.75,0.18258880381334022
6020,581,1119,3,3,6,50.0,0.014100000000000001,17.0,0.1443517460394039
6021,498,-1848,2,4,6,33.33,-0.017416666666666667,12.0,0.19511752252887826
6023,767,-5167,1,2,3,33.33,-0.028133333333333326,15.666666666666666,0.2335381876743321
6026,65,-355,0,1,1,0.0,-0.0418,49.0,0.15238205678637295
6101,160,-2660,1,1,2,50.0,-0.062,4.0,0.24873374267910064
6103,685,1865,3,1,4,75.0,0.017,10.5,0.1930572389499694
6104,2774,-17224,4,4,8,50.0,-0.021112500000000003,7.5,0.22150840170463143
6109,71,189,1,0,1,100.0,0.0189,9.0,0.23693056543601188
6111,725,-8245,2,3,5,40.0,-0.02072,12.2,0.2549279497517135
6113,643,-4413,2,7,9,22.22,-0.03006666666666667,16.666666666666668,0.17501165819135547
6114,85,1215,1,0,1,100.0,0.0907,15.0,0.19303550024749416
6118,717,-3017,3,6,9,33.33,-0.018644444444444446,10.88888888888889,0.22228554552494328
6121,15561,-49561,5,8,13,38.46,-0.011484615384615387,12.307692307692308,0.18521252776193603
6122,581,-1321,2,6,8,25.0,-0.015575000000000006,15.125,0.1954586746306108
6123,191,-2551,0,2,2,0.0,-0.107,16.5,0.2171858943551428
6124,1824,5276,6,4,10,60.0,0.006990000000000001,11.5,0.22839863152849899
6125,1471,-2951,6,5,11,54.55,0.01441818181818182,12.363636363636363,0.1705657591672796
6126,351,-6101,0,2,2,0.0,-0.07895,10.5,0.12221654291012785
6127,740,1910,6,3,9,66.67,0.03513333333333333,14.0,0.2082446891026001
6129,1385,9435,8,2,10,80.0,0.02826,19.7,0.2270746782584268
6130,130,-1260,1,1,2,50.0,-0.029400000000000003,6.0,0.21968396665671364
6134,1363,7687,6,3,9,66.67,0.02276666666666667,18.555555555555557,0.19586280194225236
6138,4478,26722,7,7,14,50.0,-0.007321428571428572,15.214285714285714,0.22293616138106095
6140,960,-360,6,6,12,50.0,-0.003383333333333336,12.833333333333334,0.15625222302744027
6143,3098,-17348,5,7,12,41.67,-0.03244166666666667,13.666666666666666,0.201023054449087
6144,197,-1367,1,2,3,33.33,-0.051166666666666666,10.666666666666666,0.22670412360402117
6146,936,-1536,1,2,3,33.33,-0.006099999999999999,18.0,0.18499617109119235
6147,3317,6633,7,5,12,58.33,0.012166666666666664,12.5,0.2045445541679581
6148,220,-5270,1,2,3,33.33,-0.10116666666666668,15.666666666666666,0.2344171321283314
6150,820,1600,4,3,7,57.14,0.02835714285714286,6.0,0.25032579988395554
6151,891,2259,3,4,7,42.86,-0.002614285714285714,16.571428571428573,0.16759065348200206
6154,906,-1556,2,3,5,40.0,-0.01272,9.0,0.15829886231805207
6156,197,-247,1,1,2,50.0,-0.0075,19.5,0.16090683236938297
6158,1736,-11636,3,3,6,50.0,-0.02755,8.833333333333334,0.2723120776115982
6160,2401,-201,4,6,10,40.0,-0.010360000000000001,10.3,0.16611734099488087
6161,355,-3595,1,3,4,25.0,-0.04215,8.75,0.13336208743607914
6163,589,-1439,2,5,7,28.57,-0.020814285714285712,9.857142857142858,0.23953074144715586
6167,976,1904,6,8,14,42.86,-0.0178,14.785714285714286,0.1933021976292196
6169,3401,-7051,6,8,14,42.86,0.00594285714285714,15.357142857142858,0.22769682586075418
6170,1053,5857,3,3,6,50.0,0.03585,20.333333333333332,0.21486394672927853
6171,340,-1400,0,4,4,0.0,-0.020625,26.0,0.23779389143132657
6173,1256,84,6,5,11,54.55,-0.004045454545454546,14.636363636363637,0.2072420521140014
6174,232,-162,1,2,3,33.33,-0.01593333333333333,11.333333333333334,0.2522656847783112
6175,1347,-13497,2,9,11,18.18,-0.05343636363636362,14.818181818181818,0.18799212364692233
6179,817,-8947,2,4,6,33.33,-0.056883333333333334,11.666666666666666,0.24991218957492697
6180,2200,-250,7,4,11,63.64,0.009163636363636362,17.09090909090909,0.1719753620314427
6182,1137,323,3,3,6,50.0,0.0025000000000000022,8.666666666666666,0.28443422038561234
6185,545,105,3,2,5,60.0,-0.0042400000000000024,12.4,0.18968975888805856
6186,443,1607,3,2,5,60.0,0.01856,13.0,0.16738956694771873
6187,4843,22207,13,5,18,72.22,0.025433333333333332,14.444444444444445,0.20683163441974126
6188,3818,-4068,6,6,12,50.0,-0.011658333333333333,17.416666666666668,0.19352862152872272
6190,490,2410,3,3,6,50.0,0.0219,9.666666666666666,0.1411197520172448
6194,1050,-10500,0,6,6,0.0,-0.04961666666666667,13.666666666666666,0.18643308308244766
6195,110,560,2,0,2,100.0,0.06875,16.5,0.2712757157493819
6198,741,-841,4,6,10,40.0,-0.009810000000000001,9.6,0.17421689444153793
6199,711,-4651,3,5,8,37.5,-0.023262500000000005,13.25,0.21651469221824596
6203,134,1666,1,0,1,100.0,0.0768,14.0,0.29518991840034037
6204,407,1193,2,1,3,66.67,0.021633333333333334,34.666666666666664,0.11749717297521234
6207,1009,6191,4,1,5,80.0,0.05624,18.0,0.28595367557519813
6208,794,3296,4,2,6,66.67,0.03493333333333333,17.0,0.21655168823797014
6210,1231,-811,5,6,11,45.45,-0.024881818181818175,17.363636363636363,0.19259003940276068
6212,294,796,3,2,5,60.0,0.0206,9.0,0.29561698283591675
6217,1575,-5215,4,6,10,40.0,-0.017500000000000005,11.7,0.2112117524720784
6218,514,-3964,2,2,4,50.0,-0.024274999999999998,16.0,0.15740472833333652
6219,0,0,0,0,0,0.0,,,
6220,998,-6198,2,5,7,28.57,-0.03137142857142857,15.142857142857142,0.19685086828267492
6221,303,-253,2,2,4,50.0,0.0019249999999999996,15.0,0.18605324553723673
6222,298,1852,2,1,3,66.67,0.09910000000000001,4.333333333333333,0.24668361064023422
6223,3649,-35499,2,6,8,25.0,-0.046925,14.25,0.23130643511801227
6227,1109,-9809,2,4,6,33.33,-0.033966666666666666,17.666666666666668,0.17733686675732074
6228,756,254,4,6,10,40.0,-0.006330000000000002,16.4,0.15513514010432575
6229,569,-2019,2,2,4,50.0,-0.0078,17.75,0.24310622724641812
6231,2594,-5994,5,1,6,83.33,0.027716666666666664,10.5,0.20548863097346526
6233,1672,11128,2,4,6,33.33,-0.029433333333333336,15.666666666666666,0.30081461601299775
6234,1541,8659,4,2,6,66.67,0.021349999999999997,13.666666666666666,0.18913406547349007
6236,191,-741,1,1,2,50.0,-0.0034500000000000017,3.0,0.23798683427920864
6237,2707,-9907,4,4,8,50.0,-0.011050000000000003,11.375,0.22271959217181983
6240,138,-1058,0,2,2,0.0,-0.041049999999999996,5.5,0.15816596220877965
6241,52,-42,0,1,1,0.0,-0.0105,2.0,0.3369802065135432
6242,176,-2776,0,2,2,0.0,-0.08940000000000001,17.0,0.25593553594136753
6244,975,-4065,5,1,6,83.33,-0.010416666666666666,12.166666666666666,0.2336905343009991
6245,2529,12121,7,3,10,70.0,0.02743,23.6,0.16398646590605018
6246,0,0,0,0,0,0.0,,,
6247,129,-329,0,1,1,0.0,-0.0148,4.0,0.14750873946142096
6248,132,-32,1,1,2,50.0,0.007099999999999999,8.0,0.3093035904979332
6259,146,554,1,1,2,50.0,0.021249999999999998,4.5,0.154178471397046
6261,2874,5626,5,3,8,62.5,0.020637499999999996,19.0,0.17880217248689365
6263,1674,-17024,1,5,6,16.67,-0.053266666666666664,15.666666666666666,0.24935005103138094
6264,567,-2007,3,3,6,50.0,-0.001266666666666667,15.166666666666666,0.1425022385060062
6265,686,-906,3,5,8,37.5,-0.006249999999999999,9.125,0.18738355175849522
6266,314,-194,1,3,4,25.0,0.008425000000000002,9.25,0.15536260507712096
6270,924,-6024,1,3,4,25.0,-0.027275,15.5,0.2083501573681124
6274,2915,-31635,7,6,13,53.85,-0.012046153846153844,13.076923076923077,0.21698802790878893
6275,1093,-393,6,4,10,60.0,0.002829999999999997,13.0,0.22972272137647592
6276,252,278,3,1,4,75.0,-0.021,5.25,0.24597715261631659
6279,8078,-25928,3,11,14,21.43,-0.02809285714285715,15.642857142857142,0.15237145166472854
6284,2208,-11958,4,6,10,40.0,-0.028970000000000006,9.8,0.19780881774010267
6287,57,-107,0,1,1,0.0,-0.0191,12.0,0.08405245608651235
6290,2436,-586,4,6,10,40.0,-0.005429999999999998,18.9,0.15721577981305207
6291,598,-1688,3,4,7,42.86,-0.024128571428571433,16.285714285714285,0.2828440290188173
6292,587,1913,3,2,5,60.0,0.03776,28.8,0.21972315677397644
6294,304,-254,2,1,3,66.67,0.0268,17.333333333333332,0.27994661528925313
6404,1102,-15002,2,2,4,50.0,-0.022899999999999997,18.5,0.313281472854396
6411,4513,2937,4,4,8,50.0,0.007274999999999999,19.375,0.19158328179122955
6417,335,3865,1,0,1,100.0,0.0713,44.0,0.39742346990378397
6418,0,0,0,0,0,0.0,,,
6419,777,-1167,3,3,6,50.0,0.015383333333333332,7.5,0.228199718749723
6425,497,-257,1,2,3,33.33,0.008299999999999995,15.666666666666666,0.1476367608421305
6426,0,0,0,0,0,0.0,,,
6432,502,2748,2,1,3,66.67,0.055066666666666673,11.333333333333334,0.13849534131189434
6435,3112,-4712,3,2,5,60.0,0.009199999999999996,12.2,0.17592571005086827
6441,921,8969,2,1,3,66.67,0.0768,7.333333333333333,0.19210632100307756
6446,3662,-21262,1,4,5,20.0,-0.02994,18.6,0.1215396658974679
6457,395,-1295,1,1,2,50.0,-0.013900000000000001,5.0,0.16923865315115016
6461,237,113,1,1,2,50.0,-0.00010000000000000286,26.0,0.1652356924398809
6462,4962,-49162,1,4,5,20.0,-0.05738000000000001,13.0,0.25439235883051103
6465,1634,-3484,2,4,6,33.33,-0.012449999999999998,6.0,0.13888530154939885
6469,903,-203,1,1,2,50.0,-0.002449999999999999,5.0,0.09272138950370912
6470,1568,732,3,3,6,50.0,0.0007333333333333312,14.666666666666666,0.14785393221133172
6472,848,11652,1,0,1,100.0,0.086,10.0,0.09651153606112062
6482,0,0,0,0,0,0.0,,,
6485,358,-858,0,2,2,0.0,-0.0167,22.0,0.1958768587259938
6486,0,0,0,0,0,0.0,,,
6488,19207,68293,5,2,7,71.43,0.028642857142857144,15.714285714285714,0.18710001935416182
6492,2614,24386,2,2,4,50.0,0.030025000000000003,9.25,0.21043155293538496
6494,2501,-13701,1,3,4,25.0,-0.046825,12.75,0.16856046778796702
6496,348,3352,1,0,1,100.0,0.0591,17.0,0.19748705660874566
6499,1366,3134,1,2,3,33.33,0.009133333333333335,12.333333333333334,0.15813549091038506
6506,366,-5016,0,4,4,0.0,-0.06085,9.5,0.19011276305909225
6508,576,-2826,2,2,4,50.0,-0.024474999999999997,14.5,0.16756974339486752
6509,851,4799,2,3,5,40.0,0.005179999999999999,8.6,0.15357406743166266
6510,21093,-61093,2,2,4,50.0,-0.0072999999999999975,8.0,0.19602539517425055
6512,0,0,0,0,0,0.0,,,
6514,1197,-5797,0,4,4,0.0,-0.034175000000000004,14.5,0.13033260643254013
6516,0,0,0,0,0,0.0,,,
6523,4993,-8393,3,4,7,42.86,-0.00028571428571428796,6.142857142857143,0.14813548172744895
6527,361,-2461,0,1,1,0.0,-0.0388,4.0,0.14020806823979703
6530,0,0,0,0,0,0.0,,,
6532,957,-15057,0,3,3,0.0,-0.08126666666666667,15.666666666666666,0.23078564784499492
6535,0,0,0,0,0,0.0,,,
6538,2347,-44847,0,2,2,0.0,-0.10515,9.5,0.19586541945495628
6542,0,0,0,0,0,0.0,,,
6547,0,0,0,0,0,0.0,,,
6548,3765,-30615,3,2,5,60.0,0.01164,10.4,0.23652938068668367
6556,188,-1788,0,1,1,0.0,-0.0535,8.0,0.20251775426831142
6560,863,5087,1,1,2,50.0,0.0162,11.5,0.3148264036322047
6561,2755,-9255,1,1,2,50.0,-0.03755,18.0,0.15733904787646924
6568,3858,14142,2,1,3,66.67,-0.020699999999999996,6.0,0.22021050537003709
6569,0,0,0,0,0,0.0,,,
6570,246,-346,0,1,1,0.0,-0.0082,13.0,0.10124642670623696
6574,0,0,0,0,0,0.0,,,
6576,0,0,0,0,0,0.0,,,
6577,385,1315,1,0,1,100.0,0.0204,9.0,0.2053853410286821
6578,0,0,0,0,0,0.0,,,
6588,0,0,0,0,0,0.0,,,
6589,657,10743,2,1,3,66.67,0.07973333333333334,12.0,0.26961953192695826
6590,197,3203,1,0,1,100.0,0.103,12.0,0.14547048362100168
6593,0,0,0,0,0,0.0,,,
6594,162,1238,1,0,1,100.0,0.0465,11.0,0.2998797921945242
6596,0,0,0,0,0,0.0,,,
6603,495,-2475,2,4,6,33.33,-0.022783333333333336,16.166666666666668,0.23684476688474235
6609,1582,5868,7,4,11,63.64,0.019809090909090908,16.0,0.16255745820373818
6612,714,-4314,0,2,2,0.0,-0.03455,5.5,0.0896884665798463
6613,837,7163,1,0,1,100.0,0.0523,15.0,0.14599642886410003
6615,1128,-13028,0,2,2,0.0,-0.07435,12.0,0.24186442494805294
6616,0,0,0,0,0,0.0,,,
6624,296,-1296,0,1,1,0.0,-0.0253,2.0,0.1116124153142295
6629,0,0,0,0,0,0.0,,,
6640,469,4331,1,0,1,100.0,0.0565,14.0,0.1988159856007654
6642,209,141,1,0,1,100.0,0.004,15.0,0.08051833848241063
6643,3967,5533,1,1,2,50.0,0.013850000000000001,14.0,0.18565492911309645
6649,0,0,0,0,0,0.0,,,
6651,0,0,0,0,0,0.0,,,
6654,396,5004,1,0,1,100.0,0.0787,19.0,0.3011705963554576
6661,0,0,0,0,0,0.0,,,
6662,0,0,0,0,0,0.0,,,
6664,466,-2966,0,1,1,0.0,-0.0364,4.0,0.09386188997858969
6667,340,-5440,0,1,1,0.0,-0.0876,4.0,0.14508273751058343
6679,664,9336,1,0,1,100.0,0.0881,10.0,0.20318766641550323
6680,0,0,0,0,0,0.0,,,
6683,2135,4365,1,0,1,100.0,0.0121,8.0,0.22886832123736744
6690,704,10296,1,0,1,100.0,0.0919,2.0,0.29747176010991616
6697,0,0,0,0,0,0.0,,,
6703,0,0,0,0,0,0.0,,,
6712,0,0,0,0,0,0.0,,,
6716,1560,5940,1,1,2,50.0,0.04485,5.0,0.3497894250092749
6727,0,0,0,0,0,0.0,,,
6728,875,2925,2,0,2,100.0,0.0193,3.5,0.18426402704468425
6732,3946,-63946,0,1,1,0.0,-0.0888,2.0,0.12642933819251923
6733,0,0,0,0,0,0.0,,,
6747,1260,25740,1,0,1,100.0,0.132,16.0,0.3748992906483186
6751,0,0,0,0,0,0.0,,,
6752,0,0,0,0,0,0.0,,,
6762,0,0,0,0,0,0.0,,,
6767,193,607,1,0,1,100.0,0.0187,27.0,0.13065127804869237
6803,0,0,0,0,0,0.0,,,
7402,1877,-5867,2,3,5,40.0,-0.015479999999999997,26.2,0.18892934681141066
7556,0,0,0,0,0,0.0,,,
8024,713,-5393,2,3,5,40.0,-0.015100000000000006,11.8,0.1780541551724943
8027,740,4410,4,2,6,66.67,0.036,12.666666666666666,0.19839725677006462
8032,1731,1039,6,5,11,54.55,0.004172727272727273,15.818181818181818,0.1694274367390596
8034,448,-4008,3,3,6,50.0,-0.034749999999999996,7.333333333333333,0.14246864320556055
8038,1731,6519,4,4,8,50.0,0.034987500000000005,9.0,0.26568634331742536
8040,1072,8298,4,2,6,66.67,0.025983333333333334,9.833333333333334,0.3581160614167524
8042,810,-2760,2,3,5,40.0,-0.002640000000000002,9.4,0.2405318118178401
8043,716,634,4,1,5,80.0,0.02078,13.6,0.17367323722402656
8044,9135,-84635,2,4,6,33.33,-0.008116666666666666,14.833333333333334,0.1650161039986929
8047,183,-5183,0,1,1,0.0,-0.1481,40.0,0.17110898557709775
8048,250,4050,1,0,1,100.0,0.1024,4.0,0.3940295074955653
8049,907,-527,5,6,11,45.45,0.0030727272727272725,13.0,0.21146183107142436
8050,3586,-29636,4,6,10,40.0,-0.021619999999999993,17.0,0.19635061980602941
8054,2360,1090,4,4,8,50.0,0.0139125,12.25,0.19515302049708214
8059,466,1794,4,2,6,66.67,0.022866666666666664,6.666666666666667,0.1352277831200928
8064,572,-72,3,2,5,60.0,0.023379999999999998,10.4,0.26637032664557464
8066,78,-328,0,1,1,0.0,-0.0256,18.0,0.17010191607861036
8067,646,-1736,3,6,9,33.33,-0.004566666666666668,13.0,0.20825551777196966
8068,1177,-7027,3,5,8,37.5,-0.0257875,8.125,0.20711476409146623
8069,4602,298,10,9,19,52.63,0.004289473684210526,15.157894736842104,0.22848332250197176
8071,0,0,0,0,0,0.0,,,
8074,745,-2495,3,4,7,42.86,-0.020342857142857145,17.0,0.1250664080104688
8076,4647,-24247,6,6,12,50.0,-0.030525000000000007,12.833333333333334,0.24184227449982335
8077,0,0,0,0,0,0.0,,,
8080,1957,-11977,5,12,17,29.41,-0.035429411764705876,12.941176470588236,0.19960136837236564
8083,3199,-9199,1,3,4,25.0,-0.017300000000000003,28.25,0.11345249960067483
8084,2318,15762,7,4,11,63.64,0.021118181818181817,11.181818181818182,0.2220353747630889
8085,633,4547,4,3,7,57.14,0.005757142857142857,12.428571428571429,0.1819277289194485
8086,821,-6171,1,2,3,33.33,-0.042833333333333334,13.666666666666666,0.15123935170252714
8087,277,-537,1,3,4,25.0,-0.002475000000000005,6.25,0.19681820658170895
8088,1596,354,5,9,14,35.71,0.007299999999999999,8.642857142857142,0.20820977065353732
8089,0,0,0,0,0,0.0,,,
8091,2535,-12735,1,6,7,14.29,-0.02208571428571429,19.428571428571427,0.1778733664385064
8092,658,-2298,2,6,8,25.0,-0.0320625,15.75,0.1404403947006203
8093,787,-4497,3,6,9,33.33,-0.040177777777777784,11.0,0.20351582772609814
8096,907,-4907,2,4,6,33.33,-0.02215,13.5,0.14796842569091992
8097,173,1747,1,1,2,50.0,0.0269,26.5,0.15423454409909465
8099,751,1699,2,2,4,50.0,0.012050000000000002,15.75,0.12266377441976567
8107,943,-993,3,4,7,42.86,0.010742857142857143,9.428571428571429,0.24049919082332147
8109,1227,1323,2,2,4,50.0,-0.001400000000000002,18.25,0.14984642670075843
8111,532,6388,4,2,6,66.67,0.07318333333333334,14.666666666666666,0.21707790561456608
8121,2434,-19834,6,5,11,54.55,-0.001227272727272726,8.727272727272727,0.23961552728367905
8147,662,-1412,2,1,3,66.67,-0.010533333333333332,6.0,0.14882633615527233
8155,2944,28906,4,1,5,80.0,0.041460000000000004,13.8,0.19755370941856515
8171,597,-8147,0,5,5,0.0,-0.060160000000000005,10.6,0.24793193919127213
8176,65,-115,0,1,1,0.0,-0.0138,12.0,0.09821236068003758
8182,1610,-4360,2,8,10,20.0,-0.03131,7.9,0.21429719378294684
8183,983,-9683,4,3,7,57.14,-0.014485714285714282,9.0,0.18913061941732448
8234,154,846,1,0,1,100.0,0.0332,7.0,0.09602941585718328
8240,3108,-33958,4,4,8,50.0,-0.00845,13.25,0.19120426727402376
8255,8919,-2719,6,7,13,46.15,8.461538461538384e-05,11.615384615384615,0.16777405560040407
8277,334,-4884,0,2,2,0.0,-0.08175,8.0,0.1813312686724886
8279,0,0,0,0,0,0.0,,,
8284,0,0,0,0,0,0.0,,,
8289,710,2890,3,3,6,50.0,0.005266666666666665,10.166666666666666,0.22544201794618726
8291,289,1911,4,1,5,80.0,0.07564,14.8,0.22616168646263818
8299,12331,-44331,4,6,10,40.0,-0.019440000000000002,23.0,0.2034917264450918
8342,541,3959,1,1,2,50.0,0.0388,15.0,0.12019579098682087
8349,2475,2725,4,3,7,57.14,0.0006571428571428581,16.0,0.12295480568344594
8354,158,1342,1,0,1,100.0,0.0518,24.0,0.15401710713018324
8358,137,-1517,0,2,2,0.0,-0.0711,15.0,0.1924195457600708
8383,832,6318,2,2,4,50.0,0.038825,12.0,0.18787879225110315
8390,672,4178,2,1,3,66.67,0.0509,9.0,0.18672445816704086
8401,373,4877,2,0,2,100.0,0.09375,12.0,0.1748118805065767
8403,929,4771,3,1,4,75.0,0.029575,14.0,0.1473273013279892
8409,653,-4103,0,4,4,0.0,-0.044225,12.25,0.12396076509475723
8410,958,-5508,1,3,4,25.0,-0.0261,14.5,0.34512365288393865
8415,366,3184,2,0,2,100.0,0.052199999999999996,22.0,0.1846756675600476
8416,4077,-4377,2,4,6,33.33,-0.010633333333333333,14.0,0.19205951649704753
8418,437,-4887,1,3,4,25.0,-0.044425000000000006,19.75,0.18229604404761507
8420,0,0,0,0,0,0.0,,,
8421,243,1687,2,1,3,66.67,0.038533333333333336,17.666666666666668,0.10185801050530523
8423,308,-2108,0,2,2,0.0,-0.0441,6.5,0.20192430416789753
8424,286,-5186,0,1,1,0.0,-0.099,28.0,0.08324109386385281
8426,1205,-7305,1,4,5,20.0,-0.04854,11.0,0.13640464351278933
8431,2334,-11434,2,4,6,33.33,-0.021466666666666665,13.0,0.23781935588348777
8432,467,6733,1,0,1,100.0,0.0904,16.0,0.11303732387141041
8433,0,0,0,0,0,0.0,,,
8435,605,4195,1,1,2,50.0,0.04215,13.0,0.1458036719855138
8436,12050,-68550,4,3,7,57.14,-0.017242857142857143,10.142857142857142,0.20830579274406621
8437,4145,-39645,1,3,4,25.0,-0.0506,10.5,0.15698072292459397
8440,0,0,0,0,0,0.0,,,
8444,1402,1698,1,1,2,50.0,0.0036,30.5,0.16397907216604501
8446,1275,-30275,0,2,2,0.0,-0.1241,13.0,0.25518201557597964
8450,464,336,1,0,1,100.0,0.0043,24.0,0.10571057142012807
8455,0,0,0,0,0,0.0,,,
8472,0,0,0,0,0,0.0,,,
8476,106,-106,0,1,1,0.0,-0.0059,5.0,0.1083555134140537
8477,263,1437,1,0,1,100.0,0.033,16.0,0.09479557725662602
8489,3221,14539,3,1,4,75.0,0.031225000000000003,7.5,0.24560139330333686
8905,518,4632,4,1,5,80.0,0.060020000000000004,20.8,0.17083295799418216
8906,476,-406,2,6,8,25.0,0.005962499999999996,7.125,0.17718992526998528
8908,0,0,0,0,0,0.0,,,
8916,129,-1179,0,2,2,0.0,-0.0683,17.0,0.09573793058632485
8917,0,0,0,0,0,0.0,,,
8921,387,-1697,2,4,6,33.33,-0.024166666666666666,16.833333333333332,0.158548296192675
8923,88,912,1,0,1,100.0,0.0638,40.0,0.11194715895202534
8924,213,-1213,0,2,2,0.0,-0.0288,7.5,0.1505549825911614
8927,0,0,0,0,0,0.0,,,
8928,819,-4399,3,6,9,33.33,-0.0245,17.666666666666668,0.1989468062362622
8929,148,-598,1,1,3,33.33,-0.08976666666666666,13.333333333333334,0.21901169641020615
8930,634,-4034,2,6,8,25.0,-0.040425,14.875,0.18574376278464105
8931,171,129,1,0,1,100.0,0.0044,35.0,0.09444943931405847
8932,858,-3618,3,9,12,25.0,-0.018074999999999997,10.916666666666666,0.23172200306435675
8933,714,2336,6,3,9,66.67,0.026522222222222225,19.11111111111111,0.19263418657093395
8935,240,-1710,1,3,4,25.0,-0.04735,8.0,0.22371187418377858
8936,1668,-6968,4,7,11,36.36,-0.026045454545454542,10.181818181818182,0.19347971815010778
8937,395,-45,2,2,4,50.0,0.007825000000000006,13.5,0.19996742018750502
8938,975,-2575,0,3,3,0.0,-0.014966666666666665,16.666666666666668,0.18220689912449917
8941,3002,8638,3,5,8,37.5,0.006937499999999999,12.5,0.18110724291634842
8942,3955,-16605,6,7,13,46.15,-0.016484615384615382,15.384615384615385,0.144445515230219
9949,859,-3009,2,5,7,28.57,-0.012971428571428573,15.142857142857142,0.19027199360837926
9950,533,-2283,1,3,4,25.0,-0.018875000000000003,24.0,0.16470263780893163
9951,7144,-24494,5,6,11,45.45,-0.023009090909090913,20.818181818181817,0.14619714750126886
9960,1398,-21848,0,7,7,0.0,-0.07818571428571429,8.571428571428571,0.1723017446128208
9962,166,-1566,1,1,2,50.0,-0.04335,26.0,0.15501392020551386
8916A,0,0,0,0,0,0.0,,,
4148,1713,-17013,1,3,4,25.0,-0.05015,11.0,0.20235970500350642
6781,0,0,0,0,0,0.0,,,
6776,0,0,0,0,0,0.0,,,
2211,297,-3447,0,1,1,0.0,-0.0649,34.0,0.12400110670956788
6768,0,0,0,0,0,0.0,,,
3357,0,0,0,0,0,0.0,,,
6741,0,0,0,0,0,0.0,,,
2250,0,0,0,0,0,0.0,,,
5236,0,0,0,0,0,0.0,,,
1522A,0,0,0,0,0,0.0,,,
6684,853,-11353,0,1,1,0.0,-0.0737,7.0,0.2582523257808127
2753,727,2273,1,0,1,100.0,0.0186,13.0,0.08543063027196074
2348A,0,0,0,0,0,0.0,,,
6790,0,0,0,0,0,0.0,,,
6788,1166,19834,1,0,1,100.0,0.1081,5.0,0.18066955890996472
2947,0,0,0,0,0,0.0,,,
4440,248,-2098,0,1,1,0.0,-0.0478,25.0,0.18568079936348747
5222,0,0,0,0,0,0.0,,,
2881C,0,0,0,0,0,0.0,,,
6761,0,0,0,0,0,0.0,,,
6806,0,0,0,0,0,0.0,,,
2945,0,0,0,0,0,0.0,,,
6770,0,0,0,0,0,0.0,,,
6792,0,0,0,0,0,0.0,,,
4770,0,0,0,0,0,0.0,,,
2883B,0,0,0,0,0,0.0,,,
6691,0,0,0,0,0,0.0,,,
3592,1898,-12198,1,2,3,33.33,-0.021566666666666668,13.333333333333334,0.2853239188242423
6719,0,0,0,0,0,0.0,,,
2756,0,0,0,0,0,0.0,,,
5244,133,-1133,0,1,1,0.0,-0.0482,48.0,0.12366506906798214
6693,0,0,0,0,0,0.0,,,
8112A,0,0,0,0,0,0.0,,,
8438,0,0,0,0,0,0.0,,,
6829,0,0,0,0,0,0.0,,,
4923,0,0,0,0,0,0.0,,,
6763,0,0,0,0,0,0.0,,,
4558,0,0,0,0,0,0.0,,,
3349,0,0,0,0,0,0.0,,,
6804,0,0,0,0,0,0.0,,,
4768,0,0,0,0,0,0.0,,,
6807,0,0,0,0,0,0.0,,,
6721,0,0,0,0,0,0.0,,,
6735,0,0,0,0,0,0.0,,,
4583,0,0,0,0,0,0.0,,,
6799,0,0,0,0,0,0.0,,,
6585,350,-350,0,1,1,0.0,-0.0058,2.0,0.10524174447585866
5228,148,-1148,0,1,1,0.0,-0.0442,5.0,0.13151970099856336
6546,0,0,0,0,0,0.0,,,
6796,0,0,0,0,0,0.0,,,
6550,371,1639,1,0,1,100.0,0.0264,11.0,0.15822882329070187
4577,0,0,0,0,0,0.0,,,
6789,0,0,0,0,0,0.0,,,
6823,0,0,0,0,0,0.0,,,
