代號,總成本,總損益(淨),獲利次數,損失次數,總交易次數,勝率%,平均報酬,平均持倉時間(日),平均帶寬
1101,2881,-3631,7,8,15,46.67,-0.001973333333333333,21.0,0.1601016361382882
1102,2518,4182,8,5,13,61.54,0.02330769230769231,22.307692307692307,0.2541871179447722
1103,1138,-2738,3,8,11,27.27,-0.009327272727272724,14.909090909090908,0.1858825714632306
1104,1377,6023,2,10,12,16.67,0.019158333333333333,16.583333333333332,0.1497570423837156
1108,1110,-4800,4,13,17,23.53,-0.03242941176470588,20.470588235294116,0.1685527882614747
1109,553,1347,4,4,8,50.0,0.016212499999999998,22.875,0.22011499529992304
1110,236,-176,1,3,4,25.0,-0.007,10.5,0.2227733087354407
1201,2851,-6831,9,13,22,40.91,-0.013840909090909096,16.772727272727273,0.2494490842261439
1203,1488,-5928,5,7,12,41.67,-0.02071666666666667,21.916666666666668,0.18975055632176616
1210,1815,11685,6,5,11,54.55,0.04639090909090909,23.545454545454547,0.16988203000822275
1213,1510,-4070,7,8,15,46.67,-0.0038399999999999992,20.8,0.20892800681278245
1215,2852,13918,11,11,22,50.0,0.006363636363636364,17.818181818181817,0.19890924697607423
1216,5345,-18845,9,16,25,36.0,-0.013031999999999998,18.92,0.1675640953865302
1217,1193,7727,11,7,18,61.11,0.06821111111111113,24.666666666666668,0.19227597856298997
1218,1313,-633,9,8,17,52.94,-0.002764705882352941,21.88235294117647,0.18876925529243085
1219,55,-95,0,1,1,0.0,-0.0186,3.0,0.16721098266330792
1220,736,-1866,4,7,11,36.36,-0.012190909090909087,13.454545454545455,0.1550488622562697
1225,1544,-4984,3,5,8,37.5,-0.0036,25.5,0.15816249875256272
1227,64,186,1,0,1,100.0,0.0237,19.0,0.08981361542538413
1229,260,-2360,0,3,3,0.0,-0.05203333333333334,25.666666666666668,0.24787040877463107
1231,212,-2162,1,2,3,33.33,-0.050566666666666676,13.666666666666666,0.2638221412721773
1232,628,-578,3,1,4,75.0,0.019150000000000007,26.5,0.17936180570930704
1233,0,0,0,0,0,0.0,,,
1234,390,2140,2,3,5,40.0,0.029919999999999995,20.2,0.2638916622518005
1235,277,-1877,0,2,2,0.0,-0.03945,12.0,0.17397587667931458
1236,487,2513,2,3,5,40.0,0.016440000000000003,23.8,0.1976167165316487
1256,15902,5898,6,7,13,46.15,0.01698461538461538,22.76923076923077,0.17183399797591614
1301,4811,10989,7,5,12,58.33,0.014849999999999997,18.083333333333332,0.22547223502133992
1303,4752,-252,5,8,13,38.46,-0.0015230769230769243,14.538461538461538,0.14715974002539037
1304,153,2147,2,0,2,100.0,0.1014,22.5,0.34926910514159315
1305,1730,1810,8,11,19,42.11,0.0014947368421052618,22.842105263157894,0.28933758252201575
1307,1647,-7597,3,10,13,23.08,-0.02666153846153846,21.076923076923077,0.19101212950441568
1308,2380,2920,11,10,21,52.38,0.016561904761904764,21.523809523809526,0.18290687178100412
1309,1468,1892,7,12,19,36.84,0.019331578947368415,13.0,0.22826791608761313
1310,1099,-3459,6,5,11,54.55,0.004190909090909093,18.363636363636363,0.2567650251023885
1312,2769,-10899,8,21,29,27.59,-0.022634482758620685,14.0,0.2371440051482997
1313,1290,130,6,8,14,42.86,0.0008500000000000006,18.357142857142858,0.17996824358007532
1314,1863,5657,10,15,25,40.0,0.029296,18.84,0.2403291688909595
1315,839,2861,6,1,7,85.71,0.030014285714285716,22.0,0.17781113772855897
1316,300,-1230,1,5,6,16.67,-0.061266666666666664,17.333333333333332,0.3290888814765771
1319,5455,-33205,7,17,24,29.17,-0.035899999999999994,16.375,0.20549046818375258
1321,1554,4446,8,6,14,57.14,0.023914285714285714,21.285714285714285,0.2788909383511528
1323,1474,-2174,4,6,10,40.0,-0.005779999999999999,20.1,0.16390991671343322
1324,1157,1683,7,8,15,46.67,0.019133333333333336,21.733333333333334,0.21589611318212915
1325,424,276,3,3,6,50.0,-0.0012166666666666645,18.5,0.18826195601172224
1326,6847,10253,8,9,17,47.06,0.010535294117647056,17.88235294117647,0.18199061966914723
1337,3190,-24470,7,11,18,38.89,-0.02538333333333333,15.333333333333334,0.18373147937210788
1338,5655,17895,7,5,12,58.33,0.041291666666666664,15.833333333333334,0.24984592338630515
1339,1349,-4249,1,5,6,16.67,-0.01693333333333333,23.666666666666668,0.1437944673099908
1340,3034,-18634,2,6,8,25.0,-0.020325000000000003,13.0,0.2025740300052151
1341,347,2153,1,0,1,100.0,0.0374,18.0,0.1494266365917376
1342,679,1321,2,0,2,100.0,0.012150000000000001,7.5,0.24261530935690223
1402,1613,1887,5,5,10,50.0,0.008720000000000002,28.4,0.13401402518387634
1409,1558,-3618,8,14,22,36.36,-0.004759090909090908,12.772727272727273,0.21491604523996344
1410,1240,-2240,6,11,17,35.29,-0.005964705882352941,21.764705882352942,0.1707453426378104
1413,449,-1149,2,7,9,22.22,-0.04406666666666667,17.0,0.32602769565515377
1414,47,-197,0,1,1,0.0,-0.0752,15.0,0.4110105100400294
1416,365,1965,4,2,6,66.67,0.11299999999999999,24.5,0.267422075509364
1417,1140,-200,8,11,19,42.11,-0.0075421052631578925,18.157894736842106,0.23624831935952406
1418,352,-1532,0,7,7,0.0,-0.07104285714285714,10.857142857142858,0.4045798095687781
1419,1102,10598,3,5,8,37.5,0.083675,18.875,0.24019570191994072
1423,760,-880,5,8,13,38.46,-0.016476923076923077,17.846153846153847,0.1955340866596673
1432,0,0,0,0,0,0.0,,,
1434,1608,-10908,2,9,11,18.18,-0.04499090909090909,14.181818181818182,0.18963751988562194
1435,646,-1806,4,7,11,36.36,0.0011000000000000025,24.545454545454547,0.29973567674748414
1436,635,3545,5,2,7,71.43,0.05561428571428571,26.285714285714285,0.15532438358507936
1437,743,-4503,2,6,8,25.0,-0.031725,12.5,0.2989277123300113
1438,0,0,0,0,0,0.0,,,
1439,3065,-3685,11,13,24,45.83,0.005395833333333332,22.208333333333332,0.19880554824831864
1440,1018,-2368,7,7,14,50.0,-0.006464285714285714,15.928571428571429,0.2374037973524738
1441,0,0,0,0,0,0.0,,,
1442,161,-721,0,3,3,0.0,-0.049066666666666675,15.0,0.3129672001080579
1443,453,-83,3,6,9,33.33,-0.002055555555555552,21.0,0.2174156008639609
1444,1064,76,8,8,16,50.0,-0.011449999999999998,21.0,0.24578357193695335
1445,701,1499,4,7,11,36.36,0.024118181818181816,20.636363636363637,0.24652414218584473
1446,0,0,0,0,0,0.0,,,
1447,1485,-6445,4,18,22,18.18,-0.023586363636363628,16.09090909090909,0.21150939185880954
1449,242,498,3,2,5,60.0,0.005959999999999993,16.4,0.18405559294322424
1451,972,-4452,1,7,8,12.5,-0.03565,15.5,0.2027085312510742
1452,800,1450,6,7,13,46.15,0.019192307692307693,19.384615384615383,0.22786432874801002
1453,53,-303,0,1,1,0.0,-0.0645,7.0,0.20084495712226724
1454,467,-687,3,5,8,37.5,-0.004512500000000001,12.0,0.20389491849617797
1455,1357,2093,11,9,20,55.0,0.023455,17.15,0.24221460758919627
1456,0,0,0,0,0,0.0,,,
1457,329,141,3,3,6,50.0,0.010700000000000001,19.0,0.29328845047341956
1459,1291,-3861,3,16,19,15.79,-0.01962105263157895,17.57894736842105,0.2386046099636957
1460,427,-1827,2,5,7,28.57,-0.03471428571428571,18.0,0.20416692021637045
1463,653,8207,8,2,10,80.0,0.12321,29.5,0.2661517737533667
1464,687,-2337,4,7,11,36.36,-0.02040909090909091,16.09090909090909,0.2604896131404322
1465,1157,-4407,2,12,14,14.29,-0.024299999999999995,18.714285714285715,0.17765216089725447
1466,0,0,0,0,0,0.0,,,
1467,1540,-1580,9,13,22,40.91,-0.012795454545454544,13.090909090909092,0.19513674067072448
1468,376,64,2,3,5,40.0,-0.0008200000000000019,22.8,0.16093021935152368
1470,0,0,0,0,0,0.0,,,
1471,1819,-49,6,15,21,28.57,0.0023333333333333374,22.333333333333332,0.3178804744896447
1472,631,-171,3,7,10,30.0,-0.007790000000000001,21.6,0.215415065615705
1473,1529,4571,5,3,8,62.5,0.025037499999999997,23.875,0.16311886941659087
1474,318,-798,2,3,5,40.0,-0.033839999999999995,21.6,0.3626760203314915
1475,259,-959,1,1,2,50.0,-0.02015,23.5,0.16689476524900382
1476,24947,-48297,8,7,15,53.33,0.013086666666666665,24.133333333333333,0.20095089320860463
1477,6494,18706,5,6,11,45.45,0.009681818181818182,20.545454545454547,0.19847926332163732
1503,1282,10068,3,4,7,42.86,0.05542857142857143,24.285714285714285,0.16268252471960812
1504,2330,-7000,6,15,21,28.57,-0.011423809523809527,18.047619047619047,0.21507437498874327
1506,64,-764,0,1,1,0.0,-0.0878,6.0,0.30577983325574776
1512,1282,-4402,5,15,20,25.0,-0.030305000000000006,16.7,0.24229122553367616
1513,456,2194,3,2,5,60.0,0.04638,14.2,0.19346624610565
1514,499,-1109,2,6,8,25.0,-0.009725000000000003,22.375,0.15543619155165056
1515,690,-1320,4,6,10,40.0,-0.005660000000000003,21.4,0.2364196285630972
1516,99,71,2,0,2,100.0,0.01175,26.0,0.20223784528518052
1517,1507,-3767,5,11,16,31.25,-0.007549999999999998,21.0625,0.24465592672154718
1519,136,-1026,0,2,2,0.0,-0.05385,17.0,0.15386072941893525
1521,5113,-9763,5,12,17,29.41,-0.01191764705882353,18.705882352941178,0.16410436463921965
1522,1890,-4090,5,9,14,35.71,-0.012264285714285719,17.714285714285715,0.21161320126371347
1524,1151,239,7,8,15,46.67,0.004266666666666666,19.0,0.23957051727000211
1525,8922,1378,9,15,24,37.5,-0.007958333333333333,20.208333333333332,0.21129752717721936
1526,324,-1174,1,4,5,20.0,-0.03876,21.2,0.2766618182405793
1527,2564,8636,6,7,13,46.15,0.04533076923076924,23.307692307692307,0.18753216807713666
1528,1333,2487,8,10,18,44.44,0.017,19.77777777777778,0.1709931887855659
1529,1271,339,9,12,21,42.86,-0.014519047619047622,11.619047619047619,0.2795068526338449
1530,2908,-10808,5,10,15,33.33,-0.015413333333333338,25.066666666666666,0.2218715477294024
1531,3199,3601,9,10,19,47.37,0.019,24.526315789473685,0.2330068844727713
1532,1975,5375,4,6,10,40.0,0.01543,25.5,0.1964820080484247
1533,318,-1418,0,2,2,0.0,-0.023399999999999997,24.5,0.2186783543660048
1535,1839,-13039,4,6,10,40.0,-0.02343,11.9,0.2044153996847083
1536,7582,4428,10,11,21,47.62,-0.006142857142857143,19.19047619047619,0.18045137932744296
1537,3407,-10057,3,9,12,25.0,-0.031575,19.0,0.2506379365922944
1538,3003,-6763,4,12,16,25.0,-0.028600000000000004,19.1875,0.32526174118182066
1539,2199,-5319,6,16,22,27.27,-0.012554545454545457,20.954545454545453,0.2277107532648639
1540,187,-337,1,1,2,50.0,-0.0101,13.5,0.17142623405497348
1541,1507,7863,6,4,10,60.0,0.013429999999999997,19.0,0.1645924291328904
1558,5340,-17740,2,6,8,25.0,-0.0027750000000000014,12.25,0.20410732022428288
1560,8233,5417,9,10,19,47.37,0.008910526315789475,16.894736842105264,0.2108995058452768
1568,1097,-3747,4,4,8,50.0,-0.014812500000000001,11.75,0.25434068472582855
1582,5952,-31452,2,10,12,16.67,-0.03028333333333334,15.25,0.1827540273597953
1583,2753,-15003,4,6,10,40.0,-0.0253,12.9,0.23303947516228013
1587,0,0,0,0,0,0.0,,,
1589,4184,-36384,1,7,8,12.5,-0.049100000000000005,18.125,0.13308677655802384
1590,32634,-22134,8,7,15,53.33,-0.004833333333333333,13.066666666666666,0.17489794695205657
1597,7103,-47703,6,11,17,35.29,-0.0218,18.0,0.21275758684271912
1598,1361,8439,2,1,3,66.67,0.05446666666666666,29.0,0.2230548094719668
1603,454,-1904,3,5,8,37.5,-0.0341625,15.25,0.22014068317691843
1604,556,6534,6,2,8,75.0,0.07375,25.0,0.2267853993329487
1605,1450,4620,10,8,18,55.56,0.026794444444444447,25.5,0.18911011226686825
1608,1189,-7219,3,14,17,17.65,-0.03902352941176471,15.823529411764707,0.21190207802385108
1609,877,-3247,6,8,14,42.86,-0.021935714285714284,20.928571428571427,0.188889027095281
1611,404,1246,3,3,6,50.0,0.018849999999999995,23.5,0.1664504192368618
1612,712,1358,6,3,9,66.67,0.009399999999999999,17.0,0.2049123209480901
1614,116,-1116,0,1,1,0.0,-0.0542,7.0,0.14995352853365418
1615,1009,2491,6,6,12,50.0,0.013375,18.0,0.2283927425037998
1616,987,-1577,6,9,15,40.0,0.00018666666666666647,22.733333333333334,0.16340491425575773
1617,624,-1054,4,5,9,44.44,-0.013333333333333332,24.88888888888889,0.1739305422104952
1618,1583,-2803,7,13,20,35.0,-0.00471,16.6,0.2437843841214907
1626,959,-2259,1,5,6,16.67,-0.009866666666666666,16.5,0.17141932005349989
1701,1547,1603,10,6,16,62.5,0.005618749999999999,21.1875,0.1894042128738282
1702,4765,7175,8,16,24,33.33,0.009725,21.625,0.1917142820735247
1707,2665,18485,4,6,10,40.0,0.0397,27.5,0.2258405022669109
1708,248,-548,2,2,4,50.0,-0.02515,19.0,0.17920525526101816
1709,662,738,3,4,7,42.86,0.010942857142857141,15.0,0.13589876217574035
1710,3803,-19953,9,18,27,33.33,-0.025837037037037037,17.185185185185187,0.1900771961322907
1711,1830,-1720,7,10,17,41.18,0.017599999999999998,19.705882352941178,0.22067297641525083
1712,406,244,4,1,5,80.0,0.01566,36.2,0.1782671240013527
1713,717,4083,4,4,8,50.0,0.0344625,24.875,0.26149977748326747
1714,2051,-5141,10,18,28,35.71,-0.019189285714285714,17.571428571428573,0.18402400089282683
1717,3069,11581,12,6,18,66.67,0.019994444444444447,21.5,0.2417758057997964
1718,1094,-4124,8,8,16,50.0,-0.012637500000000001,17.1875,0.18755632570513836
1720,1478,-6228,3,7,10,30.0,-0.019690000000000003,14.1,0.20692388310314264
1721,292,-442,2,3,5,40.0,0.004320000000000002,26.0,0.2325625352216289
1722,3816,11484,5,5,10,50.0,0.034460000000000005,22.0,0.19872716236478574
1723,4274,-4274,2,7,9,22.22,-0.0081,19.666666666666668,0.17937036845202806
1725,1566,2434,7,7,14,50.0,0.01737857142857143,23.428571428571427,0.1769001912720702
1726,783,-6583,0,4,4,0.0,-0.048175,13.5,0.2013568246350701
1727,906,-4256,3,6,9,33.33,-0.02121111111111111,14.333333333333334,0.2606028823689858
1730,158,-1878,0,2,2,0.0,-0.08374999999999999,5.5,0.26840228919711706
1731,1181,-3941,6,8,14,42.86,-0.015478571428571427,12.214285714285714,0.22947471023623742
1732,1396,-10046,4,11,15,26.67,-0.032633333333333334,16.8,0.17001723239358194
1733,3071,-2321,4,9,13,30.77,-0.0024,14.076923076923077,0.21610333790941466
1734,3040,-10140,8,10,18,44.44,-0.01166111111111111,19.72222222222222,0.23467975922539486
1735,653,357,2,6,8,25.0,0.0091375,22.0,0.159732648620482
1736,6653,32097,9,9,18,50.0,0.030127777777777785,25.27777777777778,0.24200241098519473
1737,1713,687,7,6,13,53.85,0.005023076923076922,19.923076923076923,0.24030873503008351
1760,0,0,0,0,0,0.0,,,
1762,3263,2137,6,6,12,50.0,0.00015833333333333267,19.416666666666668,0.1572782173454683
1773,5170,1330,6,5,11,54.55,0.009163636363636363,21.181818181818183,0.13711903909558104
1776,341,-1541,1,2,3,33.33,-0.0229,7.0,0.12280401369626597
1783,1534,-4184,3,6,9,33.33,-0.007977777777777782,20.555555555555557,0.21983928926114257
1786,2866,-1216,2,6,8,25.0,0.020775000000000002,17.5,0.32955546167953875
1789,3716,-8766,7,7,14,50.0,-0.017264285714285715,19.071428571428573,0.16600089606115961
1795,6883,-20083,6,11,17,35.29,-0.016523529411764704,18.294117647058822,0.30400912395804364
1802,2255,-6565,7,9,16,43.75,-0.0018812499999999992,18.625,0.25843624668516973
1805,138,-568,0,3,3,0.0,-0.08043333333333334,20.333333333333332,0.3372835491147866
1806,95,5,1,1,2,50.0,0.0005500000000000019,20.0,0.311135532704059
1808,0,0,0,0,0,0.0,,,
1809,945,4905,9,3,12,75.0,0.020708333333333332,25.083333333333332,0.23043590509583378
1810,59,-519,0,1,1,0.0,-0.0769,21.0,0.08766117023683817
1817,966,1334,3,2,5,60.0,0.01184,20.6,0.27717935859327864
1903,2380,-6880,4,5,9,44.44,-0.006544444444444441,21.0,0.20189671423115546
1904,642,-742,5,4,9,55.56,0.00511111111111111,17.22222222222222,0.22811017741351003
1905,1229,-9059,3,11,14,21.43,-0.04205000000000001,14.714285714285714,0.23622270708230472
1906,46,-276,0,1,1,0.0,-0.1249,5.0,0.8632492731718591
1907,2002,10498,8,11,19,42.11,0.04209473684210526,27.31578947368421,0.22145906373642915
1909,1274,-6404,3,12,15,20.0,-0.020506666666666663,15.533333333333333,0.2573603053298359
2002,1581,-2931,5,5,10,50.0,-0.005529999999999999,21.6,0.21958763891228134
2006,2249,-99,8,6,14,57.14,0.012978571428571426,20.857142857142858,0.23339313589358499
2007,556,7254,5,5,10,50.0,0.16754000000000002,26.0,0.38712266166729536
2008,882,-1312,4,10,14,28.57,-0.008178571428571427,13.571428571428571,0.22326420942765265
2009,2079,-5759,8,13,21,38.1,0.007047619047619043,16.80952380952381,0.2467894870669161
2010,1148,-1938,5,8,13,38.46,-0.0061,14.538461538461538,0.21745712005102386
2012,328,742,3,2,5,60.0,0.021700000000000004,27.8,0.3183856146066339
2013,2505,9195,8,8,16,50.0,0.027956250000000002,20.25,0.20027116369030795
2014,495,1255,3,3,6,50.0,0.015066666666666667,14.0,0.2578885297259397
2015,2075,3925,4,4,8,50.0,0.01005,11.0,0.22372885597581824
2017,324,1616,2,3,5,40.0,0.047060000000000005,10.8,0.33941717582411235
2020,652,498,4,3,7,57.14,0.007628571428571429,22.428571428571427,0.19517878920006826
2022,540,360,4,5,9,44.44,0.008011111111111111,15.555555555555555,0.2900789372660071
2023,1297,1323,8,6,14,57.14,0.016714285714285716,25.571428571428573,0.19243804613234422
2024,370,100,1,6,7,14.29,-0.018685714285714288,13.428571428571429,0.3714535265373976
2025,1588,-3788,10,18,28,35.71,-0.036064285714285715,17.642857142857142,0.3037291321712319
2027,64,586,1,0,1,100.0,0.0792,33.0,0.1521369784136708
2028,153,-1393,0,3,3,0.0,-0.11376666666666667,10.333333333333334,0.5603511149789505
2029,1293,-6043,2,5,7,28.57,-0.01125714285714286,14.857142857142858,0.2620518914260468
2030,1475,-16815,1,14,15,6.67,-0.05635333333333334,15.8,0.22010133458731088
2031,1769,-15719,4,10,14,28.57,-0.03439285714285714,16.071428571428573,0.2716869022193375
2032,1356,-9016,3,10,13,23.08,-0.03129230769230769,18.46153846153846,0.29911040042213494
2033,839,-6009,3,8,11,27.27,-0.03688181818181818,13.727272727272727,0.29132804816258756
2034,2164,6636,8,8,16,50.0,0.02008125,26.5625,0.1929727985204447
2038,652,1398,2,4,6,33.33,0.03586666666666666,29.166666666666668,0.20142368585983653
2049,18171,-98971,5,9,14,35.71,-0.022635714285714283,16.571428571428573,0.231315142750441
2059,7990,100510,5,4,9,55.56,0.10593333333333332,18.22222222222222,0.2389904106088493
2062,3608,-2108,7,9,16,43.75,0.01306875,18.4375,0.25886025776900684
2069,407,-5157,0,4,4,0.0,-0.075875,17.75,0.1641590057869851
2101,58,-1158,0,1,1,0.0,-0.162,6.0,0.2837222028932447
2102,1529,-5029,7,8,15,46.67,-0.010399999999999998,21.733333333333334,0.22333672834924168
2103,3324,-524,9,9,18,50.0,0.01115555555555555,24.333333333333332,0.21333943165320868
2104,73,1277,1,0,1,100.0,0.1316,73.0,0.13255144120498974
2105,5462,-6712,9,11,20,45.0,-0.006264999999999998,17.95,0.18521181955857324
2106,4352,-12952,8,15,23,34.78,-0.014117391304347823,15.695652173913043,0.17820498270830812
2107,888,-38,5,5,10,50.0,0.0058800000000000015,20.6,0.2335861864836422
2108,2946,-16196,5,12,17,29.41,-0.02042941176470588,19.11764705882353,0.14758699954513227
2109,1290,5550,6,11,18,33.33,0.03572222222222222,28.944444444444443,0.20559200503952788
2114,3589,3611,4,5,9,44.44,-0.00035555555555555476,24.444444444444443,0.1957227160363885
2115,2568,2782,4,6,10,40.0,0.011030000000000002,23.5,0.1961410913980584
2201,4871,129,10,9,19,52.63,-0.0011421052631578946,22.157894736842106,0.20739131154210097
2204,3046,-13846,6,12,18,33.33,-0.02463333333333333,12.055555555555555,0.21252512624476946
2206,1496,1644,6,10,16,37.5,0.001806249999999997,17.4375,0.21660117673887597
2207,24490,139510,9,5,14,64.29,0.022014285714285715,23.5,0.18113676779651736
2208,1872,5178,5,8,13,38.46,0.02658461538461538,19.692307692307693,0.23745900010266338
2227,9762,-46162,2,6,8,25.0,-0.0300625,11.25,0.15149044374219167
2228,3235,-18835,1,5,6,16.67,-0.03061666666666667,28.166666666666668,0.19606966133414686
2231,12067,68933,7,6,13,53.85,0.02797692307692307,19.76923076923077,0.21092003497961406
2233,6678,22772,6,8,14,42.86,0.021599999999999998,18.428571428571427,0.2581220284429297
2236,626,-7526,1,4,5,20.0,-0.06128,17.2,0.34954848925123205
2239,5283,-7883,4,5,9,44.44,0.002122222222222223,14.444444444444445,0.21128107305003535
2241,1222,428,2,2,4,50.0,-0.012,16.5,0.2204473768512346
2243,560,-3960,0,5,5,0.0,-0.0356,6.8,0.20072936516933226
2247,2726,-726,1,1,2,50.0,-0.0017499999999999998,23.0,0.18874400011136627
2301,3006,-4206,6,8,14,42.86,-0.0021285714285714276,26.0,0.19856759621212763
2302,170,380,1,2,3,33.33,0.03133333333333333,15.666666666666666,0.19751644738522414
2303,1065,-115,4,5,9,44.44,-0.000822222222222223,17.333333333333332,0.19008156311773974
2305,62,-862,0,1,1,0.0,-0.1077,12.0,0.31026891534271583
2308,10854,6246,7,7,14,50.0,-0.0026214285714285706,12.5,0.16135352022809576
2312,1459,1101,11,9,20,55.0,0.003454999999999999,19.0,0.17070956071832075
2313,3269,-5049,14,13,27,51.85,0.0025,17.11111111111111,0.19957742295854497
2314,965,1295,5,6,11,45.45,0.05690909090909091,15.636363636363637,0.23856069067373953
2316,949,-4149,4,7,11,36.36,-0.024554545454545454,16.0,0.22264489447345434
2317,9082,-182,6,9,15,40.0,-0.008886666666666666,14.133333333333333,0.13141661379804023
2321,1476,-4626,6,18,24,25.0,-0.04294583333333333,13.75,0.22677430135414958
2323,1357,-247,11,10,21,52.38,-0.004299999999999999,17.19047619047619,0.22056007834807045
2324,2471,-4221,8,8,16,50.0,-0.004787500000000002,13.9375,0.18734324019733717
2327,913,7597,7,5,12,58.33,0.04034166666666666,20.25,0.2783220320116487
2328,5219,-19219,12,18,30,40.0,-0.008533333333333335,15.433333333333334,0.2523153424003182
2329,0,0,0,0,0,0.0,,,
2330,3773,-15073,4,6,10,40.0,-0.020089999999999997,12.0,0.1430700126411066
2331,1078,-478,5,4,9,55.56,0.029166666666666667,18.444444444444443,0.21983773857932015
2332,3198,-1878,10,12,22,45.45,0.02091818181818182,17.545454545454547,0.2302589219300761
2337,348,-2238,2,4,6,33.33,-0.04973333333333333,19.666666666666668,0.34758840453514983
2338,947,3103,8,2,10,80.0,0.018779999999999998,15.6,0.1895837777119677
2340,600,-2040,2,6,8,25.0,-0.022262499999999998,14.625,0.2979460006456425
2342,111,229,1,1,2,50.0,0.01815,11.5,0.31154454964088774
2344,1847,-2177,10,13,23,43.48,-0.003908695652173913,17.82608695652174,0.2272002723488141
2345,4073,-37373,6,10,16,37.5,-0.013399999999999999,16.1875,0.19306651795277688
2347,770,3730,3,0,3,100.0,0.0309,20.666666666666668,0.15013155084397067
2348,0,0,0,0,0,0.0,,,
2349,2086,-1436,15,19,34,44.12,-0.005808823529411763,19.264705882352942,0.2773816975712189
2351,5455,-24405,10,8,18,55.56,0.007272222222222223,22.27777777777778,0.21770339141341624
2352,1869,-7499,8,11,19,42.11,-0.022994736842105262,13.263157894736842,0.2526085144394628
2353,1232,-10532,2,4,6,33.33,-0.007483333333333332,10.166666666666666,0.23699775339276133
2354,16543,-17643,9,11,20,45.0,-0.013849999999999998,16.0,0.18810341330884708
2355,6587,-9237,12,20,32,37.5,-0.008821874999999998,13.5,0.1934671501236212
2356,1533,-10983,5,9,14,35.71,-0.038985714285714276,17.285714285714285,0.229733883638509
2357,3664,-25414,2,7,9,22.22,-0.04156666666666667,14.666666666666666,0.2393421436100491
2358,43,-163,0,1,1,0.0,-0.1567,10.0,0.2623064880960779
2359,400,-4400,1,3,4,25.0,-0.05814999999999999,12.0,0.23951050296094295
2360,10320,13980,11,7,18,61.11,0.016372222222222222,21.11111111111111,0.2129182554572418
2362,3604,546,7,12,19,36.84,0.010889473684210525,15.736842105263158,0.20586871400980664
2363,1039,-1039,4,5,9,44.44,0.006544444444444444,15.555555555555555,0.25887379062984395
2364,225,-435,2,2,4,50.0,-0.003050000000000004,17.5,0.3612801309827322
2365,793,3757,3,1,4,75.0,0.027625,22.0,0.23591045239283187
2367,2685,3385,14,13,27,51.85,0.00433703703703704,16.48148148148148,0.21628959342450513
2368,2461,-4321,7,14,21,33.33,0.007823809523809525,16.952380952380953,0.2521777040743099
2369,1790,-1280,10,11,21,47.62,0.0030857142857142867,15.666666666666666,0.2012096843856085
2371,752,518,6,4,10,60.0,0.013420000000000001,18.6,0.24655671142440413
2373,0,0,0,0,0,0.0,,,
2374,3423,-7273,10,16,26,38.46,-0.0037615384615384616,17.76923076923077,0.23941290614003388
2375,418,-2358,3,4,7,42.86,-0.023028571428571433,16.857142857142858,0.3191011333057527
2376,3065,-7065,5,7,12,41.67,-0.011924999999999998,17.5,0.21213603128135103
2377,6355,-26105,8,17,25,32.0,-0.02112,17.0,0.21205510271781564
2379,16356,-9806,6,10,16,37.5,0.004106250000000003,17.6875,0.2606868450536168
2380,1452,1878,7,9,16,43.75,-0.0006625000000000003,19.8125,0.24541274912775377
2382,4953,6597,8,6,14,57.14,0.0061,22.357142857142858,0.18099400561870707
2383,1060,-6680,2,9,11,18.18,-0.03810909090909091,12.909090909090908,0.24481719935242052
2385,4597,-20497,6,7,13,46.15,-0.022861538461538457,19.76923076923077,0.2297470383477075
2387,3124,-7024,9,12,21,42.86,0.0012857142857142876,15.571428571428571,0.181184685131097
2388,919,-4419,2,4,6,33.33,-0.024500000000000004,19.666666666666668,0.20490332831308164
2390,2060,-20,10,13,23,43.48,0.020139130434782607,20.695652173913043,0.19501952608477424
2392,9222,-30822,10,16,26,38.46,-0.012634615384615385,15.692307692307692,0.24051224715197522
2393,5899,-6549,6,11,17,35.29,-0.002741176470588234,15.529411764705882,0.26446712229854114
2395,13407,-36107,3,11,14,21.43,-0.022385714285714287,15.071428571428571,0.16255481940789812
2397,2065,-2065,3,6,9,33.33,0.007533333333333332,17.555555555555557,0.1675883079173093
2399,2074,-12814,6,16,22,27.27,-0.023986363636363636,18.727272727272727,0.3079797885199152
2401,2535,1505,7,9,16,43.75,-0.0059375,16.0625,0.2501840459923893
2402,3070,5380,13,11,24,54.17,0.014666666666666666,18.625,0.2348618592968086
2404,1426,-7476,3,5,8,37.5,-0.0349625,11.75,0.15516357649926146
2405,2709,-18159,8,22,30,26.67,-0.038386666666666666,15.433333333333334,0.26571386822164045
2406,1033,4357,5,10,15,33.33,0.04762,18.466666666666665,0.2873699704777559
2408,753,-9713,1,8,9,11.11,-0.08375555555555556,11.777777777777779,0.42837718800744135
2409,2862,4238,10,8,18,55.56,0.02361111111111111,17.833333333333332,0.20077629098474503
2412,0,0,0,0,0,0.0,,,
2413,1718,-7718,6,13,19,31.58,-0.029415789473684208,17.473684210526315,0.25164739155931687
2414,683,217,4,4,8,50.0,0.0008500000000000001,21.625,0.17735453342233537
2415,2755,-7185,12,17,29,41.38,-0.010382758620689657,18.75862068965517,0.23900786240019767
2417,3882,-3792,10,13,23,43.48,0.023934782608695658,13.217391304347826,0.18790992850237073
2419,2496,-7206,8,18,26,30.77,-0.021303846153846152,18.03846153846154,0.2566490037196312
2420,2913,-4913,8,12,20,40.0,-0.013340000000000001,20.5,0.23878025115097185
2421,2686,-12586,5,16,21,23.81,-0.02899047619047619,16.142857142857142,0.19429887225226977
2423,938,-2788,4,5,9,44.44,-0.017011111111111112,16.77777777777778,0.17161734661379588
2424,463,1447,4,3,7,57.14,0.018285714285714287,20.0,0.3185098850616369
2425,0,0,0,0,0,0.0,,,
2426,1910,-10300,6,14,20,30.0,-0.032605,14.05,0.2926916555333568
2427,1157,3203,8,7,15,53.33,0.01975333333333333,18.0,0.30321913895146047
2428,9643,-58393,7,18,25,28.0,-0.027047999999999996,14.84,0.21021363895664988
2429,347,-1477,1,6,7,14.29,-0.08445714285714286,15.714285714285714,0.2725662234063367
2430,2271,-6921,5,4,9,55.56,-0.012599999999999998,14.555555555555555,0.2585972684320279
2431,1900,9200,7,16,23,30.43,0.026421739130434784,17.82608695652174,0.21944468057171732
2433,121,-1171,0,2,2,0.0,-0.0796,12.5,0.2072688857411864
2434,1892,-11422,7,11,18,38.89,-0.01417777777777778,18.88888888888889,0.2640251559219904
2436,2318,-7018,7,7,14,50.0,0.001492857142857143,16.0,0.2267530017855654
2438,494,2156,7,1,8,87.5,0.045662499999999995,25.75,0.2702749045682953
2439,11834,29166,8,12,20,40.0,0.00524,17.85,0.2078531947685358
2440,414,-3254,1,6,7,14.29,-0.08818571428571428,10.571428571428571,0.3916180327006301
2441,2281,-10781,2,9,11,18.18,-0.025781818181818184,14.363636363636363,0.20584855047237352
2442,611,-3001,2,7,9,22.22,-0.03502222222222222,17.555555555555557,0.3114749681058109
2443,794,-4744,2,11,13,15.38,-0.0698,15.692307692307692,0.27284922988368937
2444,871,2489,3,7,10,30.0,-0.01283,14.7,0.3591387952005686
2449,2092,-2032,10,8,18,55.56,0.0031666666666666666,21.555555555555557,0.21410786863999695
2450,2722,-11072,6,10,16,37.5,-0.008862499999999999,18.1875,0.1708104445557086
2451,10227,-66227,5,16,21,23.81,-0.030790476190476184,14.047619047619047,0.23959556822778455
2453,1355,-2005,4,12,16,25.0,-0.011768750000000001,18.4375,0.19151943364268112
2454,37833,-162333,8,10,18,44.44,-0.02338888888888889,21.22222222222222,0.20778018341167798
2455,4387,10513,6,10,16,37.5,0.0017562499999999974,17.5625,0.2677067294912079
2457,1099,2111,4,6,10,40.0,0.004090000000000002,17.5,0.27360355249778
2458,6924,-12324,9,9,18,50.0,-0.013699999999999997,16.666666666666668,0.19222006828786814
2459,2326,-4576,5,8,13,38.46,-0.014961538461538462,15.384615384615385,0.2502409598129778
2460,3133,-7613,8,14,22,36.36,0.00043636363636363496,16.863636363636363,0.21119073289420906
2461,1992,2958,7,12,19,36.84,0.0058736842105263165,20.94736842105263,0.2306932641871582
2462,2079,-19429,5,11,16,31.25,-0.0371125,15.5,0.25936656647309564
2464,362,-2612,1,2,3,33.33,-0.036166666666666666,14.333333333333334,0.34364866273874495
2465,458,-2478,2,4,6,33.33,-0.02751666666666666,18.666666666666668,0.4842128970265766
2466,1018,182,3,5,8,37.5,0.023275000000000004,16.0,0.24815660751145954
2467,2539,11011,14,3,17,82.35,0.02214705882352941,23.352941176470587,0.22069679390496386
2468,830,-7080,2,9,11,18.18,-0.04887272727272727,20.818181818181817,0.2190598627832155
2471,2034,-3984,9,15,24,37.5,-0.012025000000000003,17.333333333333332,0.23360792137704878
2472,1392,-8602,4,10,14,28.57,-0.02802857142857143,14.214285714285714,0.2738707831423268
2474,16192,33608,8,9,17,47.06,0.005994117647058823,19.352941176470587,0.27323098217321895
2476,1981,69,6,7,13,46.15,0.004153846153846155,19.384615384615383,0.23945951971210955
2477,3615,-4265,11,16,27,40.74,0.012025925925925926,23.62962962962963,0.22332241446160614
2478,2410,-9360,10,9,19,52.63,-0.0037526315789473685,18.36842105263158,0.19250562533152749
2480,555,-55,2,1,3,66.67,0.0134,13.666666666666666,0.16575525771834912
2481,5150,22990,15,13,28,53.57,0.01624642857142857,17.821428571428573,0.25663615643045207
2482,1868,7282,11,6,17,64.71,0.04117058823529412,21.470588235294116,0.2975440317810139
2483,1681,-1071,6,10,16,37.5,-0.0048625,18.875,0.16899206406391798
2484,2056,-17786,7,14,21,33.33,-0.04358095238095238,22.714285714285715,0.27304632994291406
2485,4795,-21745,6,18,24,25.0,-0.016558333333333335,15.25,0.24015455132233132
2486,2549,7351,11,10,21,52.38,0.012114285714285713,19.523809523809526,0.2831259346174336
2488,359,-2509,0,4,4,0.0,-0.0466,7.0,0.1775227268655749
2489,1924,-5674,6,11,17,35.29,-0.013241176470588235,18.0,0.22655889019927689
2491,244,826,2,2,4,50.0,-0.02215,17.75,0.3751686871861695
2492,8145,-17115,9,10,19,47.37,-0.010689473684210526,12.0,0.27437364584795787
2493,1873,287,9,8,17,52.94,0.006364705882352942,17.058823529411764,0.23535516596539008
2495,5802,-16452,11,17,28,39.29,-0.011249999999999998,18.035714285714285,0.21084986319041144
2496,234,-2884,0,4,4,0.0,-0.116175,3.5,0.4161322401798889
2497,4972,-14672,8,19,27,29.63,-0.01268888888888889,17.0,0.22892031399296697
2498,33389,119111,10,12,22,45.45,0.01556818181818182,15.227272727272727,0.2127940701524241
2501,1606,-3636,7,11,18,38.89,0.015055555555555563,15.777777777777779,0.21518846469476743
2504,1211,-1381,8,7,15,53.33,-0.0032200000000000006,19.066666666666666,0.2353480010350673
2505,121,519,1,1,2,50.0,-0.0119,12.0,0.62025783867652
2506,87,-137,0,2,2,0.0,-0.059800000000000006,5.0,0.386432348100166
2509,54,426,1,0,1,100.0,0.106,34.0,0.15377569610597774
2511,1747,-6307,8,13,21,38.1,0.0018666666666666627,19.80952380952381,0.207851569735791
2514,191,1539,2,1,3,66.67,0.04033333333333333,14.333333333333334,0.32092244152283916
2515,1300,-3880,7,15,22,31.82,-0.01875909090909091,18.636363636363637,0.19820497701192358
2516,378,182,2,5,7,28.57,0.010371428571428571,15.428571428571429,0.3540425929958217
2520,756,-5916,2,7,9,22.22,-0.04617777777777778,10.88888888888889,0.27350612342437675
2524,3437,-1087,5,16,21,23.81,0.012061904761904765,16.80952380952381,0.19435549250751474
2527,155,355,2,1,3,66.67,0.034466666666666666,23.0,0.2019365599977839
2528,127,23,2,1,3,66.67,0.07453333333333334,25.0,0.5358315030899666
2530,50,780,1,0,1,100.0,0.3035,20.0,0.6352179616558227
2534,1865,5585,10,7,17,58.82,0.039629411764705885,21.529411764705884,0.21538111417003847
2535,1421,1439,7,10,17,41.18,0.025347058823529414,20.41176470588235,0.2349198159884287
2536,1800,2600,6,4,10,60.0,0.01853,25.2,0.28260683313012824
2537,0,0,0,0,0,0.0,,,
2538,1214,-6184,7,7,14,50.0,-0.021235714285714285,19.642857142857142,0.19249265191593867
2539,0,0,0,0,0,0.0,,,
2540,131,49,2,1,3,66.67,0.034333333333333334,13.333333333333334,0.6791544393164645
2542,1362,-1962,4,3,7,57.14,0.06764285714285714,15.428571428571429,0.27721443850871086
2543,1165,-825,7,11,18,38.89,0.018361111111111113,23.166666666666668,0.16809248585366662
2545,2172,-14972,4,7,11,36.36,-0.02428181818181818,15.0,0.2570767862055275
2546,1737,1303,7,9,16,43.75,-0.005681250000000002,19.1875,0.24519460458213344
2547,1781,13609,9,7,16,56.25,0.052806250000000006,20.5,0.23548852074860013
2548,5008,-55058,1,13,14,7.14,-0.057771428571428564,13.214285714285714,0.21944906599963382
2597,739,-989,1,2,3,33.33,-0.0209,25.666666666666668,0.1387209084473715
2601,45,-145,0,1,1,0.0,-0.0788,6.0,0.3422455728144582
2603,2316,-20616,3,12,15,20.0,-0.04088666666666666,14.066666666666666,0.22171857231529407
2605,2185,-2535,7,7,14,50.0,-0.005207142857142859,13.857142857142858,0.18281752579204572
2606,4602,12048,8,9,17,47.06,0.01991176470588235,21.058823529411764,0.20951284098158116
2607,1763,-5613,7,11,18,38.89,-0.019799999999999998,14.88888888888889,0.1981584739961773
2608,2016,12034,8,7,15,53.33,0.04953333333333333,20.533333333333335,0.28086127263284194
2609,1554,-8924,8,9,17,47.06,-0.033611764705882355,19.294117647058822,0.19904547653389518
2610,408,92,2,3,5,40.0,0.004839999999999999,30.0,0.2006336405518041
2611,976,1054,6,7,13,46.15,0.0058230769230769265,22.384615384615383,0.15294742222164542
2612,0,0,0,0,0,0.0,,,
2613,1525,-1355,7,10,17,41.18,0.017729411764705882,17.176470588235293,0.22878645612486115
2614,53,-563,0,1,1,0.0,-0.1147,14.0,0.364741651630516
2615,2440,-8690,9,8,17,52.94,0.010217647058823527,25.176470588235293,0.2710522131990208
2616,528,-1228,4,2,6,66.67,-0.014150000000000001,19.666666666666668,0.13370212381989025
2617,2334,10316,8,7,15,53.33,0.03420666666666668,20.533333333333335,0.23037758168634415
2618,595,-4625,3,5,8,37.5,-0.049812499999999996,16.125,0.18894468672079665
2630,631,119,3,2,5,60.0,0.0051,21.2,0.1457762246084635
2633,613,2287,2,2,4,50.0,0.01885,26.5,0.1883905620990342
2634,1330,-8680,1,6,7,14.29,-0.03401428571428572,18.285714285714285,0.13668073149742227
2636,1795,555,2,5,7,28.57,0.026771428571428564,18.714285714285715,0.1713785916737795
2637,295,-545,0,2,2,0.0,-0.01085,15.0,0.12703008743968314
2642,2370,-2920,5,6,11,45.45,-0.01011818181818182,17.454545454545453,0.1988757372021039
2701,820,-3210,5,5,10,50.0,-0.021829999999999995,16.4,0.15748005923475739
2702,2022,128,8,8,16,50.0,0.0061562499999999985,18.125,0.2089851784546339
2704,2091,-9091,5,6,11,45.45,-0.01674545454545454,16.545454545454547,0.17857930613384507
2705,1412,-2502,7,9,16,43.75,-0.015574999999999997,14.1875,0.23970716232423814
2706,1263,-5713,3,7,10,30.0,-0.020509999999999997,18.6,0.16913066124320006
2707,0,0,0,0,0,0.0,,,
2712,125,-725,0,1,1,0.0,-0.0333,8.0,0.1137079805187835
2722,560,-960,1,2,3,33.33,-0.007333333333333331,10.0,0.24931670575656809
2723,10662,-26962,4,7,11,36.36,0.011863636363636364,18.363636363636363,0.27805172006392803
2727,5924,-30224,4,3,7,57.14,-0.013728571428571427,17.0,0.18112471095845567
2731,5242,-11742,4,6,10,40.0,-0.013569999999999995,26.9,0.22846904875054985
2739,419,2931,3,0,3,100.0,0.04243333333333333,27.666666666666668,0.11238728013240284
2748,591,-541,1,1,2,50.0,0.0046,21.5,0.1787630350412972
2801,700,1450,3,4,7,42.86,0.022828571428571427,16.428571428571427,0.13022856717455547
2809,2388,-5958,6,14,20,30.0,-0.0005699999999999979,17.05,0.1450223839296794
2812,184,-214,1,2,3,33.33,-0.02476666666666667,7.333333333333333,0.35849454894292165
2816,243,-483,2,2,4,50.0,0.011425000000000001,22.5,0.16158942298323226
2820,423,-3383,1,6,7,14.29,-0.06265714285714286,16.142857142857142,0.18945719168061514
2832,0,0,0,0,0,0.0,,,
2834,129,81,1,1,2,50.0,0.01165,20.5,0.234804951748247
2836,757,363,5,5,10,50.0,0.0037599999999999995,22.0,0.13325767824042625
2838,247,-647,2,2,4,50.0,-0.030550000000000004,29.5,0.18628033269309452
2841,1411,1379,10,12,22,45.45,-0.0023818181818181807,17.0,0.2834368378620807
2845,594,-3334,1,7,8,12.5,-0.0274625,18.5,0.22363533921319656
2849,515,575,6,2,8,75.0,0.017512500000000004,17.0,0.18258258921333057
2850,612,-2912,1,6,7,14.29,-0.024814285714285712,15.571428571428571,0.14975478230021472
2851,327,-887,2,2,4,50.0,-0.009725000000000001,15.75,0.22375021063240963
2852,947,-1397,6,5,11,54.55,-0.0025909090909090877,17.09090909090909,0.16589134491145532
2855,1100,-1700,3,9,12,25.0,-0.0019083333333333313,22.166666666666668,0.19526481606326915
2867,453,-1353,2,4,6,33.33,-0.01721666666666667,13.666666666666666,0.1070977480534721
2880,1613,-1613,7,5,12,58.33,0.0034666666666666704,16.083333333333332,0.17164744458347447
2881,2763,-4113,4,9,13,30.77,-0.004853846153846154,20.307692307692307,0.1652887487735891
2882,2902,-13452,3,8,11,27.27,-0.02897272727272727,15.909090909090908,0.20037677474531132
2883,1168,-1918,6,10,16,37.5,-0.011593750000000002,18.75,0.14556347359940497
2884,1148,-2448,3,7,10,30.0,-0.01711,14.9,0.13325845769972894
2885,786,464,6,3,9,66.67,0.0006444444444444467,23.22222222222222,0.21692754476386408
2886,1178,-5778,3,7,10,30.0,-0.03085,16.8,0.1446390660159429
2887,683,-6943,3,5,8,37.5,-0.040575,13.125,0.19059454909732373
2888,1108,82,5,7,12,41.67,0.004008333333333332,16.916666666666668,0.259950565944673
2889,506,-2766,2,5,7,28.57,-0.026699999999999995,22.857142857142858,0.175129642447902
2890,1175,-3535,4,10,14,28.57,-0.023828571428571428,16.0,0.157593959461873
2891,876,4524,5,2,7,71.43,0.028599999999999997,27.285714285714285,0.13383332019196106
2892,844,-2294,3,4,7,42.86,-0.008800000000000002,17.571428571428573,0.26853446155121324
2897,259,1231,3,1,4,75.0,0.0383,16.0,0.21503253655289267
2901,1383,-9333,0,11,11,0.0,-0.038845454545454544,20.09090909090909,0.18066348452786685
2903,2592,3058,9,12,21,42.86,0.0013571428571428575,18.857142857142858,0.18780611162511004
2904,256,-306,1,4,5,20.0,0.012280000000000003,23.0,0.255766685493184
2905,132,-982,1,1,2,50.0,-0.0419,18.0,0.17207471986125922
2906,139,-239,1,1,2,50.0,-0.01025,22.0,0.14904303756424242
2908,291,1009,2,0,2,100.0,0.022,21.5,0.12252804029640085
2910,130,-1630,0,1,1,0.0,-0.0694,7.0,0.17879444506170095
2911,1667,-6117,7,10,17,41.18,-0.006282352941176471,15.235294117647058,0.25310137188284576
2912,11311,-3011,4,10,14,28.57,-0.005657142857142856,25.5,0.1667444185384515
2913,101,-131,1,1,2,50.0,-0.008399999999999998,24.5,0.4436063369362614
2915,7201,-11351,10,14,24,41.67,-0.012066666666666665,17.583333333333332,0.21813514280166624
2923,1151,2599,3,5,8,37.5,0.015250000000000003,18.0,0.18160191560311187
2929,5460,-23510,4,9,13,30.77,-0.016146153846153845,24.46153846153846,0.2947832662045814
2939,519,-16919,0,1,1,0.0,-0.1675,17.0,0.12315920705501715
3002,829,-3079,2,7,9,22.22,-0.011511111111111114,21.555555555555557,0.16378229065427818
3003,4923,19877,13,11,24,54.17,0.009483333333333331,19.916666666666668,0.2098449609464892
3004,703,607,4,6,10,40.0,-0.019950000000000002,15.2,0.26526781761380924
3005,3915,2035,9,16,25,36.0,0.0070999999999999995,19.0,0.23113986094332084
3006,5243,8807,6,11,17,35.29,-0.010482352941176469,14.823529411764707,0.2659806121833145
3008,275041,946959,12,10,22,54.55,0.018963636363636363,20.272727272727273,0.18815749295808343
3010,1258,-5108,2,3,5,40.0,-0.012960000000000005,15.2,0.18143941965776564
3011,1491,6439,11,8,19,57.89,0.05059473684210527,22.736842105263158,0.26012770795600937
3013,1454,246,9,6,15,60.0,0.0033799999999999998,16.133333333333333,0.19370919535105222
3014,2582,24968,4,6,10,40.0,0.030779999999999995,19.9,0.31778009052902484
3015,1933,-4733,4,6,10,40.0,-0.01857,14.9,0.18700025114646837
3016,4448,24522,13,8,21,61.9,0.03661904761904763,20.714285714285715,0.27888927817486514
3017,4337,2563,10,16,26,38.46,-0.002842307692307693,15.076923076923077,0.22930392200084382
3018,439,-859,1,6,7,14.29,-0.04442857142857143,16.285714285714285,0.23802633492351863
3019,11347,-8497,10,12,22,45.45,-0.009954545454545456,11.590909090909092,0.20620427211667564
3021,611,-4091,1,7,8,12.5,-0.09887499999999999,17.5,0.3375418762175977
3022,4470,15430,12,7,19,63.16,0.021610526315789476,19.157894736842106,0.2399759599206405
3023,792,-4942,1,5,6,16.67,-0.0462,13.0,0.2557817789148816
3024,2325,-7135,7,19,26,26.92,-0.012650000000000003,17.692307692307693,0.2288341839824254
3025,1868,-6868,7,10,17,41.18,-0.011729411764705882,18.41176470588235,0.2647632962345931
3026,1889,-12639,2,7,9,22.22,-0.040933333333333335,19.22222222222222,0.2510317140258455
3027,1739,-7379,7,8,15,46.67,-0.008340000000000005,14.866666666666667,0.2461592803900069
3028,1999,-3049,8,8,16,50.0,-0.01176875,13.0625,0.1704357209789838
3029,3582,-752,12,18,30,40.0,0.013126666666666667,19.866666666666667,0.23324960393446478
3030,4951,-5651,6,13,19,31.58,-0.004721052631578948,16.36842105263158,0.16868317737183747
3031,3801,-35541,9,18,27,33.33,-0.03548148148148148,17.22222222222222,0.24480372965849262
3032,632,-782,2,5,7,28.57,0.0066,19.571428571428573,0.18542246163545567
3033,1451,-2481,6,7,13,46.15,-0.01300769230769231,18.307692307692307,0.2548130354923426
3034,13330,-85330,6,14,20,30.0,-0.029765000000000003,18.95,0.22379476387915673
3035,4949,-1899,8,7,15,53.33,0.002573333333333334,17.4,0.22521156954655694
3036,2431,-14581,4,10,14,28.57,-0.03709285714285714,16.142857142857142,0.22288819019411274
3037,3744,14806,9,7,16,56.25,0.025999999999999995,16.75,0.35310623767339083
3038,1822,3668,8,13,21,38.1,0.02574761904761905,18.571428571428573,0.28053700520266506
3040,1598,-10068,5,11,16,31.25,-0.029262500000000004,16.5,0.19423458703334054
3041,3169,4181,9,8,17,52.94,0.0318235294117647,22.235294117647058,0.29657857518411823
3042,5702,-34852,5,14,19,26.32,-0.025536842105263156,14.842105263157896,0.1845580457402491
3043,2864,-20044,4,23,27,14.81,-0.04848518518518518,10.962962962962964,0.3228796489331611
3044,11050,-37150,8,18,26,30.77,-0.008219230769230769,14.0,0.2005486207583926
3045,1811,-3311,3,6,9,33.33,-0.010477777777777777,12.88888888888889,0.11047785194452607
3046,1117,-8817,2,12,14,14.29,-0.04774285714285714,13.642857142857142,0.18379060458292815
3047,2748,-4428,10,18,28,35.71,0.0032535714285714256,16.642857142857142,0.28628362020674186
3048,2285,-5785,7,12,19,36.84,-0.02068947368421053,15.947368421052632,0.2034195334284509
3049,144,556,1,1,2,50.0,0.05645000000000001,15.5,0.24082011245077095
3050,1050,-6840,4,10,14,28.57,-0.03041428571428572,17.928571428571427,0.27771676628909153
3051,1934,-14044,2,4,6,33.33,-0.06213333333333334,14.5,0.4461873544136426
3052,1146,-2646,7,10,17,41.18,-0.027347058823529415,14.823529411764707,0.20031317173006577
3054,358,2502,2,1,3,66.67,0.06093333333333334,19.0,0.45889363812569384
3055,1074,-2274,3,4,7,42.86,-0.019342857142857144,24.714285714285715,0.2628353646845221
3056,111,-1261,0,2,2,0.0,-0.1062,25.5,0.21465523431920952
3057,3034,-5294,11,13,24,45.83,-0.00985,18.291666666666668,0.318601448801477
3058,1262,-7112,5,10,15,33.33,-0.021633333333333338,21.466666666666665,0.3123606114075068
3059,4932,-19182,9,16,25,36.0,-0.010284,16.48,0.27514311741969677
3060,7406,17144,12,13,25,48.0,0.015344,16.64,0.23782802226851973
3062,4188,5712,14,12,26,53.85,0.004046153846153844,16.846153846153847,0.23475070478435886
3090,4076,-11026,4,14,18,22.22,-0.015294444444444444,18.11111111111111,0.25121335537000666
3094,4069,-14819,8,14,22,36.36,-0.011695454545454547,19.181818181818183,0.2144461563910965
3130,5369,631,2,5,7,28.57,0.0011285714285714271,15.857142857142858,0.19492999772244843
3138,0,0,0,0,0,0.0,,,
3149,1947,-13927,4,7,11,36.36,-0.0032818181818181826,21.363636363636363,0.3016286001044582
3164,3925,-13775,8,12,20,40.0,-0.006765,22.4,0.20742470725342627
3167,2968,-10218,4,7,11,36.36,-0.014627272727272727,21.545454545454547,0.2102587265332996
3189,9507,22493,10,7,17,58.82,0.021805882352941175,17.823529411764707,0.18403739130823005
3209,1746,-1346,7,6,13,53.85,-0.0035153846153846164,15.615384615384615,0.24799121689424247
3229,3195,-6405,8,18,26,30.77,-0.01711923076923077,14.923076923076923,0.2586654827967331
3231,3964,2386,9,11,20,45.0,0.006885,15.7,0.2304209656083124
3257,4121,-19321,4,9,13,30.77,-0.033538461538461545,18.307692307692307,0.24510575431783926
3266,1001,-4751,3,5,8,37.5,-0.0198375,16.125,0.16129641454889282
3296,2966,-10566,8,13,21,38.1,-0.01880952380952381,18.857142857142858,0.27605527061991647
3305,4196,13554,9,7,16,56.25,0.0264,22.375,0.24762232293879988
3308,974,-10864,2,10,12,16.67,-0.05061666666666665,12.083333333333334,0.21404468112798947
3311,5402,-19552,5,10,15,33.33,-0.015619999999999998,16.133333333333333,0.2571598808659156
3312,1103,1087,5,9,14,35.71,0.007985714285714285,19.857142857142858,0.27363160591662405
3321,530,-3380,2,5,7,28.57,-0.03605714285714286,19.428571428571427,0.35334924814826063
3338,4537,-8487,7,9,16,43.75,0.0031062499999999988,17.375,0.2548868700882777
3346,3280,-15430,4,7,11,36.36,-0.03289090909090909,15.0,0.3044951536704097
3356,8431,-5981,7,10,17,41.18,0.0019352941176470576,19.058823529411764,0.25487948854087533
3376,8115,-101915,3,10,13,23.08,-0.06063076923076923,15.846153846153847,0.2501770979524562
3380,1743,257,6,7,13,46.15,0.020946153846153844,18.23076923076923,0.2554328715855126
3383,1489,-13069,2,11,13,15.38,-0.06892307692307692,11.538461538461538,0.2751485898091542
3406,27285,405115,12,6,18,66.67,0.0782777777777778,22.944444444444443,0.32946352630916775
3413,7050,-16550,2,4,6,33.33,-0.00995,24.333333333333332,0.2826414467752147
3416,2494,-8194,1,5,6,16.67,-0.01915,14.333333333333334,0.19612964852411005
3419,1985,-6335,7,11,18,38.89,-0.013444444444444446,12.833333333333334,0.27693561302098296
3432,706,-1306,1,6,7,14.29,-0.013085714285714284,11.285714285714286,0.2062241185198996
3437,1951,-20751,4,9,13,30.77,-0.04823846153846153,16.846153846153847,0.3329992839995594
3443,11740,31060,7,5,12,58.33,0.016708333333333332,17.416666666666668,0.38023480199207477
3450,9347,-23197,9,11,20,45.0,-0.011625,9.95,0.21490442900827103
3454,6843,-32893,5,11,16,31.25,-0.03623124999999999,11.6875,0.18221212991151206
3481,1292,2068,5,7,12,41.67,0.019433333333333334,16.333333333333332,0.18472954653591522
3494,2479,-17399,9,14,23,39.13,-0.026047826086956525,21.26086956521739,0.292151856378004
3501,2257,543,5,4,9,55.56,-0.0007444444444444427,21.333333333333332,0.29276948965864386
3504,10951,-22501,13,14,27,48.15,0.006188888888888888,18.185185185185187,0.2838416225386403
3515,6386,-68486,3,9,12,25.0,-0.03829166666666666,18.666666666666668,0.30717879833321854
3518,5847,-37597,8,17,25,32.0,-0.023312,17.16,0.27684784165900317
3528,165,-1165,0,1,1,0.0,-0.04,14.0,0.09238378174590678
3530,796,-4206,2,5,7,28.57,-0.014457142857142854,8.571428571428571,0.44839994489552326
3532,8131,15269,6,10,16,37.5,0.009843749999999998,14.0625,0.22544430661781187
3533,16994,81556,4,11,15,26.67,0.0008600000000000002,18.2,0.2791188749898423
3535,2485,-12995,8,14,22,36.36,-0.008022727272727272,16.727272727272727,0.25400412556686836
3536,371,-3771,1,4,5,20.0,-0.04426,12.2,0.3172380944749663
3543,1304,-414,3,3,6,50.0,0.08268333333333334,17.666666666666668,0.19763523767155533
3545,5030,420,11,11,22,50.0,-0.0010863636363636338,20.681818181818183,0.2877764235377823
3550,1086,674,6,6,12,50.0,0.010900000000000002,17.5,0.2513588273520438
3557,894,-17184,4,6,10,40.0,-0.04144,16.4,0.3191442804547839
3563,5494,1006,4,1,5,80.0,0.04056,27.8,0.20630737103382155
3576,2473,-1343,9,13,22,40.91,0.007086363636363633,20.818181818181817,0.26036962383461454
3583,5234,1766,7,7,14,50.0,0.004592857142857143,16.857142857142858,0.19126704514821347
3588,4375,1925,4,6,10,40.0,-0.009240000000000002,17.2,0.21351380218725816
3591,1715,-8475,7,6,13,53.85,0.02671538461538462,22.615384615384617,0.27682629082801874
3593,2017,1233,8,10,18,44.44,0.02769444444444445,18.61111111111111,0.23951174702107808
3596,4483,33267,6,7,13,46.15,0.057315384615384615,20.76923076923077,0.2114122720993571
3605,4450,-16200,5,13,18,27.78,0.002161111111111114,15.833333333333334,0.20713447508945612
3607,3171,-9771,4,11,15,26.67,-0.024273333333333334,13.2,0.20608571032849854
3617,2955,5945,4,3,7,57.14,0.010399999999999998,25.0,0.14278461304820464
3622,1963,-16253,3,9,12,25.0,-0.027291666666666662,22.666666666666668,0.2667951784177085
3645,2733,-8383,5,8,13,38.46,-0.02193846153846154,18.615384615384617,0.2854559790256417
3653,10047,43553,3,8,11,27.27,0.0017727272727272743,18.09090909090909,0.22464479365801876
3661,12696,39554,1,4,5,20.0,0.06561999999999998,20.6,0.4750781096207943
3665,10773,1727,4,7,11,36.36,-0.008354545454545455,19.454545454545453,0.2159661113129718
3669,2291,-1441,7,5,12,58.33,0.03497499999999999,25.583333333333332,0.2106019002340386
3673,20327,-102377,7,12,19,36.84,-0.013915789473684211,12.210526315789474,0.20353072978941747
3679,4512,-3212,4,7,11,36.36,-0.0036909090909090906,20.272727272727273,0.15870759398933154
3682,918,-258,5,8,13,38.46,0.005030769230769232,21.923076923076923,0.1975433916012284
3686,2757,-30187,6,17,23,26.09,-0.027152173913043476,17.434782608695652,0.2810154099500595
3694,1516,8134,7,6,13,53.85,0.030261538461538465,24.153846153846153,0.24495543107354212
3701,103,-583,0,2,2,0.0,-0.07555,14.5,0.4925733383801473
3702,2560,-5410,6,7,13,46.15,0.0026538461538461533,17.384615384615383,0.217157713634178
3703,874,5386,7,3,10,70.0,0.04578,27.2,0.17320776872371538
3704,1384,-11184,2,11,13,15.38,-0.04376153846153847,16.076923076923077,0.1656069147417512
3705,879,1671,2,1,3,66.67,0.010933333333333331,34.0,0.16120012137424675
3706,1122,3728,5,2,7,71.43,0.020785714285714286,20.428571428571427,0.21890170379711973
3708,3026,-3226,3,3,6,50.0,-0.005816666666666665,21.166666666666668,0.17133875591936254
3711,1796,2204,1,3,4,25.0,-0.008,10.25,0.19347978191584075
3712,879,22421,3,2,5,60.0,0.31244,21.4,0.2646448544155354
3714,1265,-13465,1,2,3,33.33,-0.058133333333333335,6.333333333333333,0.15349023035222623
4104,1336,2964,1,3,4,25.0,0.00935,18.75,0.26252295253346347
4106,3361,-18861,7,12,19,36.84,-0.03168421052631578,13.947368421052632,0.1952951356591096
4108,2446,2504,5,11,16,31.25,0.008787500000000004,18.3125,0.18456313168315874
4119,5930,6070,9,8,17,52.94,0.005852941176470587,15.470588235294118,0.21079574625554864
4133,5137,-42437,5,11,16,31.25,-0.03744375,11.875,0.18584182342721767
4137,12760,-56760,3,8,11,27.27,-0.019890909090909088,15.545454545454545,0.2099932854743625
4142,2710,-10160,3,10,13,23.08,-0.00866923076923077,17.692307692307693,0.1631265444977542
4155,3317,3073,7,8,15,46.67,0.01845333333333333,18.8,0.171099116899252
4164,2477,10323,5,2,7,71.43,0.04208571428571429,33.857142857142854,0.2442641182464767
4190,7633,-20733,6,8,14,42.86,-0.01300714285714286,16.214285714285715,0.2091459030587704
4306,1528,2752,9,7,16,56.25,0.00876875,14.75,0.17564233968177703
4414,375,-1415,1,5,6,16.67,0.02126666666666667,19.0,0.29545410383481213
4426,4912,7358,8,10,18,44.44,-0.020316666666666667,16.88888888888889,0.17657943073834337
4438,3395,-10395,1,3,4,25.0,-0.012700000000000003,15.0,0.1421471750187972
4439,3275,-7275,1,3,4,25.0,0.0004750000000000032,20.75,0.18596192162311875
4526,2960,7790,9,6,15,60.0,0.011213333333333332,26.8,0.14617716182717425
4532,1473,-3793,5,8,13,38.46,0.00600769230769231,21.46153846153846,0.2449390032148659
4536,4263,-12363,1,5,6,16.67,-0.013866666666666668,15.5,0.10838058083156284
4540,1144,1436,3,2,5,60.0,0.00676,13.6,0.17821845508450007
4545,521,-221,2,1,3,66.67,0.0038666666666666663,6.0,0.14001327996033383
4551,4588,17112,4,2,6,66.67,0.02353333333333334,22.666666666666668,0.14263200962879996
4552,3245,-4245,4,4,8,50.0,-0.0038375000000000015,24.875,0.16498908192041892
4555,731,-6931,0,2,2,0.0,-0.05455,5.0,0.17510012043834433
4557,402,-802,0,1,1,0.0,-0.0116,9.0,0.12111773839795625
4560,0,0,0,0,0,0.0,,,
4562,505,-6005,1,3,4,25.0,-0.056575,32.0,0.2877726789642611
4564,1429,-8479,2,4,6,33.33,-0.031433333333333334,15.0,0.20599897791747848
4566,216,884,1,0,1,100.0,0.0245,16.0,0.0871749424674495
4571,3247,-33247,0,6,6,0.0,-0.050300000000000004,6.666666666666667,0.1810029177840955
4572,1984,-16284,1,2,3,33.33,-0.027900000000000005,10.333333333333334,0.11981550553602942
4576,3193,-4893,2,3,5,40.0,-0.006939999999999999,23.4,0.19381135981269865
4581,208,-2208,0,1,1,0.0,-0.0597,2.0,0.08733167955459309
4720,1010,-660,5,6,11,45.45,-0.0013363636363636381,23.545454545454547,0.21074435027615532
4722,1784,12566,8,5,13,61.54,0.04986923076923078,19.923076923076923,0.13601649624574236
4737,6593,-32693,6,10,16,37.5,-0.026225,24.375,0.21006500389743343
4739,6126,65724,10,6,16,62.5,0.06163125,18.1875,0.3107379227641153
4746,4829,-25979,3,10,13,23.08,-0.027207692307692304,17.153846153846153,0.16854824532570145
4755,0,0,0,0,0,0.0,,,
4763,4398,8402,3,3,6,50.0,0.0045166666666666645,12.333333333333334,0.27849654439809546
4764,379,621,1,0,1,100.0,0.0097,12.0,0.162642519817634
4766,875,5125,1,0,1,100.0,0.0353,24.0,0.17665415519830918
4807,1320,-11750,1,3,4,25.0,-0.0415,13.5,0.22204336699020455
4904,650,1450,3,1,4,75.0,0.01245,14.5,0.1395473283366125
4906,5929,36721,17,6,23,73.91,0.0449913043478261,22.391304347826086,0.2576779734513851
4912,8651,4749,8,7,15,53.33,0.010726666666666669,18.933333333333334,0.27362489458698724
4915,3349,901,7,6,13,53.85,0.016976923076923077,15.307692307692308,0.1693398158814014
4916,1512,-1862,4,5,9,44.44,0.003677777777777779,17.555555555555557,0.2803430717764376
4919,3096,2104,7,4,11,63.64,-0.005845454545454546,21.727272727272727,0.21400747804772483
4927,2270,1130,3,4,7,42.86,0.006242857142857143,21.714285714285715,0.18665261615944467
4930,855,-755,3,3,6,50.0,-0.009933333333333329,22.0,0.2633873600677415
4934,808,3382,4,5,9,44.44,0.05663333333333333,30.666666666666668,0.36860424707379225
4935,3073,-1773,4,5,9,44.44,-0.008555555555555556,12.444444444444445,0.18771792765287906
4938,2483,-23283,0,7,7,0.0,-0.047099999999999996,12.142857142857142,0.1829150809177925
4942,3080,-2530,5,9,14,35.71,-0.0021928571428571435,19.214285714285715,0.12765911475982686
4943,5654,-54504,1,8,9,11.11,-0.07283333333333333,10.222222222222221,0.3737180047056478
4952,1345,6005,5,2,7,71.43,0.029971428571428572,24.0,0.18167827029236797
4956,1953,1247,8,9,17,47.06,0.008523529411764704,21.0,0.30680463357847565
4958,8138,-32938,6,10,16,37.5,-0.012450000000000003,12.9375,0.1954790898193821
4960,1705,2595,9,7,16,56.25,0.0227,25.125,0.21037030257486455
4961,4302,78678,3,4,7,42.86,0.3828285714285714,23.571428571428573,0.21981428815123122
4967,0,0,0,0,0,0.0,,,
4968,4255,-14255,3,2,5,60.0,0.02924,17.0,0.33586854189073134
4976,3358,24342,9,8,17,52.94,0.03523529411764706,22.176470588235293,0.33989545633692514
4977,3680,-6080,2,6,8,25.0,-0.010575000000000001,18.75,0.26745205234409186
4989,0,0,0,0,0,0.0,,,
4994,8335,-45135,5,9,14,35.71,-0.03274285714285714,13.785714285714286,0.21682693050650473
4999,1401,3499,4,1,5,80.0,0.01792,19.4,0.2858445015396927
5007,754,-804,3,3,6,50.0,0.0019499999999999997,17.0,0.1670691691456301
5203,7948,-38648,3,9,12,25.0,-0.01816666666666666,16.75,0.2793642498874542
5215,974,1276,1,4,5,20.0,0.011659999999999998,30.4,0.23927137571515106
5225,691,2609,2,2,4,50.0,0.0216,11.5,0.22907985144544896
5234,1121,-8271,1,4,5,20.0,-0.041580000000000006,17.6,0.17915402117624843
5243,2128,72,4,5,9,44.44,0.0015666666666666637,20.333333333333332,0.29138171023497583
5258,833,-2333,2,4,6,33.33,-0.02036666666666667,8.666666666666666,0.2551893432988734
5269,22708,-22208,4,6,10,40.0,-0.0011099999999999999,11.5,0.276210840657576
5283,0,0,0,0,0,0.0,,,
5284,1386,-86,2,2,4,50.0,-0.0021999999999999997,23.75,0.16242901766864226
5285,3757,50343,6,4,10,60.0,0.0654,21.3,0.1900845112491015
5288,4049,451,2,4,6,33.33,0.003500000000000002,21.5,0.1544020756194173
5388,1735,-12285,4,7,11,36.36,-0.02921818181818182,17.545454545454547,0.1955683380273855
5434,7483,-8433,8,12,20,40.0,-0.007210000000000003,16.5,0.186519809553848
5469,1093,-6143,2,10,12,16.67,-0.031716666666666664,9.416666666666666,0.18032118685563367
5471,5699,2101,8,12,20,40.0,-0.00529,17.55,0.27083598874359877
5484,3450,-4800,11,12,23,47.83,-0.0007130434782608695,20.47826086956522,0.23969856149594826
5515,1327,-5977,5,10,15,33.33,-0.014086666666666666,17.866666666666667,0.18701122900709458
5519,62,-312,0,1,1,0.0,-0.0411,48.0,0.10600654512418828
5521,1555,-3645,7,15,22,31.82,-0.017395454545454547,16.40909090909091,0.18899007675213186
5522,4044,1456,7,8,15,46.67,-0.009340000000000003,22.6,0.1892427010825921
5525,480,3970,3,3,6,50.0,0.08083333333333334,18.5,0.2249470863557738
5531,2918,-3168,7,9,16,43.75,0.0077499999999999965,15.1875,0.2293728715187373
5533,1051,-7271,2,8,10,20.0,-0.02945000000000001,22.0,0.3112469050115034
5534,7040,15860,6,13,19,31.58,0.03797894736842105,18.157894736842106,0.20125715449590798
5538,667,-6067,0,4,4,0.0,-0.051050000000000005,15.25,0.1841266154081938
5546,1524,-3624,2,2,4,50.0,-0.013425000000000001,17.5,0.09251968740600347
5607,1361,4889,5,6,11,45.45,0.02554545454545455,15.090909090909092,0.2460183242456454
5608,2126,-5116,5,5,10,50.0,0.01501,17.0,0.18988671776793778
5706,399,1951,3,1,4,75.0,0.0566,22.0,0.2506374358748284
5871,5772,30928,6,1,7,85.71,0.040600000000000004,22.0,0.27481240981391036
5876,0,0,0,0,0,0.0,,,
5880,232,318,1,1,2,50.0,0.010750000000000001,20.0,0.24206371345485667
5906,304,-1394,1,3,4,25.0,-0.020225,8.0,0.4315512772138898
5907,3278,-8678,5,9,14,35.71,-0.005478571428571428,19.214285714285715,0.1651264170966054
6005,893,647,7,5,12,58.33,0.012499999999999999,19.666666666666668,0.1820166909131308
6024,1426,-5876,2,5,7,28.57,-0.02125714285714286,17.0,0.1912996264190007
6108,3037,-13887,6,16,22,27.27,-0.021177272727272725,16.227272727272727,0.21297572622925703
6112,297,2483,3,1,4,75.0,0.060525,29.25,0.11630243814313618
6115,3025,-20875,3,10,13,23.08,-0.04063076923076922,21.307692307692307,0.20098034313835633
6116,145,305,2,0,2,100.0,0.0143,11.0,0.16353086274883233
6117,1981,4319,11,7,18,61.11,0.0299,17.72222222222222,0.25724421213482423
6120,3802,-15532,11,17,28,39.29,-0.019799999999999995,16.285714285714285,0.2697243055734707
6128,1565,-3915,3,8,11,27.27,-0.02175454545454545,24.09090909090909,0.26080285449840374
6133,1381,-6711,5,11,16,31.25,-0.0235625,14.75,0.1955352848611576
6136,1638,-7188,3,4,7,42.86,-0.020042857142857147,19.142857142857142,0.18878860590657795
6139,3201,-16001,6,10,16,37.5,-0.01101875,19.9375,0.24378542870533765
6141,3345,-8945,9,15,24,37.5,-0.008287500000000003,20.416666666666668,0.19177336903790002
6142,2205,13765,10,11,21,47.62,0.054766666666666665,20.0,0.28186054062791016
6152,2735,-25425,3,19,22,13.64,-0.04109545454545455,18.181818181818183,0.23607031581252186
6153,3949,9131,12,11,23,52.17,0.023599999999999993,21.26086956521739,0.21689742504027007
6155,3068,-16368,8,13,21,38.1,-0.02595238095238095,13.904761904761905,0.2710442684334321
6164,1956,-6,10,11,21,47.62,0.006647619047619048,15.666666666666666,0.22036344316793882
6165,1169,2471,3,11,14,21.43,-0.024492857142857143,21.571428571428573,0.2191986966137883
6166,1987,-4987,2,7,9,22.22,-0.018555555555555558,23.11111111111111,0.21640117737663686
6168,2715,-10115,7,12,19,36.84,-0.014515789473684216,16.94736842105263,0.23322615253332576
6176,6209,-25609,7,8,15,46.67,-0.029499999999999995,18.0,0.2186841533299058
6177,1749,-12249,3,9,12,25.0,-0.04344166666666666,17.083333333333332,0.1670449751394103
6183,541,5239,4,3,7,57.14,0.06571428571428571,24.285714285714285,0.2411509851614678
6184,397,-3997,0,2,2,0.0,-0.05325,12.0,0.301627981007648
6189,1905,-3705,5,6,11,45.45,-0.010327272727272728,25.0,0.20013557974777238
6191,3716,16124,9,15,24,37.5,0.013670833333333332,18.708333333333332,0.22453727297971157
6192,3920,-6820,6,7,13,46.15,-0.011407692307692306,18.153846153846153,0.2015840886619733
6196,8306,-19356,13,18,31,41.94,-0.009135483870967742,16.0,0.18951472203826938
6197,7126,-33176,10,13,23,43.48,-0.004617391304347827,18.652173913043477,0.34488490908799535
6201,2009,-14659,1,11,12,8.33,-0.04034166666666667,15.5,0.17389073784538236
6202,451,-4501,0,3,3,0.0,-0.0554,8.333333333333334,0.32881601576770897
6205,3800,-7400,10,10,20,50.0,0.00452,21.2,0.20789959183498602
6206,5374,-16474,6,6,12,50.0,-0.020266666666666672,19.0,0.2408909583839924
6209,5917,3973,9,17,26,34.62,-0.006976923076923075,15.807692307692308,0.2328029864412626
6213,4736,6214,8,11,19,42.11,0.015068421052631578,18.42105263157895,0.19906573575258676
6214,1280,5070,2,4,6,33.33,0.0030000000000000027,23.833333333333332,0.21064017245577815
6215,1361,-9661,4,9,13,30.77,-0.015923076923076925,20.692307692307693,0.2564997154564971
6216,2986,-11936,6,5,11,54.55,0.0026727272727272715,19.363636363636363,0.2702251315786573
6224,5973,-33173,5,11,16,31.25,-0.0203,12.3125,0.18886075915683692
6225,1244,-2144,4,3,7,57.14,-0.0058571428571428585,16.285714285714285,0.2560538508068459
6226,2198,-8128,8,23,31,25.81,-0.014845161290322581,14.193548387096774,0.2294944014373798
6230,14007,-31857,7,19,26,26.92,-0.006365384615384608,18.153846153846153,0.25482749066004495
6235,1129,-1809,4,6,10,40.0,0.010290000000000007,21.8,0.3890466641134886
6239,3927,-9877,4,4,8,50.0,-0.0046625,17.875,0.19584385549449235
6243,2382,-18082,4,9,13,30.77,-0.037099999999999994,16.846153846153847,0.25594622313198667
6251,1604,766,7,9,16,43.75,0.008212500000000001,17.4375,0.21377649827555906
6257,1918,-318,10,5,15,66.67,0.0035666666666666694,25.2,0.23983389955278642
6269,11686,-40736,10,15,25,40.0,-0.026356,15.24,0.21368742749830422
6271,12211,4389,5,13,18,27.78,-0.01396666666666667,18.0,0.2073472109041879
6277,3735,-52235,0,6,6,0.0,-0.07665,19.166666666666668,0.2210315143556221
6278,0,0,0,0,0,0.0,,,
6281,560,-4810,0,3,3,0.0,-0.05343333333333333,13.0,0.37026950786888185
6282,3471,1479,14,11,25,56.0,0.0011640000000000025,17.2,0.21296884962870805
6283,1829,-10409,3,14,17,17.65,-0.034600000000000006,19.176470588235293,0.24533756819245348
6285,6396,-2896,5,11,16,31.25,-0.0006062500000000009,19.3125,0.22678791240062507
6288,0,0,0,0,0,0.0,,,
6289,1831,-561,7,17,24,29.17,-0.04065833333333333,15.708333333333334,0.3058605377058844
6405,2595,-6395,5,8,13,38.46,-0.013223076923076922,14.23076923076923,0.23982183452027217
6409,31527,503473,4,3,7,57.14,0.08997142857142858,20.142857142857142,0.144281626153758
6412,1279,-6929,1,4,5,20.0,-0.02862,30.0,0.09309409101287405
6414,15022,81478,5,3,8,62.5,0.022412500000000002,19.125,0.2064282842596538
6415,30633,-480133,1,5,6,16.67,-0.052583333333333336,17.833333333333332,0.22561835949621442
6416,4301,7969,4,4,8,50.0,0.006575,14.875,0.30486978030316814
6431,828,-6178,3,4,7,42.86,-0.014828571428571429,13.857142857142858,0.1993758990628825
6438,1568,-11168,2,2,4,50.0,-0.039825,14.0,0.18360150951635362
6442,1437,20963,3,2,5,60.0,0.09809999999999999,23.2,0.3393534667185324
6443,1010,6510,4,3,7,57.14,0.017842857142857143,14.857142857142858,0.33431627536369807
6449,2038,762,5,4,9,55.56,-0.00011111111111111121,13.555555555555555,0.2084803173160891
6451,4337,36563,3,4,7,42.86,0.05721428571428571,13.714285714285714,0.17330692379693094
6456,5579,65521,5,3,8,62.5,0.0621875,18.625,0.35474654008348583
6464,2108,2392,2,1,3,66.67,0.0069,31.333333333333332,0.10754824921285351
6477,1216,-26766,1,5,6,16.67,-0.08805,14.833333333333334,0.4305509538658377
6491,3427,-12787,1,4,5,20.0,-0.02477999999999999,20.6,0.25506730108012465
6504,12763,-13763,4,8,12,33.33,-0.006124999999999999,13.833333333333334,0.19339309745190655
6505,4784,-11384,4,6,10,40.0,-0.010170000000000002,12.7,0.14631630588090752
6515,0,0,0,0,0,0.0,,,
6525,4528,-2628,5,7,12,41.67,-0.002333333333333331,15.666666666666666,0.20250982201187032
6531,20728,207572,5,9,14,35.71,0.03479285714285713,17.0,0.3106063056295421
6533,10166,-100466,2,7,9,22.22,-0.027500000000000004,10.88888888888889,0.2840119781772341
6541,4944,24386,5,5,10,50.0,0.07265,28.3,0.20254225426895953
6552,0,0,0,0,0,0.0,,,
6558,2000,1250,3,5,8,37.5,0.013700000000000004,14.375,0.25029916848431216
6573,1180,770,3,3,6,50.0,0.020200000000000003,18.833333333333332,0.3213762196263403
6579,1014,-5594,0,2,2,0.0,-0.03705,30.0,0.1726450629693559
6581,1570,-1370,2,1,3,66.67,-0.011933333333333332,21.666666666666668,0.12023318142068236
6582,4109,-26209,1,3,4,25.0,-0.053125000000000006,18.75,0.26748259540419267
6591,3309,1441,4,4,8,50.0,0.0282875,21.0,0.3825087242353178
6592,479,1121,1,0,1,100.0,0.0139,18.0,0.1477942872286644
6598,584,-7934,0,2,2,0.0,-0.07645,7.0,0.15428797191900578
6605,9072,9378,9,8,17,52.94,0.008988235294117646,17.764705882352942,0.19060840794021128
6625,1136,3014,2,2,4,50.0,0.032725000000000004,11.0,0.3599150264173383
6641,734,166,1,1,2,50.0,0.0027,26.5,0.10740303713626964
6655,193,-1743,0,1,1,0.0,-0.051,4.0,0.26725071785761
6666,3965,-2965,1,3,4,25.0,-0.0070500000000000024,19.5,0.14276431434926629
6668,1262,1238,2,2,4,50.0,0.008550000000000002,20.0,0.1912451687438408
6669,15709,-86709,2,1,3,66.67,-0.03216666666666666,26.666666666666668,0.22884022251558767
6670,1047,-1047,0,1,1,0.0,-0.0058,29.0,0.09117026850258014
6671,495,-2545,0,2,2,0.0,-0.0294,9.0,0.13253243509874668
6672,990,3110,1,1,2,50.0,0.024,17.0,0.27691608585175875
6674,728,2472,3,1,4,75.0,0.035199999999999995,19.75,0.38301767451519
6698,1120,-1120,1,3,4,25.0,0.007324999999999998,8.5,0.2758672833903119
6706,2650,21950,2,1,3,66.67,0.01796666666666666,18.333333333333332,0.26760927999444023
6715,3533,-8533,2,3,5,40.0,-0.01336,10.4,0.11478545449151448
6743,718,-12218,0,1,1,0.0,-0.0929,7.0,0.21230999283284113
6754,0,0,0,0,0,0.0,,,
6756,3285,-34285,0,2,2,0.0,-0.054400000000000004,2.5,0.45525366193693806
8011,2384,4816,11,7,18,61.11,0.014066666666666668,19.77777777777778,0.20837923691949278
8016,11366,-52166,9,8,17,52.94,-0.0010235294117647033,14.294117647058824,0.21212817149516164
8021,3941,-21841,10,11,21,47.62,-0.012961904761904761,17.0,0.24919385468936428
8028,0,0,0,0,0,0.0,,,
8033,1526,3254,8,7,15,53.33,0.01484,17.066666666666666,0.20704879983517863
8039,5904,-13904,7,15,22,31.82,-0.01132272727272727,15.636363636363637,0.1999031256454092
8046,11201,-75001,3,12,15,20.0,-0.02558000000000001,13.666666666666666,0.19752165321823706
8070,3520,-11420,3,3,6,50.0,-0.008266666666666665,19.5,0.1291079740532141
8072,5322,-31772,4,7,11,36.36,-0.003427272727272723,15.454545454545455,0.16479552311671297
8081,11688,-96488,5,11,16,31.25,-0.034612500000000004,14.0,0.24044752795133434
8101,1328,-16998,4,11,15,26.67,-0.05720666666666667,16.733333333333334,0.2344216540369238
8103,3379,15571,9,8,17,52.94,0.03701764705882353,19.41176470588235,0.23056145832990327
8104,3373,116567,5,8,13,38.46,3.000592307692308,283.0769230769231,0.349758336186846
8105,2701,-13081,13,16,29,44.83,-0.006272413793103447,19.96551724137931,0.2565124115863925
8110,1560,-5750,5,16,21,23.81,-0.026533333333333336,15.428571428571429,0.261991588611604
8112,1889,1781,8,10,18,44.44,0.0077944444444444415,18.11111111111111,0.24667102735145927
8114,7135,-2435,3,7,10,30.0,-0.0037299999999999994,24.6,0.15981024951782702
8131,1890,-16640,3,9,12,25.0,-0.035016666666666675,12.666666666666666,0.29018894551561464
8150,2055,-3805,6,5,11,54.55,-0.009827272727272728,18.0,0.19986755230857042
8163,1624,-20074,3,7,10,30.0,-0.05215000000000001,11.2,0.22948253702989177
8201,1409,1551,7,5,12,58.33,0.02266666666666667,14.25,0.23754852840142696
8210,3288,-1038,9,8,17,52.94,-0.004970588235294117,22.41176470588235,0.20383922790820314
8213,3714,-18164,7,8,15,46.67,-0.02787333333333333,23.2,0.18171518750005455
8215,2214,-6714,6,11,17,35.29,-0.011476470588235291,16.352941176470587,0.2446537137287809
8222,525,8875,2,2,4,50.0,0.08324999999999999,33.5,0.18134737356518915
8249,2048,-6548,3,8,11,27.27,-0.020136363636363633,14.272727272727273,0.2357679966347708
8261,1740,-12430,5,9,14,35.71,-0.02696428571428572,18.571428571428573,0.2616224851711664
8271,2109,-7559,4,8,12,33.33,-0.024041666666666666,13.666666666666666,0.19979299888854155
8341,11174,-25674,4,6,10,40.0,-0.00869,19.7,0.1711682063791456
8367,362,-6662,0,1,1,0.0,-0.0999,6.0,0.21092375314057987
8374,2721,12629,9,9,18,50.0,0.030288888888888896,18.22222222222222,0.2599832912885334
8404,0,0,0,0,0,0.0,,,
8411,725,-825,2,3,5,40.0,0.009479999999999999,24.8,0.12309666240917663
8422,9652,1348,5,4,9,55.56,0.0048333333333333344,20.11111111111111,0.16005880265186986
8429,3940,-7190,4,9,13,30.77,-0.015361538461538463,12.384615384615385,0.17992957358821984
8442,237,-487,0,1,1,0.0,-0.012,6.0,0.1109026364657304
8443,147,443,2,0,2,100.0,0.01935,37.5,0.3410902336129842
8454,13356,-51356,3,5,8,37.5,-0.008275000000000005,24.5,0.1562621150209311
8462,0,0,0,0,0,0.0,,,
8463,260,-560,1,1,2,50.0,-0.01435,6.0,0.1802248394312862
8464,23193,66807,8,5,13,61.54,0.02354615384615384,17.153846153846153,0.1423142910764417
8466,1089,2911,3,0,3,100.0,0.016766666666666666,32.666666666666664,0.27217254169457566
8467,727,-4477,1,3,4,25.0,-0.035625,20.25,0.11732176922037652
8473,937,-1937,1,2,3,33.33,-0.0070999999999999995,30.333333333333332,0.11501573462396457
8478,0,0,0,0,0,0.0,,,
8480,1487,-5487,0,2,2,0.0,-0.021449999999999997,5.5,0.11259150336075519
8481,763,6487,2,0,2,100.0,0.06325,29.0,0.1580275680708476
8482,1338,-14338,0,2,2,0.0,-0.0588,45.5,0.13497796709903787
8488,83,2517,1,0,1,100.0,0.2142,21.0,0.5164832553423797
8499,3987,-1887,3,3,6,50.0,-0.006783333333333333,20.333333333333332,0.20772846978971352
8926,461,1989,3,3,6,50.0,0.03278333333333333,32.0,0.16484766922075333
8940,1098,-6348,2,7,9,22.22,-0.031477777777777785,18.444444444444443,0.23845659498640742
8996,4684,-6234,6,13,19,31.58,-0.0029526315789473734,19.736842105263158,0.23250066136870312
9802,4292,-11342,5,4,9,55.56,0.0005222222222222233,19.0,0.1309152228094886
9902,0,0,0,0,0,0.0,,,
9904,2080,5920,6,6,12,50.0,0.014225,19.916666666666668,0.19799951336197355
9905,1142,-542,5,4,9,55.56,-0.005677777777777778,20.88888888888889,0.21847467958093883
9906,44,176,1,0,1,100.0,0.1833,20.0,0.4591639544428969
9907,1852,3078,11,10,21,52.38,0.03421428571428572,16.333333333333332,0.21247826825133825
9908,150,800,1,1,2,50.0,0.02715,12.0,0.11800651555348074
9910,592,-42,2,2,4,50.0,-0.0020750000000000005,21.75,0.1364833749896059
9911,314,-634,2,3,5,40.0,-0.0247,16.2,0.28848266743108664
9912,107,-1147,0,2,2,0.0,-0.11255,8.5,0.431419017722775
9914,21284,69716,15,10,25,60.0,0.025636000000000006,19.6,0.21985069537520593
9917,1194,10706,3,1,4,75.0,0.056075,27.25,0.13952486818172266
9918,216,1034,2,0,2,100.0,0.0265,41.5,0.1367081043997962
9919,1246,-8796,1,10,11,9.09,-0.03748181818181818,16.818181818181817,0.1957171980124022
9921,1411,-8011,1,4,5,20.0,-0.027640000000000005,42.0,0.15234773786861594
9924,980,-1040,2,5,7,28.57,-0.011800000000000001,17.0,0.1743022866478813
9925,319,3431,1,1,2,50.0,0.05565,19.0,0.11761410731790489
9926,388,1212,1,2,3,33.33,0.0023999999999999994,26.0,0.16206746390145485
9927,2936,3964,5,8,13,38.46,0.0017384615384615429,20.076923076923077,0.21855540790719227
9928,203,657,2,1,3,66.67,0.02903333333333333,30.0,0.24805141847776513
9929,864,936,6,9,15,40.0,0.02507333333333333,26.666666666666668,0.286183762008939
9930,186,-1886,0,2,2,0.0,-0.0567,23.5,0.19256679518104503
9931,0,0,0,0,0,0.0,,,
9933,520,5580,3,1,4,75.0,0.07222499999999998,23.75,0.1994222849588031
9934,2545,11755,12,7,19,63.16,0.0370157894736842,22.473684210526315,0.21529222766289272
9935,1125,-7005,5,8,13,38.46,-0.03625384615384615,19.384615384615383,0.2618263989822061
9937,726,-1976,1,4,5,20.0,-0.01488,24.0,0.12093596475306848
9938,5359,-32839,3,15,18,16.67,-0.03167222222222222,13.055555555555555,0.16541913147624557
9939,3550,5050,6,6,12,50.0,0.002975000000000002,26.583333333333332,0.18808759421322443
9940,4662,-27612,4,10,14,28.57,-0.02486428571428571,19.571428571428573,0.13856213202397857
9941,1980,-6780,4,4,8,50.0,-0.0126,19.0,0.19057172625574142
9942,4499,-16849,2,9,11,18.18,-0.02365454545454546,18.272727272727273,0.17693749769886627
9943,548,-5348,0,5,5,0.0,-0.061119999999999994,13.6,0.17827524351886986
9944,2821,-10171,8,10,18,44.44,-0.015538888888888889,17.72222222222222,0.23311457544498188
9945,3507,2933,8,10,18,44.44,-0.00883888888888889,18.88888888888889,0.21517746890220046
9946,1373,-23,6,8,14,42.86,0.010535714285714287,19.142857142857142,0.2862803870141421
9955,2435,-11435,3,11,14,21.43,-0.019071428571428576,23.285714285714285,0.18870741398748367
9958,3865,-15675,4,12,16,25.0,0.0010312499999999992,17.0,0.16961616901286497
1312A,428,-978,2,4,6,33.33,-0.016583333333333335,11.0,0.22583065499796848
2002A,249,-2399,0,1,1,0.0,-0.0543,4.0,0.21501729475233078
2836A,0,0,0,0,0,0.0,,,
2838A,0,0,0,0,0,0.0,,,
2881A,374,2526,1,0,1,100.0,0.0409,49.0,0.11993815137307728
2881B,370,2730,1,0,1,100.0,0.0449,68.0,0.1320268464058416
2882A,0,0,0,0,0,0.0,,,
2882B,0,0,0,0,0,0.0,,,
2887E,0,0,0,0,0,0.0,,,
2887F,0,0,0,0,0,0.0,,,
2888A,0,0,0,0,0,0.0,,,
2888B,0,0,0,0,0,0.0,,,
2891B,0,0,0,0,0,0.0,,,
2891C,0,0,0,0,0,0.0,,,
2897A,70,340,1,0,1,100.0,0.0353,29.0,0.2503869203190683
3702A,277,1023,1,0,1,100.0,0.0221,29.0,0.2124370368350712
5871A,0,0,0,0,0,0.0,,,
9941A,0,0,0,0,0,0.0,,,
1240,0,0,0,0,0,0.0,,,
1258,533,557,2,3,5,40.0,0.05752,18.4,0.4073077163802991
1259,1400,-10900,0,2,2,0.0,-0.0381,11.5,0.2949629104984769
1264,2062,-6062,1,1,2,50.0,-0.016550000000000002,25.5,0.17380384394396875
1268,1673,-3173,1,1,2,50.0,-0.009749999999999998,34.0,0.18668311157356987
1336,604,-944,2,5,7,28.57,-0.017057142857142858,25.428571428571427,0.18869195045203682
1565,50491,213309,8,13,21,38.1,0.019319047619047618,18.476190476190474,0.1897521920173691
1569,2049,-17299,3,8,11,27.27,-0.03760909090909091,21.90909090909091,0.22643726754839388
1570,504,-1874,3,4,7,42.86,-0.026899999999999997,16.142857142857142,0.17231348735316437
1580,277,-2177,0,2,2,0.0,-0.04505,14.5,0.22779868437673922
1584,1303,-5723,3,10,13,23.08,-0.017053846153846156,16.615384615384617,0.17442845574847465
1586,1774,-4024,3,6,9,33.33,-0.016111111111111114,14.88888888888889,0.19489434070783387
1591,1683,-4483,2,7,9,22.22,-0.01857777777777778,19.11111111111111,0.21765092968157326
1593,148,952,1,0,1,100.0,0.0389,38.0,0.31008724553369627
1595,3641,6009,4,6,10,40.0,0.020040000000000002,15.0,0.1409560853224156
1599,2374,-13624,2,7,9,22.22,-0.034555555555555555,20.444444444444443,0.13837392665934192
1742,1726,3324,7,9,16,43.75,0.021425000000000003,16.75,0.23066344889434368
1752,2736,2514,6,7,13,46.15,0.0050538461538461536,25.46153846153846,0.18997249283048384
1777,597,3953,3,0,3,100.0,0.039766666666666665,25.0,0.2238416148680653
1781,4433,-49743,9,23,32,28.12,-0.019262500000000002,18.875,0.22792033190434563
1784,2630,-2680,6,6,12,50.0,0.004758333333333336,15.833333333333334,0.26788797033766015
1785,5921,31479,10,10,20,50.0,0.033394999999999994,21.2,0.31914609248004144
1788,1278,622,1,2,3,33.33,0.01433333333333333,27.666666666666668,0.19566581014166187
1796,702,-3052,0,3,3,0.0,-0.02413333333333333,17.0,0.15823523795945538
1799,2745,-4495,7,14,21,33.33,-0.005761904761904761,17.142857142857142,0.19261807088018285
1813,1159,-5159,2,4,6,33.33,-0.017933333333333332,18.166666666666668,0.1492711172426028
1815,1529,771,8,8,16,50.0,0.00406875,15.625,0.23077362880092153
2035,281,-4881,0,2,2,0.0,-0.08810000000000001,10.0,0.33918561809920833
2061,358,-2888,1,3,4,25.0,-0.032525,11.25,0.11939550917943598
2063,1788,-17588,0,6,6,0.0,-0.05993333333333334,10.833333333333334,0.16101410591240597
2064,80,-580,0,1,1,0.0,-0.0417,7.0,0.08175069920483358
2065,576,-226,1,2,3,33.33,-0.010133333333333336,10.333333333333334,0.17019550111469636
2066,2613,287,3,2,5,60.0,-0.00426,19.4,0.2347937288410226
2067,624,-2274,2,4,6,33.33,0.009283333333333338,10.0,0.13144849974360992
2070,173,-973,0,1,1,0.0,-0.0322,5.0,0.14653135466722245
2221,589,-3079,3,3,6,50.0,-0.03603333333333333,25.833333333333332,0.20275408819476656
2230,415,3535,3,1,4,75.0,0.056824999999999994,18.75,0.20460125249939576
2235,1858,-17358,1,2,3,33.33,-0.051333333333333335,18.666666666666668,0.2278946258093709
2596,79,-279,0,1,1,0.0,-0.0213,15.0,0.14286641923483612
2640,2909,-13709,2,3,5,40.0,-0.01082,17.8,0.1264323002063943
2641,790,-6040,3,5,8,37.5,-0.041225,18.0,0.2598992669202876
2643,2375,21625,4,3,7,57.14,0.05871428571428571,23.285714285714285,0.2169959803951856
2718,0,0,0,0,0,0.0,,,
2719,1049,-2359,3,6,9,33.33,-0.009533333333333335,15.88888888888889,0.23432670823773533
2724,319,1001,2,3,5,40.0,0.08747999999999999,22.0,0.3843280671187717
2726,3178,-6028,4,4,8,50.0,-0.01175,18.25,0.29202388780929633
2729,2647,48353,2,0,2,100.0,0.1207,32.5,0.36219721512307657
2732,4988,-41788,2,6,8,25.0,-0.038875,13.0,0.21136551322526131
2734,1377,-6627,3,7,10,30.0,-0.01633,17.8,0.2361720716957853
2736,584,-3084,0,5,5,0.0,-0.024880000000000003,15.0,0.10423820218984851
2740,701,-1051,2,3,5,40.0,-0.026059999999999993,20.6,0.25645993775165893
2743,241,-1321,1,1,2,50.0,-0.019200000000000002,17.5,0.14428680764394786
2745,952,-9292,1,6,7,14.29,-0.04835714285714286,9.571428571428571,0.2501192984613352
2752,0,0,0,0,0,0.0,,,
2754,810,7290,1,1,2,50.0,0.06864999999999999,26.5,0.15941120165814515
2755,0,0,0,0,0,0.0,,,
2916,425,625,2,2,4,50.0,0.01705,20.25,0.1251021735090142
2924,436,-3236,0,1,1,0.0,-0.0422,71.0,0.19522229174921302
2926,3814,-12814,1,4,5,20.0,-0.0242,9.8,0.14285326238039336
2937,104,-604,0,1,1,0.0,-0.033,12.0,0.1384412789536802
3064,3427,-5527,7,9,16,43.75,0.010724999999999998,14.125,0.3529051651258985
3066,1439,-22019,2,10,12,16.67,-0.06765833333333333,24.25,0.25368884876655123
3067,647,1353,2,2,4,50.0,0.011225,21.25,0.15779211044891933
3071,518,-5918,0,6,6,0.0,-0.06206666666666666,15.833333333333334,0.2026190155340701
3073,1355,-5555,3,6,9,33.33,-0.0357,18.88888888888889,0.24300735152703654
3078,2447,6053,6,11,17,35.29,0.0011470588235294107,24.58823529411765,0.31209150593837764
3081,10102,75898,4,2,6,66.67,0.05644999999999999,21.333333333333332,0.3034814702277942
3083,9415,9335,11,10,21,52.38,0.01390476190476191,15.238095238095237,0.2688295204484306
3085,3572,-592,9,16,25,36.0,0.0018880000000000008,11.24,0.2582422788362662
3086,1846,2124,7,13,20,35.0,0.019455000000000004,17.2,0.2606487612545799
3088,4444,-12444,7,8,15,46.67,-0.018566666666666672,15.866666666666667,0.201564153601587
3089,1813,-8033,9,12,21,42.86,-0.017904761904761906,14.238095238095237,0.36826102965100976
3092,2942,-622,6,13,19,31.58,-0.010221052631578952,14.736842105263158,0.23031614697108993
3093,2991,-7691,4,7,11,36.36,-0.008136363636363634,17.454545454545453,0.18001552413181063
3095,1959,-13429,4,8,12,33.33,-0.021550000000000003,17.75,0.29666071000840416
3105,1836,-15136,2,5,7,28.57,-0.028328571428571432,16.0,0.18729081399448425
3114,1885,-1185,8,9,17,47.06,0.00048235294117647174,16.941176470588236,0.1650859281883829
3115,928,-1348,4,7,11,36.36,-0.01895454545454545,14.727272727272727,0.24754921276811848
3118,1652,-12452,1,7,8,12.5,-0.040900000000000006,18.125,0.13902383361449958
3122,665,-8565,1,5,6,16.67,-0.06393333333333333,17.166666666666668,0.2327876570436835
3128,1451,-3951,6,7,13,46.15,-0.0016076923076923085,18.307692307692307,0.25602204728065464
3131,16518,21982,3,6,9,33.33,0.007322222222222226,21.555555555555557,0.21755510707305384
3141,217,-317,1,1,2,50.0,-0.0004000000000000045,14.0,0.44045934224808836
3147,0,0,0,0,0,0.0,,,
3152,3313,3487,2,3,5,40.0,0.021740000000000002,22.4,0.2464983524674246
3162,832,-4042,4,6,10,40.0,0.011169999999999994,18.5,0.1829977260310505
3163,4871,-8421,7,8,15,46.67,0.009040000000000003,18.133333333333333,0.3003644210425004
3169,2582,-18932,2,11,13,15.38,-0.038853846153846155,12.384615384615385,0.2309031785563817
3171,1381,-8191,4,11,15,26.67,-0.02738,17.6,0.18600501271140293
3176,6690,-58690,2,9,11,18.18,-0.03998181818181819,13.0,0.21985616241547878
3178,0,0,0,0,0,0.0,,,
3188,2650,1040,5,16,21,23.81,-0.036757142857142856,19.238095238095237,0.24789258878302467
3191,2271,-19021,5,13,18,27.78,-0.04703333333333334,13.666666666666666,0.27887643668473294
3202,2211,-11551,4,16,20,20.0,-0.032035,15.05,0.23719072977714578
3205,73,777,1,0,1,100.0,0.0773,24.0,0.3819781446842836
3206,653,1087,2,3,5,40.0,0.025839999999999995,16.4,0.24518325292139168
3207,1612,1508,9,11,20,45.0,0.019774999999999997,16.15,0.23466817317496078
3211,8280,-80180,3,13,16,18.75,-0.05358125,13.875,0.18517263368783707
3213,5798,30852,9,4,13,69.23,0.02802307692307693,18.53846153846154,0.25016122608206665
3217,2680,770,6,7,13,46.15,-0.0070076923076923085,22.153846153846153,0.26535652260750875
3218,8308,7542,7,14,21,33.33,-0.017599999999999998,20.857142857142858,0.21526077459678183
3219,997,-10697,2,7,9,22.22,-0.05901111111111111,12.444444444444445,0.3601612335903445
3221,2390,9930,7,8,15,46.67,0.033699999999999994,18.466666666666665,0.29113651821999603
3224,544,1026,3,3,6,50.0,0.01678333333333333,18.833333333333332,0.18359981452682603
3226,984,-2734,1,4,5,20.0,-0.027839999999999997,17.0,0.2206433761416839
3227,13907,47593,9,8,17,52.94,0.006952941176470589,17.294117647058822,0.3053226436393072
3228,4096,12604,8,8,16,50.0,0.019956250000000005,18.625,0.27798202363778124
3230,1985,-515,6,12,18,33.33,0.017383333333333324,26.055555555555557,0.2848718588000545
3232,2238,-17718,5,11,16,31.25,-0.015518749999999998,16.0625,0.29322496253758756
3234,129,-729,0,1,1,0.0,-0.0323,85.0,0.33834266192011375
3236,2382,11568,10,12,22,45.45,0.00712272727272727,18.681818181818183,0.26902545981668263
3252,552,-3752,2,4,6,33.33,-0.0263,10.5,0.3927531948231476
3259,2443,2907,4,12,16,25.0,0.005318749999999999,18.3125,0.2440976888384353
3260,6073,42977,9,9,18,50.0,0.02993333333333333,15.5,0.19617990876621041
3264,2818,-13818,6,11,17,35.29,-0.03084117647058824,22.235294117647058,0.23466173148313468
3265,410,-1220,1,3,4,25.0,-0.023175,12.5,0.3215268747361046
3268,3793,13767,7,12,19,36.84,-0.00034210526315789477,18.105263157894736,0.3157666975777792
3272,1472,-5322,3,2,5,60.0,-0.02198,14.2,0.3003663965218631
3276,396,-1426,2,3,5,40.0,0.006920000000000004,22.0,0.2852068644645278
3284,912,1498,5,5,10,50.0,-0.0038399999999999997,12.6,0.21923990556354203
3285,1095,4655,5,4,9,55.56,0.01968888888888889,29.444444444444443,0.2403028922875444
3287,1286,-9276,2,13,15,13.33,-0.04569999999999999,15.533333333333333,0.21187493537031354
3288,3401,3749,9,13,22,40.91,-0.01977272727272727,14.772727272727273,0.28098203655092757
3289,2341,-17391,2,7,9,22.22,-0.0463,20.444444444444443,0.28561206115964405
3290,1613,4077,11,7,18,61.11,0.013888888888888888,19.38888888888889,0.1911192038403763
3293,17652,-114552,4,12,16,25.0,-0.02586875,19.0,0.2782982475898614
3294,1312,-13662,3,6,9,33.33,-0.024066666666666667,17.77777777777778,0.39888945509923374
3297,1823,13227,8,5,13,61.54,0.03763846153846154,21.692307692307693,0.23150643877217902
3303,1208,-3558,2,7,9,22.22,-0.05027777777777778,13.222222222222221,0.285004777232178
3306,2523,-20823,2,7,9,22.22,-0.048222222222222215,10.555555555555555,0.17536333638248155
3310,682,-4602,2,6,8,25.0,-0.01285,11.0,0.33924022324410247
3313,2044,-9704,7,7,14,50.0,0.0018785714285714289,19.357142857142858,0.2923536457287334
3317,3091,-5941,7,11,18,38.89,-0.023088888888888895,17.333333333333332,0.2709488186113829
3322,663,-6923,2,7,9,22.22,-0.06257777777777779,16.88888888888889,0.2387923198194165
3323,540,-1540,2,2,4,50.0,0.017824999999999997,31.75,0.20388821742249064
3324,5330,29220,9,8,17,52.94,0.017882352941176467,16.0,0.2655145754476418
3325,2051,-3561,8,9,17,47.06,0.003676470588235294,18.470588235294116,0.24950502566484029
3332,593,-5343,1,2,3,33.33,-0.055333333333333325,26.0,0.3414669269052922
3339,2757,-1317,10,13,23,43.48,-0.004043478260869568,16.565217391304348,0.25837636477572956
3354,1657,-12277,2,10,12,16.67,-0.03491666666666666,16.75,0.24529405938181761
3360,1261,-4561,6,9,15,40.0,-0.01575333333333333,15.066666666666666,0.23957118956937998
3362,1434,-2224,5,6,11,45.45,0.006009090909090911,14.727272727272727,0.1863832897166745
3363,1587,-4737,5,4,9,55.56,-0.01367777777777778,15.0,0.29632950310818373
3372,1343,577,7,11,18,38.89,0.02,18.88888888888889,0.3112809238816221
3373,4121,12729,8,9,17,47.06,0.03544705882352941,21.352941176470587,0.2546415077202037
3374,3531,-8631,2,5,7,28.57,0.004885714285714291,15.428571428571429,0.27094549073447033
3379,775,7015,3,3,6,50.0,0.05135,18.333333333333332,0.19947066773087144
3388,3837,-13237,3,5,8,37.5,-0.024650000000000002,22.0,0.2759772200828917
3390,1193,-11243,0,8,8,0.0,-0.04191249999999999,11.0,0.13572896601446618
3402,1325,-13325,2,7,9,22.22,-0.04644444444444445,14.666666666666666,0.21439448752975654
3426,300,-2900,0,1,1,0.0,-0.0546,6.0,0.09464604755325023
3434,867,-2027,4,7,11,36.36,-0.003372727272727274,17.181818181818183,0.195508180110082
3438,4660,-36260,7,11,18,38.89,-0.015605555555555551,18.27777777777778,0.3193961636418791
3441,1128,13172,5,2,7,71.43,0.0649,20.0,0.28049577793143815
3444,2355,-18405,1,14,15,6.67,-0.044953333333333324,14.6,0.20831376403919516
3455,2986,23414,4,7,11,36.36,0.0744909090909091,20.636363636363637,0.2567072970983829
3465,304,-1224,1,4,5,20.0,-0.0321,17.8,0.3123018911678877
3466,3299,-2049,5,13,18,27.78,-0.017816666666666665,18.333333333333332,0.2530868360772749
3479,1986,3014,4,4,8,50.0,0.004275000000000001,23.5,0.208083151551207
3483,6917,-13917,8,14,22,36.36,0.007395454545454544,18.40909090909091,0.2520294550285288
3484,3438,-5338,5,9,14,35.71,-0.009364285714285717,17.357142857142858,0.21822929555664158
3489,825,-3395,3,6,9,33.33,-0.018922222222222222,20.77777777777778,0.2780008922789864
3490,2425,-23925,3,12,15,20.0,-0.04919333333333334,19.733333333333334,0.2651084416513437
3491,7155,7745,8,8,16,50.0,0.021668750000000004,18.6875,0.1955877264256509
3492,1205,495,3,5,8,37.5,-0.0009125000000000036,16.5,0.2507124840352883
3498,4783,-3683,7,13,20,35.0,-0.012214999999999998,18.0,0.262742275211796
3499,1614,4076,6,8,14,42.86,0.004278571428571428,23.142857142857142,0.23811156971131994
3508,3130,1270,6,7,13,46.15,0.02266153846153846,19.0,0.2831436300451914
3511,2080,-10880,4,10,14,28.57,-0.04126428571428571,14.428571428571429,0.21796574408010796
3512,1176,-4646,3,7,10,30.0,-0.038160000000000006,23.5,0.462927563620721
3516,516,-826,3,4,7,42.86,-0.000985714285714284,23.571428571428573,0.18066974370596034
3520,3926,61334,7,12,19,36.84,0.04800526315789474,22.263157894736842,0.36411741132684267
3521,865,-2365,3,7,10,30.0,-0.005080000000000001,17.7,0.3067655407416793
3522,1697,-11197,2,12,14,14.29,-0.04397142857142857,10.642857142857142,0.2779003455800328
3523,2894,-17454,5,13,18,27.78,-0.005016666666666666,16.61111111111111,0.36829696941535656
3526,5253,20747,5,9,14,35.71,0.005885714285714283,19.928571428571427,0.2795800242367712
3527,10441,43659,10,6,16,62.5,0.0297125,15.375,0.23352144374827957
3529,25630,259170,5,9,14,35.71,0.0011785714285714277,17.928571428571427,0.21410001210168758
3531,1569,-8219,2,9,11,18.18,-0.02395454545454546,14.727272727272727,0.18443576704340844
3537,1839,-16389,5,7,12,41.67,-0.045675,9.833333333333334,0.17651616599859243
3540,2061,-4911,2,6,8,25.0,-0.038349999999999995,12.625,0.35678180572448304
3541,583,-283,1,2,3,33.33,-0.0044666666666666665,20.333333333333332,0.20200044314046073
3546,10792,-49592,5,14,19,26.32,-0.03208947368421052,15.842105263157896,0.22704766456697492
3548,3236,-15186,5,8,13,38.46,-0.022,15.692307692307692,0.22910714870053292
3551,2279,10721,7,3,10,70.0,0.02555,17.1,0.17928946939975574
3552,5499,-50299,1,5,6,16.67,-0.04741666666666666,16.5,0.1652861009962561
3555,526,-9176,1,2,3,33.33,-0.06146666666666667,17.666666666666668,0.2410592779819852
3556,6064,-16364,9,7,16,56.25,-0.014131250000000003,15.8125,0.32685590784903124
3558,5170,10930,4,3,7,57.14,0.00812857142857143,20.714285714285715,0.22748428385364353
3564,1797,5553,2,5,7,28.57,0.0012571428571428614,14.285714285714286,0.2570502282702684
3567,1272,3828,5,5,10,50.0,0.00958,15.2,0.21286139846605873
3570,218,-2468,0,1,1,0.0,-0.0633,6.0,0.2473094359734107
3577,1832,-5882,5,5,10,50.0,-0.01465,20.6,0.17924921948342387
3580,2218,-26368,1,10,11,9.09,-0.07133636363636364,11.090909090909092,0.3280047759125665
3581,789,3011,4,3,7,57.14,0.01812857142857143,32.57142857142857,0.23041327728758879
3587,7872,-6872,9,10,19,47.37,-0.006689473684210525,16.36842105263158,0.2168806978528071
3594,957,-4957,2,4,6,33.33,-0.02086666666666667,15.5,0.18768824577037632
3597,0,0,0,0,0,0.0,,,
3609,601,399,1,5,6,16.67,0.0072499999999999995,10.166666666666666,0.17493433279354983
3611,12384,-5184,5,5,10,50.0,0.005209999999999999,29.0,0.23617995805751174
3615,3000,-23500,4,10,14,28.57,-0.02169285714285715,11.428571428571429,0.1814359664143089
3623,2363,-7503,3,10,13,23.08,-0.022746153846153847,11.461538461538462,0.19828586928492647
3624,1298,4452,4,3,7,57.14,0.02917142857142857,17.714285714285715,0.26702230257697523
3625,999,-6549,1,9,10,10.0,-0.04468,17.4,0.2435079344698156
3628,3908,-27208,0,8,8,0.0,-0.040925,14.0,0.2468610261842657
3629,379,-3939,2,2,4,50.0,-0.03065,22.25,0.21435336864798393
3630,5785,53765,12,6,18,66.67,0.08909999999999998,20.166666666666668,0.4251738689742031
3631,3020,-31370,4,9,13,30.77,-0.03601538461538461,15.0,0.25433337556036173
3632,3123,6447,6,13,19,31.58,0.014099999999999998,15.421052631578947,0.22169630211864377
3642,1106,-9106,1,8,9,11.11,-0.04346666666666667,14.333333333333334,0.20576459780555695
3646,338,2712,1,2,3,33.33,0.1089,24.666666666666668,0.26457777819736134
3652,1081,-2531,3,6,9,33.33,-0.004266666666666667,21.444444444444443,0.1975765868250164
3663,1034,2916,4,2,6,66.67,0.02401666666666667,16.333333333333332,0.18619176980094712
3664,1296,-3346,5,7,12,41.67,0.003258333333333335,16.166666666666668,0.19942584825212953
3666,1767,-22967,4,7,11,36.36,-0.05842727272727273,14.181818181818182,0.2836459855311548
3672,1634,-2284,3,8,11,27.27,0.024490909090909094,15.0,0.21328955158823237
3675,4701,10049,6,6,12,50.0,0.012674999999999997,17.75,0.2673454628072843
3680,9414,49836,8,5,13,61.54,0.011984615384615383,17.076923076923077,0.27057793775213934
3684,1654,-2754,2,4,6,33.33,-0.013616666666666666,23.5,0.15446555420604022
3685,3218,10782,6,9,15,40.0,0.03510666666666667,24.8,0.21570078333669532
3687,8218,-918,7,9,16,43.75,0.008387499999999999,15.875,0.2261081087836952
3689,1242,8458,4,2,6,66.67,0.061016666666666663,28.333333333333332,0.36557573151284006
3691,32290,-232290,7,11,18,38.89,-0.03069444444444445,19.61111111111111,0.29565375244910985
3693,1986,-28836,1,7,8,12.5,-0.0719375,11.25,0.2553585407288439
3707,2592,14268,4,6,10,40.0,0.03680000000000001,19.1,0.2711588805568147
3709,217,1383,1,1,2,50.0,0.036,21.5,0.2717372909610326
3710,188,-258,1,2,3,33.33,-0.0101,11.333333333333334,0.21164862418270225
3713,213,-3263,0,1,1,0.0,-0.0841,15.0,0.1363809710687982
4102,3315,-9765,13,11,24,54.17,0.0022333333333333315,14.166666666666666,0.20171662308651647
4105,5411,3789,5,8,13,38.46,0.0012307692307692286,21.307692307692307,0.2257120153303991
4107,288,-508,1,3,4,25.0,-0.010725,7.0,0.18446340800622452
4109,1853,-14703,5,12,17,29.41,-0.04221176470588236,13.294117647058824,0.16468110109017606
4111,2588,-4688,8,12,20,40.0,-0.0072050000000000005,23.05,0.2292498797220654
4113,400,-7030,0,6,6,0.0,-0.11571666666666665,9.333333333333334,0.3729332640834077
4114,3136,-8186,9,11,20,45.0,0.006725,17.35,0.22097910295554107
4116,575,-4275,0,2,2,0.0,-0.0424,5.5,0.20933019467910285
4120,6065,-21715,7,13,20,35.0,-0.019209999999999998,17.45,0.20403047610336458
4121,2436,-4566,9,14,23,39.13,-0.0023347826086956513,20.08695652173913,0.2556383753227703
4123,3316,-8666,3,10,13,23.08,-0.023823076923076926,17.23076923076923,0.18196574539226457
4126,902,-6502,2,3,5,40.0,-0.026500000000000003,17.6,0.22983005845046675
4127,1779,-4479,7,9,16,43.75,-0.019875000000000004,22.0,0.20332926877995366
4128,4504,9546,6,13,19,31.58,0.034178947368421045,20.63157894736842,0.2209618751580142
4129,6056,-11506,9,13,22,40.91,-0.016227272727272733,18.227272727272727,0.1966210204465274
4130,3018,-16468,4,9,13,30.77,-0.025284615384615385,20.0,0.21809950381053544
4131,133,3077,2,0,2,100.0,0.20379999999999998,24.0,0.24873201784509613
4138,2774,-12724,4,3,7,57.14,-0.0007000000000000022,20.571428571428573,0.14529560819809118
4139,3505,7395,5,4,9,55.56,0.009044444444444445,14.444444444444445,0.15436361210924168
4147,5303,-12203,3,4,7,42.86,0.021257142857142853,18.571428571428573,0.3132913414517849
4153,2939,-28389,3,7,10,30.0,-0.031069999999999997,14.6,0.2583278740555728
4154,712,-512,2,2,4,50.0,0.0021250000000000006,22.25,0.2008779938353315
4157,2798,-18148,4,11,15,26.67,-0.036460000000000006,14.333333333333334,0.21992779952010466
4160,1352,-6102,2,6,8,25.0,-0.019312500000000003,15.75,0.1855329060593165
4161,4790,-21990,3,9,12,25.0,-0.026766666666666675,16.75,0.2020177655968982
4162,14155,-19105,6,10,16,37.5,0.0013000000000000017,21.625,0.2638921114367975
4163,5824,5876,4,4,8,50.0,0.012262499999999997,29.25,0.19177713161048632
4167,1191,-9391,3,6,9,33.33,-0.04413333333333334,15.222222222222221,0.15948307354976668
4168,4109,20841,9,7,16,56.25,0.02028125,20.125,0.2478328447798298
4171,963,-5363,3,2,5,60.0,-0.00388,19.2,0.18749152456555174
4173,963,1837,4,3,7,57.14,0.014085714285714285,19.857142857142858,0.17481466012393268
4174,18807,-102207,7,9,16,43.75,-0.0035812499999999976,15.125,0.26840271714162334
4175,1144,-6644,0,3,3,0.0,-0.03186666666666667,13.333333333333334,0.08649739735054889
4183,309,741,1,2,3,33.33,0.022533333333333336,16.333333333333332,0.28068549600673887
4188,727,-4027,1,4,5,20.0,-0.0031799999999999997,19.2,0.41467990925662124
4192,692,-692,1,2,3,33.33,-0.0008999999999999994,14.333333333333334,0.16926099319343665
4198,807,-12017,1,8,9,11.11,-0.08472222222222221,13.11111111111111,0.2951710791505933
4205,259,-459,0,2,2,0.0,-0.010450000000000001,31.5,0.1486398267169995
4207,860,1210,5,7,12,41.67,0.00896666666666667,20.166666666666668,0.14589139498696627
4303,611,-1961,3,10,13,23.08,-0.06546153846153847,12.0,0.2963213786219616
4304,216,-166,1,2,3,33.33,-0.006100000000000001,10.0,0.12895665038299567
4305,278,-1678,0,3,3,0.0,-0.03373333333333333,7.333333333333333,0.11718671552420368
4401,4404,-26434,5,9,14,35.71,-0.009985714285714284,12.785714285714286,0.20806730086429773
4402,439,-1189,2,7,9,22.22,-0.04066666666666666,9.11111111111111,0.19783894885068695
4406,807,-2627,4,9,13,30.77,-0.018884615384615385,12.076923076923077,0.1512393647840678
4413,209,-1599,0,4,4,0.0,-0.09129999999999999,13.0,0.37736502329013205
4416,168,-1328,0,3,3,0.0,-0.07819999999999999,16.333333333333332,0.19992671575747653
4417,1215,-6115,4,6,10,40.0,-0.0060199999999999984,20.0,0.2601887612361516
4419,1184,28006,5,6,11,45.45,0.1198909090909091,16.363636363636363,0.26894723137889576
4420,306,-2556,0,3,3,0.0,-0.0483,15.0,0.17311516993603196
4430,967,-6567,1,3,4,25.0,-0.030025,17.0,0.17224649451265783
4432,2579,23471,6,5,11,54.55,0.0378,28.727272727272727,0.2143728793754933
4433,1631,-81,6,3,9,66.67,-6.666666666666626e-05,21.333333333333332,0.19106076761875201
4502,416,-1686,3,4,7,42.86,-0.02758571428571428,17.428571428571427,0.1888431409023002
4503,352,-1502,1,4,5,20.0,-0.032100000000000004,18.6,0.2875492231361909
4506,0,0,0,0,0,0.0,,,
4510,359,1851,2,3,5,40.0,0.03004,23.0,0.3544964314854712
4513,1354,-1074,6,11,17,35.29,-0.004829411764705886,21.647058823529413,0.2032092677659876
4523,3097,-13197,6,12,18,33.33,-0.005555555555555553,17.38888888888889,0.22651914295810327
4527,570,-2410,1,5,6,16.67,-0.017283333333333335,17.166666666666668,0.2179393794816209
4528,788,1762,5,4,9,55.56,0.013588888888888888,16.77777777777778,0.2584293195936012
4529,270,-3010,0,4,4,0.0,-0.07395,12.0,0.14960153464272125
4530,959,-10059,3,11,14,21.43,-0.05675,15.785714285714286,0.31496614372786935
4533,1525,1325,9,6,15,60.0,0.0015866666666666683,21.8,0.17486366794086228
4534,784,-4804,2,7,9,22.22,-0.05103333333333334,13.666666666666666,0.20911293047894275
4535,1831,-8081,2,5,7,28.57,-0.021428571428571432,18.0,0.12090298973989404
4538,0,0,0,0,0,0.0,,,
4541,1281,3019,3,3,6,50.0,0.04231666666666667,13.166666666666666,0.20769595148193423
4542,859,3441,3,2,5,60.0,0.01916,18.6,0.1304723705296616
4543,124,-674,0,1,1,0.0,-0.0311,13.0,0.08666207628560652
4549,3804,-16604,2,5,7,28.57,-0.025385714285714286,23.142857142857142,0.21266765792484943
4550,459,1441,3,1,4,75.0,0.01585,25.75,0.12589442919923488
4554,1116,2234,2,4,6,33.33,0.005250000000000002,10.333333333333334,0.30568535575919387
4556,363,1437,1,1,2,50.0,0.0232,22.5,0.19778967436686223
4561,299,-5099,0,2,2,0.0,-0.09325,14.5,0.22954422254707008
4563,765,-2665,1,2,3,33.33,-0.026833333333333334,20.666666666666668,0.3291234593841388
4568,338,-3738,0,1,1,0.0,-0.0618,4.0,0.1251423819443731
4580,1638,-2938,1,2,3,33.33,-0.010233333333333334,22.0,0.105073641793009
4609,1398,1282,5,12,17,29.41,0.022517647058823535,17.823529411764707,0.26402644700807204
4702,202,-1102,0,4,4,0.0,-0.07812499999999999,13.25,0.3651256060932096
4706,873,-3363,4,7,11,36.36,-0.028372727272727268,21.545454545454547,0.1863842158975036
4707,1509,-9839,6,9,15,40.0,-0.02142666666666667,22.066666666666666,0.23395508720911304
4711,600,-1250,3,4,7,42.86,-0.009842857142857143,15.0,0.13969769766803103
4712,849,1461,6,7,13,46.15,0.016446153846153846,18.692307692307693,0.23334904183425748
4714,879,-2219,5,7,12,41.67,-0.016941666666666664,14.833333333333334,0.2723880677764607
4716,934,-2284,4,6,10,40.0,-0.009349999999999999,13.7,0.20641415949364625
4721,6442,-34692,8,17,25,32.0,-0.029984,17.24,0.20342685810440794
4726,2056,-9406,4,6,10,40.0,-0.02357,17.4,0.24682350107917603
4728,1092,-2042,2,4,6,33.33,-0.007433333333333331,18.833333333333332,0.17608970967560036
4729,2229,-3829,7,14,21,33.33,-0.010385714285714286,20.095238095238095,0.2638141443742947
4735,4127,48173,8,7,15,53.33,0.03588,16.333333333333332,0.20866292312307708
4736,4876,-10876,3,6,9,33.33,-0.015133333333333332,15.0,0.14695446999434045
4741,324,-2324,0,1,1,0.0,-0.0408,3.0,0.08212822656855878
4743,7416,-36266,6,9,15,40.0,0.00035333333333333695,21.133333333333333,0.2575083571013697
4744,0,0,0,0,0,0.0,,,
4745,1964,-12564,2,5,7,28.57,-0.026,10.285714285714286,0.18568891798467813
4747,1717,7533,4,1,5,80.0,0.03678,21.6,0.2078975345512287
4754,1377,4123,3,2,5,60.0,0.014479999999999998,28.2,0.19492089827387993
4760,0,0,0,0,0,0.0,,,
4767,0,0,0,0,0,0.0,,,
4804,603,-5133,0,4,4,0.0,-0.055150000000000005,5.5,0.2596590511711876
4806,1015,-685,1,4,5,20.0,-0.026739999999999996,27.6,0.3306418785432795
4903,303,-393,1,5,6,16.67,-0.03576666666666666,13.166666666666666,0.4561721985979152
4905,605,-995,4,4,8,50.0,-0.0018999999999999998,20.125,0.22390322802873744
4907,182,2938,2,1,3,66.67,0.26076666666666665,19.333333333333332,0.3969761939484588
4908,151,-1801,0,2,2,0.0,-0.0712,13.5,0.18686826160969172
4909,4382,-26032,10,14,24,41.67,-0.02049166666666667,20.25,0.2747192576743469
4911,6135,-32185,5,10,15,33.33,-0.020066666666666667,16.8,0.234700093835902
4924,696,-3416,3,2,5,60.0,0.03182000000000001,27.2,0.2785629926224641
4931,0,0,0,0,0,0.0,,,
4933,3617,-17717,6,7,13,46.15,-0.009492307692307692,17.923076923076923,0.2545509315829744
4939,1312,-3312,5,7,12,41.67,-0.0016749999999999944,23.25,0.3504375409207962
4944,1007,10263,7,4,11,63.64,0.08336363636363636,15.909090909090908,0.28803240365381105
4945,0,0,0,0,0,0.0,,,
4946,4271,-21421,4,12,16,25.0,-0.020125,14.0625,0.21097577559147385
4950,941,8259,3,4,7,42.86,0.060714285714285714,29.571428571428573,0.23298542934765762
4953,233,1267,1,0,1,100.0,0.0327,28.0,0.24893616372861493
4966,25232,-31232,4,7,11,36.36,-0.0034272727272727306,17.09090909090909,0.29981719876122187
4971,4704,7996,5,6,11,45.45,0.004372727272727272,14.909090909090908,0.1707116716300006
4972,195,3355,1,0,1,100.0,0.1096,48.0,0.22774054352678208
4973,1512,-10062,4,6,10,40.0,-0.03835,14.9,0.13252003833333043
4974,1558,9942,5,1,6,83.33,0.042433333333333344,19.333333333333332,0.24070496176700826
4979,3684,2166,8,10,18,44.44,0.007605555555555554,19.555555555555557,0.26703732486157133
4987,1843,-943,2,3,5,40.0,-0.020579999999999998,20.8,0.22047832531137387
4991,4053,-3,5,7,12,41.67,0.008266666666666663,20.583333333333332,0.18828444477706086
4995,1856,-14006,0,9,9,0.0,-0.0406,11.88888888888889,0.1235580654296857
5009,1444,-1064,8,5,13,61.54,0.0076230769230769225,15.076923076923077,0.2050816635226584
5011,0,0,0,0,0,0.0,,,
5013,1255,3995,7,4,11,63.64,0.01828181818181818,14.909090909090908,0.12303528555758868
5014,2461,6189,13,17,30,43.33,0.019476666666666666,17.666666666666668,0.258119231690965
5015,1308,-158,4,5,9,44.44,0.002322222222222224,18.333333333333332,0.20086339445543155
5016,943,12507,7,1,8,87.5,0.08839999999999999,23.75,0.20564921386785312
5201,161,-21,2,1,3,66.67,-0.0030666666666666655,10.666666666666666,0.2067434533082054
5202,1812,-5012,9,17,26,34.62,-0.011650000000000002,18.46153846153846,0.22295101969057612
5205,331,-1331,1,5,6,16.67,-0.0389,18.0,0.25531052020915784
5206,108,192,1,1,2,50.0,0.024100000000000003,10.0,0.2919691629574822
5209,752,-9052,4,2,6,66.67,-0.020833333333333332,17.5,0.19390386903422877
5210,1132,-3822,5,11,16,31.25,-0.01893125,13.9375,0.15179688340904446
5211,328,-4228,1,1,2,50.0,-0.037200000000000004,10.0,0.28284358625481376
5212,860,-3560,3,5,8,37.5,-0.014474999999999998,13.75,0.2231745855802624
5213,192,-1862,0,3,3,0.0,-0.08439999999999999,7.333333333333333,0.19491852271680665
5220,1274,9286,3,3,6,50.0,0.048783333333333324,26.166666666666668,0.18611250868245902
5223,1097,-11297,1,2,3,33.33,-0.05243333333333333,6.666666666666667,0.2562212266881123
5227,2883,17927,8,7,15,53.33,0.04034666666666666,14.8,0.2693730471151211
5230,1371,-2871,1,3,4,25.0,-0.011975000000000001,21.25,0.2067197647864512
5245,3718,28982,4,7,11,36.36,0.05761818181818182,19.90909090909091,0.22786577720646317
5251,383,-733,1,1,2,50.0,0.019250000000000003,18.5,0.24837545656794013
5263,10358,-9858,3,5,8,37.5,0.008437499999999999,14.375,0.3937335345601679
5272,1055,-8505,1,3,4,25.0,-0.030075000000000008,17.5,0.2275065188092225
5274,51484,-527484,5,8,13,38.46,-0.030353846153846155,18.53846153846154,0.3201287361448714
5276,626,-4726,2,3,5,40.0,-0.03218,10.8,0.23190702101604077
5278,4525,-32775,1,7,8,12.5,-0.03815,17.75,0.2028423389461551
5281,1017,-8017,1,4,5,20.0,-0.011540000000000002,19.2,0.300324710245992
5287,11717,44283,4,4,8,50.0,0.029725,15.125,0.16662165773295842
5289,4297,-11097,2,5,7,28.57,-0.011842857142857143,19.142857142857142,0.1305253382325045
5291,902,-1252,2,4,6,33.33,-0.011183333333333335,15.0,0.16744037134388545
5299,0,0,0,0,0,0.0,,,
5301,665,-1335,4,7,11,36.36,-0.0028363636363636386,10.636363636363637,0.26234314505644624
5302,432,-2232,3,3,6,50.0,-0.014433333333333333,20.833333333333332,0.36003794100913294
5306,650,-3320,2,9,11,18.18,-0.05334545454545454,10.727272727272727,0.34673412120343766
5309,166,-1076,0,3,3,0.0,-0.06543333333333333,11.0,0.18584552631052573
5310,506,-3766,3,4,7,42.86,-0.027714285714285716,11.428571428571429,0.27917474058534036
5312,0,0,0,0,0,0.0,,,
5314,229,-139,2,2,4,50.0,-0.01,13.0,0.32138037968459565
5315,549,-2139,2,7,9,22.22,-0.03556666666666667,15.11111111111111,0.3138258243482725
5321,275,-565,1,4,5,20.0,0.01661999999999999,29.4,0.3270404274167937
5324,527,-677,3,7,10,30.0,-0.03928,13.1,0.26433203568971764
5328,162,-932,0,3,3,0.0,-0.06453333333333333,23.333333333333332,0.2019932016800856
5340,2336,3074,10,13,23,43.48,-0.0021608695652173943,16.82608695652174,0.22827145196312396
5344,0,0,0,0,0,0.0,,,
5345,806,954,6,8,14,42.86,-0.01094285714285714,17.214285714285715,0.28833678295620135
5347,373,-2873,2,3,5,40.0,-0.03226,16.2,0.2708090246867385
5348,108,592,1,1,2,50.0,0.12189999999999998,7.0,0.3500896090670286
5351,2021,-22551,2,15,17,11.76,-0.06708235294117647,11.411764705882353,0.2616547691348247
5353,783,-2213,3,8,11,27.27,-0.01052727272727273,15.454545454545455,0.2229129269337871
5355,1183,-3833,7,11,18,38.89,-0.01336111111111111,23.27777777777778,0.15750200317478152
5356,3297,-2457,6,14,20,30.0,-0.00042500000000000036,18.7,0.22453461661228005
5364,170,-1520,1,2,3,33.33,-0.07640000000000001,12.666666666666666,0.3279980357135946
5371,3534,-7834,5,11,16,31.25,-0.009587500000000002,13.5,0.21051022359970495
5381,1499,-3309,9,17,26,34.62,-0.01711923076923077,17.615384615384617,0.2578150788970947
5383,2068,772,12,11,23,52.17,0.008878260869565216,24.08695652173913,0.2542980054796797
5386,403,-3023,1,4,5,20.0,-0.042760000000000006,15.0,0.19951295994780294
5392,125,-2025,0,2,2,0.0,-0.11410000000000001,5.0,0.40212135741741184
5398,399,1301,5,2,7,71.43,0.027542857142857147,16.571428571428573,0.2619974334043329
5403,1565,-4315,5,10,15,33.33,-0.013026666666666667,21.0,0.17568566768723143
5410,55,-105,0,1,1,0.0,-0.0202,5.0,0.0901706321347353
5425,4489,-8189,8,18,26,30.77,-0.018753846153846152,22.23076923076923,0.2265276472550865
5426,704,-2104,3,6,9,33.33,-0.0263,20.0,0.226527842211073
5432,1108,-10108,2,13,15,13.33,-0.07136666666666666,13.466666666666667,0.5017176672201296
5438,3042,-18492,5,14,19,26.32,-0.02175789473684211,23.526315789473685,0.2740017629228977
5439,4457,-5757,9,19,28,32.14,0.00026428571428571343,20.785714285714285,0.22950066611637246
5443,830,670,2,7,9,22.22,-0.012755555555555553,15.444444444444445,0.29452442752453145
5450,2031,9489,11,13,24,45.83,0.04670833333333333,17.958333333333332,0.2463246089045753
5452,2245,-14405,10,15,25,40.0,-0.02886,21.44,0.2614938462585836
5455,163,-1803,0,3,3,0.0,-0.11309999999999999,10.666666666666666,0.4590726416524981
5457,1084,-1084,6,8,14,42.86,0.001964285714285718,16.214285714285715,0.25939520292380314
5460,1251,-8501,4,9,13,30.77,-0.030592307692307693,23.153846153846153,0.18092709579482366
5464,1637,-9767,2,11,13,15.38,-0.029792307692307694,15.0,0.2500015851519318
5465,528,1552,4,4,8,50.0,0.010425,14.25,0.24924604053877217
5468,128,-728,1,1,2,50.0,-0.03385,17.5,0.37244264088512546
5474,5235,11815,12,15,27,44.44,0.015370370370370368,20.62962962962963,0.25849359814210904
5475,1896,-9456,9,19,28,32.14,-0.02687857142857143,13.392857142857142,0.24726223274972167
5478,7841,-15691,4,12,16,25.0,0.012431249999999998,17.0625,0.22117740198077868
5481,1790,16390,9,9,18,50.0,0.04243888888888889,22.333333333333332,0.25624420729807373
5483,7490,-45690,7,13,20,35.0,-0.007389999999999996,21.55,0.32062680547271183
5487,684,-1984,2,5,7,28.57,-0.013571428571428571,12.714285714285714,0.15987821823610443
5488,1256,-8926,3,12,15,20.0,-0.04203333333333334,20.6,0.23551858560248984
5489,3318,-10068,6,8,14,42.86,-0.008635714285714285,23.928571428571427,0.20449813033517975
5490,2521,-9321,4,10,14,28.57,-0.019542857142857147,17.214285714285715,0.18901367807921013
5493,1335,6015,4,6,10,40.0,0.04572999999999999,28.1,0.19187717975837568
5498,1460,-5670,6,14,20,30.0,-0.013905,18.95,0.2172685588280514
5508,2199,10001,5,4,9,55.56,0.02804444444444444,35.333333333333336,0.21735026024338946
5511,383,3227,2,4,6,33.33,0.07375,25.5,0.197471558500383
5512,1175,7405,8,7,15,53.33,0.04189333333333334,21.266666666666666,0.23801263047958374
5514,709,-1059,4,5,9,44.44,-0.008655555555555559,16.666666666666668,0.18834813849561582
5516,899,2481,3,9,12,25.0,0.019875,12.416666666666666,0.23548098339209622
5520,441,-1541,3,2,5,60.0,-0.017479999999999992,17.2,0.15771619081289479
5523,945,-6885,5,7,12,41.67,-0.03650833333333333,21.5,0.31242791463182923
5529,48,-428,0,1,1,0.0,-0.1436,6.0,0.7352992230766062
5530,3133,26237,6,9,15,40.0,0.048,22.266666666666666,0.24329865619326055
5536,6726,-10526,3,5,8,37.5,-0.009275,15.0,0.2616120990933887
5543,611,-3661,0,3,3,0.0,-0.0384,20.0,0.14065497715668696
5601,116,-216,0,2,2,0.0,-0.017849999999999998,4.0,0.12084335129961787
5603,525,2715,3,4,7,42.86,0.030500000000000006,18.428571428571427,0.22996392823354198
5604,0,0,0,0,0,0.0,,,
5609,3321,6329,9,9,18,50.0,0.01915555555555555,16.77777777777778,0.17585105833966239
5701,1882,-4162,9,19,28,32.14,-0.025789285714285716,15.285714285714286,0.24784815784693892
5703,0,0,0,0,0,0.0,,,
5704,0,0,0,0,0,0.0,,,
5820,440,-120,3,4,7,42.86,-2.857142857142741e-05,13.857142857142858,0.1470390919378862
5864,648,-1188,3,6,9,33.33,-0.011866666666666668,15.88888888888889,0.2211123707348483
5878,498,-648,0,2,2,0.0,-0.0076,10.0,0.09143134082265225
5902,286,-1086,1,4,5,20.0,-0.04732,5.4,0.1890209915997408
5903,0,0,0,0,0,0.0,,,
5904,313,-813,1,1,2,50.0,-0.0057,12.5,0.10293907248031053
5905,1597,-5247,4,15,19,21.05,-0.020584210526315788,22.05263157894737,0.25029166779453244
6015,56,-806,0,1,1,0.0,-0.129,11.0,0.4155129975124958
6016,1564,-3294,7,16,23,30.43,-0.017313043478260872,15.478260869565217,0.1924131217608857
6020,861,-4061,3,6,9,33.33,-0.021044444444444442,15.666666666666666,0.17317168300636546
6021,1614,3396,8,11,19,42.11,0.024457894736842102,18.842105263157894,0.21403001919347925
6023,1628,-16328,1,6,7,14.29,-0.05064285714285714,16.142857142857142,0.17017548130776522
6026,293,487,2,2,4,50.0,0.017125,13.75,0.22405095584917023
6101,525,-5235,2,5,7,28.57,-0.037471428571428565,13.285714285714286,0.41511184679987967
6103,1713,10997,6,2,8,75.0,0.050837499999999994,15.25,0.33974721325646373
6104,6672,-12372,11,11,22,50.0,-0.004054545454545455,16.181818181818183,0.2997537332284738
6109,408,152,2,4,6,33.33,0.0028666666666666645,17.5,0.2671112289122209
6111,874,-7224,2,5,7,28.57,-0.04071428571428572,14.571428571428571,0.26909932487783356
6113,1513,-5113,5,16,21,23.81,-0.02132857142857143,22.761904761904763,0.2476092878832151
6114,86,1514,1,0,1,100.0,0.113,21.0,0.19303550024749416
6118,1627,-5897,6,13,19,31.58,-0.023384210526315792,21.789473684210527,0.27393475259009775
6121,22428,-62928,9,11,20,45.0,-0.014180000000000002,17.0,0.1896212465423671
6122,830,960,4,7,11,36.36,0.008490909090909096,19.454545454545453,0.19648425604496625
6123,354,-2964,1,4,5,20.0,-0.07877999999999999,17.4,0.3111925463621999
6124,1287,3513,2,4,6,33.33,-0.005016666666666669,15.0,0.2526639468766941
6125,3107,1483,11,12,23,47.83,0.013439130434782606,16.217391304347824,0.2276685039648772
6126,1162,-6512,3,5,8,37.5,-0.019675,25.375,0.3744441989571623
6127,2504,-9294,9,20,29,31.03,-0.02013448275862069,16.689655172413794,0.34452051089733865
6129,2543,137,12,9,21,57.14,0.015542857142857145,23.238095238095237,0.2958258742967258
6130,267,-5267,0,4,4,0.0,-0.133,5.5,0.5431703993069494
6134,3015,-7535,8,12,20,40.0,-0.017255,22.8,0.19978982432677833
6138,7246,10654,7,16,23,30.43,-0.022717391304347825,14.565217391304348,0.30631457924092625
6140,1659,-6839,10,10,20,50.0,-0.01778,18.2,0.2066064148544982
6143,5793,-6693,7,16,23,30.43,-0.013365217391304344,17.73913043478261,0.26885653109895563
6144,448,-2398,4,3,7,57.14,-0.032600000000000004,11.857142857142858,0.2292826738908975
6146,2581,12269,5,4,9,55.56,0.022599999999999995,26.0,0.19347367597691784
6147,5911,-26911,9,15,24,37.5,-0.029420833333333337,15.333333333333334,0.30013452713543304
6148,868,-9948,3,11,14,21.43,-0.024650000000000002,16.214285714285715,0.40534299672840396
6150,2172,-17132,4,13,17,23.53,-0.04015882352941177,11.235294117647058,0.3153119771713092
6151,2627,-17527,7,11,18,38.89,-0.03140555555555555,17.333333333333332,0.24984885097592446
6154,2130,-19830,1,10,11,9.09,-0.051654545454545446,9.181818181818182,0.15988759958991972
6156,760,-5360,1,5,6,16.67,-0.02935,20.666666666666668,0.3204337567387747
6158,3654,-21544,7,13,20,35.0,-0.019030000000000002,21.75,0.2646642513196193
6160,4464,-4564,11,14,25,44.0,0.0041880000000000025,18.28,0.23286855004160678
6161,778,-7348,1,8,9,11.11,-0.04834444444444444,12.777777777777779,0.17022092733036046
6163,1913,-5693,7,15,22,31.82,-0.010454545454545454,15.454545454545455,0.2896324125696536
6167,1723,-2173,12,12,24,50.0,-0.010245833333333336,18.958333333333332,0.2942415033106475
6169,6219,-11869,7,24,31,22.58,-0.014338709677419358,17.903225806451612,0.2844991943308282
6170,2215,-6665,6,9,15,40.0,-0.013966666666666665,24.8,0.26200490390731485
6171,565,-4815,0,7,7,0.0,-0.05537142857142857,12.428571428571429,0.2276982612150968
6173,3641,7869,12,11,23,52.17,0.0066999999999999985,17.17391304347826,0.337138715723486
6174,556,-2186,1,6,7,14.29,-0.03661428571428571,10.285714285714286,0.22559373451959946
6175,2292,-20652,3,17,20,15.0,-0.044455,15.15,0.21490137424280276
6179,1813,-13043,4,9,13,30.77,-0.029576923076923077,15.0,0.2749157959418263
6180,4455,-19855,7,17,24,29.17,-0.02324583333333333,18.958333333333332,0.2782315195200584
6182,1414,8226,5,4,9,55.56,0.040244444444444444,17.0,0.24439355540110322
6185,1953,-19503,5,8,13,38.46,-0.03766153846153846,16.384615384615383,0.21819416392102703
6186,1117,2143,5,8,13,38.46,0.013400000000000004,15.153846153846153,0.3441365441927925
6187,6937,11763,14,14,28,50.0,0.020924999999999996,20.5,0.2241911971521542
6188,6101,-4351,7,13,20,35.0,1.4999999999998349e-05,19.8,0.23979861983155198
6190,1191,-2811,8,8,16,50.0,-0.003406250000000003,18.75,0.17632080307698944
6194,2436,-17636,2,9,11,18.18,-0.04075454545454546,7.909090909090909,0.14486233879196386
6195,309,-269,2,2,4,50.0,0.010750000000000001,11.5,0.35270517991007044
6198,1181,-2801,5,10,15,33.33,-0.0063999999999999994,14.133333333333333,0.20568965803331704
6199,1661,-15251,2,16,18,11.11,-0.049566666666666676,14.38888888888889,0.28893646296778436
6203,130,570,1,0,1,100.0,0.0263,21.0,0.29518991840034037
6204,1061,-4511,1,4,5,20.0,-0.035699999999999996,32.4,0.3288886208225813
6207,922,5028,4,1,5,80.0,0.033240000000000006,20.8,0.33882978836954336
6208,1522,2788,6,5,11,54.55,0.007709090909090905,19.09090909090909,0.21362441802432197
6210,2467,-2957,9,10,19,47.37,-0.01838947368421052,18.842105263157894,0.20450882458440325
6212,545,-2795,3,5,8,37.5,-0.0216875,15.875,0.35981236747415546
6217,2898,-13238,4,16,20,20.0,-0.0415,13.45,0.23398623120004572
6218,1218,-3968,5,4,9,55.56,8.888888888888526e-05,23.77777777777778,0.17998987552590423
6219,113,-853,0,2,2,0.0,-0.0635,4.5,0.18282818288593705
6220,3180,-6030,10,15,25,40.0,-0.014543999999999996,18.88,0.26760720968695395
6221,794,3996,4,5,9,44.44,0.0403111111111111,23.22222222222222,0.2103755805056048
6222,695,-1355,2,6,8,25.0,-0.012975,8.5,0.43681955733609845
6223,7693,25657,7,10,17,41.18,0.039417647058823536,19.41176470588235,0.2820598025562495
6227,1129,-14529,1,5,6,16.67,-0.06319999999999999,15.5,0.18559940870643657
6228,1318,-6208,5,12,17,29.41,-0.02068235294117647,15.529411764705882,0.20348593288459302
6229,1952,7848,8,7,15,53.33,0.023046666666666667,18.733333333333334,0.251451471937138
6231,7956,-26856,7,11,18,38.89,-0.006722222222222223,15.38888888888889,0.25917558706125976
6233,3520,2830,9,10,19,47.37,-0.011726315789473684,21.57894736842105,0.3624083572543445
6234,5144,7956,10,12,22,45.45,0.005713636363636365,16.045454545454547,0.22083664003780365
6236,597,2633,5,1,6,83.33,0.05188333333333334,15.833333333333334,0.292494127997498
6237,5144,-52194,5,13,18,27.78,-0.042050000000000004,14.555555555555555,0.28890439671940116
6240,138,-1058,0,2,2,0.0,-0.041049999999999996,5.5,0.15816596220877965
6241,121,-81,1,1,2,50.0,-0.0198,13.5,0.23598024961034758
6242,545,-2135,2,4,6,33.33,-0.030600000000000002,14.5,0.23734667218507266
6244,6612,62028,9,7,16,56.25,0.03137500000000001,24.5,0.3154599427692413
6245,4361,16689,11,7,18,61.11,0.042283333333333326,24.38888888888889,0.22516126880704843
6246,549,-5139,0,8,8,0.0,-0.0697625,7.375,0.3620289824444065
6247,715,3435,4,3,7,57.14,0.04241428571428572,19.571428571428573,0.1961403931938563
6248,1187,13473,5,7,12,41.67,0.24186666666666667,19.666666666666668,0.3042872916190353
6259,486,-1436,2,3,5,40.0,-0.0215,11.8,0.21178118597131806
6261,5767,-4267,8,9,17,47.06,0.0005000000000000025,23.764705882352942,0.19574921729392583
6263,4037,-11037,6,10,16,37.5,-0.0012312499999999997,19.1875,0.21346502377043763
6264,2089,-1239,6,12,18,33.33,0.006455555555555558,20.166666666666668,0.23390498459061396
6265,1239,3911,6,10,16,37.5,0.021837499999999996,20.0625,0.19155335183104866
6266,701,1679,3,5,8,37.5,0.03535,21.25,0.19475401249206475
6270,1603,-6803,3,4,7,42.86,-0.02041428571428571,15.142857142857142,0.2210092174522831
6274,8083,-32283,12,13,25,48.0,-0.01664,17.72,0.25823312739983595
6275,1706,-6756,6,10,16,37.5,-0.008881250000000002,19.0,0.2601956963710449
6276,250,-920,1,3,4,25.0,-0.0532,7.5,0.24597715261631659
6279,14107,-61757,8,16,24,33.33,-0.025195833333333334,19.541666666666668,0.18388326369990823
6284,2079,-7829,4,6,10,40.0,-0.018709999999999997,14.5,0.19148629834308664
6287,455,1025,2,5,7,28.57,-0.003557142857142857,16.142857142857142,0.26610608913505984
6290,4728,-44078,5,16,21,23.81,-0.04222380952380952,19.428571428571427,0.21491558312193174
6291,1589,-2809,7,9,16,43.75,-0.01689375,16.5,0.31801611256505274
6292,1417,-1367,6,4,10,60.0,0.02409,29.7,0.20393614175338923
6294,429,-2999,1,4,5,20.0,-0.03414,17.2,0.3024653429669367
6404,2075,-11365,5,6,11,45.45,-0.0030636363636363604,25.90909090909091,0.42192135261212066
6411,6605,9845,7,5,12,58.33,0.011449999999999997,22.916666666666668,0.20968406280405824
6417,326,1774,1,0,1,100.0,0.0327,30.0,0.39742346990378397
6418,0,0,0,0,0,0.0,,,
6419,1276,10684,6,4,10,60.0,0.05399,12.3,0.18974678734902412
6425,1086,-1256,3,4,7,42.86,-0.0017857142857142835,19.714285714285715,0.16759861296915987
6426,0,0,0,0,0,0.0,,,
6432,866,2434,4,1,5,80.0,0.03354,22.6,0.13921523256357288
6435,4436,-9436,4,3,7,57.14,-0.005742857142857145,18.857142857142858,0.18545917580522783
6441,1151,11549,2,2,4,50.0,0.066775,13.75,0.1644526011722377
6446,7253,-28153,4,6,10,40.0,-0.0289,29.1,0.20454931232645396
6457,3047,-17097,2,5,7,28.57,-0.02511428571428572,9.857142857142858,0.24079599003884017
6461,1723,-13,4,5,9,44.44,0.008944444444444446,24.333333333333332,0.2636383796015853
6462,9282,-55982,2,7,9,22.22,-0.027211111111111113,16.22222222222222,0.4286043602585477
6465,2558,-15908,1,9,10,10.0,-0.041499999999999995,7.5,0.14783065748902335
6469,903,-203,1,1,2,50.0,-0.002449999999999999,5.0,0.09272138950370912
6470,2585,-8335,3,7,10,30.0,-0.019170000000000003,20.1,0.1805216913471494
6472,4956,1144,3,3,6,50.0,0.018333333333333337,34.333333333333336,0.17232923548832946
6482,649,-6399,0,3,3,0.0,-0.06053333333333333,5.0,0.3932296045436979
6485,1936,47664,2,2,4,50.0,0.0911,29.5,0.29776395144125883
6486,208,-1608,0,1,1,0.0,-0.0437,2.0,0.10884286419579636
6488,28673,37927,6,4,10,60.0,0.003879999999999996,24.9,0.25476692052446664
6492,5780,-29280,4,5,9,44.44,0.010211111111111112,14.555555555555555,0.32903064249125946
6494,3535,-16235,2,6,8,25.0,-0.0276,12.0,0.17633192373567902
6496,1072,6428,2,1,3,66.67,0.0336,24.333333333333332,0.17514951810976678
6499,4620,3830,5,4,9,55.56,0.023622222222222225,18.22222222222222,0.28975314535316604
6506,86,-336,0,1,1,0.0,-0.0224,25.0,0.2129520657980568
6508,1558,-5258,4,6,10,40.0,-0.017359999999999997,18.4,0.24981532133333725
6509,1857,4893,3,10,13,23.08,-0.014753846153846156,13.461538461538462,0.27888102675691395
6510,36486,-60486,3,4,7,42.86,-0.00017142857142856842,13.571428571428571,0.22569194305668847
6512,76,924,1,0,1,100.0,0.0832,43.0,0.29538274967848266
6514,2093,-3943,2,5,7,28.57,-0.006628571428571431,18.857142857142858,0.27939786466646027
6516,1805,-16305,0,2,2,0.0,-0.0631,13.0,0.19966682758136856
6523,7012,-34012,3,7,10,30.0,-0.013680000000000003,12.4,0.16783263963148065
6527,1110,-4360,1,3,4,25.0,-0.023350000000000003,9.5,0.1106043567813953
6530,0,0,0,0,0,0.0,,,
6532,1988,-10738,3,5,8,37.5,-0.013762499999999997,16.125,0.2678688376306155
6535,913,-3063,1,3,4,25.0,-0.009499999999999995,16.5,0.2188733488823087
6538,4906,-3856,2,4,6,33.33,-0.015899999999999994,14.5,0.3087791646650953
6542,313,1787,1,0,1,100.0,0.0344,4.0,0.1543281168794175
6547,746,84,2,2,4,50.0,0.0002999999999999999,20.0,0.1425181024734558
6548,6126,-40976,3,3,6,50.0,0.007899999999999999,16.0,0.25181265664274877
6556,392,-1242,1,1,2,50.0,-0.018799999999999997,13.5,0.1687537127034312
6560,1098,-2498,1,2,3,33.33,-0.024566666666666667,23.666666666666668,0.37820107668451447
6561,6309,-33309,1,3,4,25.0,-0.027975,14.75,0.14546729925412916
6568,5547,61453,4,1,5,80.0,0.04898,21.8,0.257201079246758
6569,1105,-605,0,1,1,0.0,-0.0032,13.0,0.15625203148346167
6570,586,-3056,1,2,3,33.33,-0.031400000000000004,11.666666666666666,0.14628528402845897
6574,0,0,0,0,0,0.0,,,
6576,1378,1722,1,2,3,33.33,0.006233333333333331,8.666666666666666,0.185790003845869
6577,386,1514,1,0,1,100.0,0.0235,15.0,0.2053853410286821
6578,115,-215,0,1,1,0.0,-0.0108,18.0,0.14403561889102967
6588,301,1699,1,0,1,100.0,0.034,48.0,0.5530402873378375
6589,664,12186,2,1,3,66.67,0.09166666666666667,17.666666666666668,0.26961953192695826
6590,482,3218,2,0,2,100.0,0.03905,11.5,0.1482339544296758
6593,0,0,0,0,0,0.0,,,
6594,163,1637,1,0,1,100.0,0.0615,31.0,0.2998797921945242
6596,649,8851,1,1,2,50.0,0.0944,45.5,0.10352862112742722
6603,220,-470,1,2,3,33.33,-0.012666666666666668,10.666666666666666,0.23948999260606993
6609,2786,5314,11,9,20,55.0,0.012555000000000002,19.1,0.19483597096613373
6612,714,-4314,0,2,2,0.0,-0.03455,5.5,0.0896884665798463
6613,3596,3404,3,1,4,75.0,0.00925,15.75,0.12853419736430455
6615,1478,-13478,0,3,3,0.0,-0.05206666666666667,12.666666666666666,0.21812624534519554
6616,205,-305,0,1,1,0.0,-0.0087,6.0,0.10419519948788736
6624,550,-1050,1,1,2,50.0,-0.0098,14.5,0.18354528093744782
6629,270,-570,0,1,1,0.0,-0.0123,4.0,0.1690074278941056
6640,707,2593,1,1,2,50.0,0.010150000000000001,15.0,0.1506823344010676
6642,398,2452,1,1,2,50.0,0.0414,20.5,0.26440565646773884
6643,6941,19559,3,1,4,75.0,0.02175,19.5,0.47156770970595646
6649,208,-1708,0,1,1,0.0,-0.0464,2.0,0.2041349549333764
6651,656,-15156,0,1,1,0.0,-0.1232,7.0,0.4518921416366708
6654,1033,767,1,2,3,33.33,0.001533333333333333,12.666666666666666,0.23140367328348907
6661,0,0,0,0,0,0.0,,,
6662,183,3167,1,0,1,100.0,0.11,27.0,0.5611896817620947
6664,811,-1011,1,1,2,50.0,-0.0011000000000000003,26.5,0.11148526044800644
6667,711,-1711,1,1,2,50.0,-0.012899999999999998,16.5,0.1505606259918989
6679,655,7345,1,0,1,100.0,0.0693,15.0,0.20318766641550323
6680,0,0,0,0,0,0.0,,,
6683,7467,-36467,1,3,4,25.0,-0.024450000000000006,11.25,0.2820154330454408
6690,3074,2926,3,1,4,75.0,0.02435,23.75,0.20571795877214705
6697,0,0,0,0,0,0.0,,,
6703,0,0,0,0,0,0.0,,,
6712,1951,-28451,0,1,1,0.0,-0.0805,2.0,0.4520994324533323
6716,1617,18883,1,1,2,50.0,0.10504999999999999,21.5,0.3497894250092749
6727,0,0,0,0,0,0.0,,,
6728,839,-5139,0,2,2,0.0,-0.0334,4.5,0.18426402704468425
6732,10685,-98685,1,2,3,33.33,-0.06143333333333333,19.666666666666668,0.20522257648736866
6733,146,-1346,0,1,1,0.0,-0.0518,54.0,0.3015669925274178
6747,1343,44157,1,0,1,100.0,0.2264,44.0,0.3748992906483186
6751,0,0,0,0,0,0.0,,,
6752,0,0,0,0,0,0.0,,,
6762,0,0,0,0,0,0.0,,,
6767,192,158,1,0,1,100.0,0.0049,19.0,0.13065127804869237
6803,1565,435,1,1,2,50.0,0.002449999999999999,27.0,0.17210281360595547
7402,3056,5944,3,5,8,37.5,0.008525000000000001,18.0,0.16254775490315063
7556,778,15722,1,0,1,100.0,0.1305,8.0,0.6139951835741149
8024,1736,-6916,7,7,14,50.0,0.004199999999999998,20.928571428571427,0.1946879441469236
8027,1563,2087,4,5,9,44.44,0.01508888888888889,26.444444444444443,0.22798174034767932
8032,2472,-6872,5,11,16,31.25,-0.017037499999999997,20.125,0.19367274880435614
8034,928,-1268,7,6,13,53.85,0.010769230769230765,18.0,0.205129088070799
8038,2492,-11892,3,8,11,27.27,-0.014936363636363637,18.09090909090909,0.24186703418444513
8040,2565,26345,6,12,18,33.33,0.024566666666666667,16.444444444444443,0.2865803613626101
8042,2807,-14407,5,9,14,35.71,-0.022828571428571427,19.0,0.24514915837238394
8043,1537,-2037,6,5,11,54.55,-0.004718181818181819,20.90909090909091,0.27111178577845074
8044,21259,-73359,11,9,20,55.0,0.006345000000000001,16.4,0.24666703034200213
8047,203,-703,0,1,1,0.0,-0.0201,7.0,0.17110898557709775
8048,1501,4299,4,6,10,40.0,0.00447,18.6,0.24332746649339718
8049,1620,-2780,9,11,20,45.0,0.002065000000000003,14.1,0.25540287280418716
8050,6887,-26837,9,10,19,47.37,-0.012815789473684211,15.31578947368421,0.2184778571808885
8054,3994,5556,8,9,17,47.06,0.012176470588235294,15.764705882352942,0.2585945221749663
8059,468,5252,4,2,6,66.67,0.055850000000000004,18.166666666666668,0.1218950752887364
8064,773,-1673,3,4,7,42.86,0.0033428571428571452,14.428571428571429,0.2348230935331604
8066,126,-816,0,2,2,0.0,-0.06409999999999999,13.5,0.47447712758922445
8067,1186,-7766,5,12,17,29.41,-0.04145882352941176,11.529411764705882,0.19095786869033538
8068,3115,-17335,4,13,17,23.53,-0.03531764705882352,10.294117647058824,0.40484617249260585
8069,6263,-6913,10,17,27,37.04,-0.006022222222222222,17.74074074074074,0.24300053913667632
8071,105,-1435,0,2,2,0.0,-0.1504,8.0,0.38830196902033753
8074,1049,-2149,4,6,10,40.0,-0.006910000000000002,20.1,0.18027001637711484
8076,8537,-71437,9,13,22,40.91,-0.03426363636363636,18.40909090909091,0.3154951950451146
8077,69,1681,1,0,1,100.0,0.2155,43.0,0.48965013185750905
8080,2957,-13827,8,20,28,28.57,-0.03254642857142857,15.071428571428571,0.34838052590126206
8083,1847,-13547,0,4,4,0.0,-0.05525,8.0,0.11868723741616277
8084,3664,-1384,8,12,20,40.0,-0.0013499999999999992,21.05,0.24388442819161646
8085,1757,3103,9,13,22,40.91,-0.0014454545454545427,15.681818181818182,0.24441552366600894
8086,2094,-46994,1,7,8,12.5,-0.10095000000000001,12.375,0.29569600314782474
8087,585,-4975,1,8,9,11.11,-0.06821111111111111,12.11111111111111,0.31280104582272084
8088,3355,5365,14,16,30,46.67,0.011919999999999998,16.266666666666666,0.2512508213858471
8089,0,0,0,0,0,0.0,,,
8091,3689,-5189,6,6,12,50.0,-0.006949999999999998,20.916666666666668,0.2424334096822994
8092,910,-5500,2,9,11,18.18,-0.038918181818181824,15.363636363636363,0.1861754051581582
8093,1252,-7712,4,12,16,25.0,-0.03918125,13.3125,0.18537314502251773
8096,2595,-23535,6,13,19,31.58,-0.041542105263157894,11.947368421052632,0.2223661988994209
8097,633,587,3,4,7,42.86,0.0015857142857142856,22.0,0.31637401394067727
8099,2127,-12827,4,9,13,30.77,-0.034161538461538465,17.692307692307693,0.2261133421411522
8107,1961,-8731,7,11,18,38.89,-0.015305555555555553,14.555555555555555,0.21347053943501246
8109,2737,1813,3,6,9,33.33,0.002899999999999998,20.555555555555557,0.19352906763081867
8111,1608,2672,7,9,16,43.75,0.01669375,22.0,0.3202674751529465
8121,4724,-11824,10,12,22,45.45,-0.0018363636363636316,12.090909090909092,0.30518517710711257
8147,834,1016,3,1,4,75.0,0.010050000000000002,8.0,0.18966516543983536
8155,4602,35948,6,6,12,50.0,0.05082500000000001,20.75,0.24987926142950911
8171,1190,-15370,1,9,10,10.0,-0.06461,15.0,0.24608318257012507
8176,269,-639,1,3,4,25.0,0.0036999999999999967,12.25,0.2931414958288534
8182,2929,6971,9,10,19,47.37,0.006384210526315792,17.894736842105264,0.22943239353207223
8183,1797,-10517,5,10,15,33.33,-0.023533333333333333,14.933333333333334,0.24984101801762543
8234,1594,-11694,3,6,9,33.33,-0.02548888888888889,20.555555555555557,0.3324408659670093
8240,6003,-59353,6,13,19,31.58,-0.027805263157894736,13.68421052631579,0.25597454080583415
8255,17601,56099,10,15,25,40.0,0.024703999999999997,16.56,0.21710776851314392
8277,523,-4773,1,3,4,25.0,-0.0436,10.25,0.3598268169156959
8279,678,-14678,0,1,1,0.0,-0.116,31.0,0.29336972183892196
8284,0,0,0,0,0,0.0,,,
8289,1680,4920,9,7,16,56.25,0.01906875,18.75,0.1868451408030564
8291,654,-584,4,8,12,33.33,-0.018883333333333335,15.166666666666666,0.2443384407990332
8299,24329,-34829,10,11,21,47.62,-0.0067523809523809515,17.857142857142858,0.2658264482632172
8342,536,2964,1,1,2,50.0,0.028350000000000004,18.0,0.12019579098682087
8349,5138,-3888,6,6,12,50.0,-0.004449999999999998,22.916666666666668,0.12618118950172622
8354,339,-989,2,1,3,66.67,-0.014400000000000001,19.0,0.4252749649864001
8358,261,-2341,0,3,3,0.0,-0.06,11.333333333333334,0.20675465622750408
8383,1697,-247,4,5,9,44.44,-0.001522222222222221,23.555555555555557,0.20188576531142233
8390,1621,4279,4,4,8,50.0,0.017675,17.75,0.20619715869705355
8401,548,2702,3,1,4,75.0,0.030925,17.25,0.14566092222054522
8403,1740,-6190,1,7,8,12.5,-0.021725,21.125,0.19190703988603627
8409,1729,-6579,2,8,10,20.0,-0.0208,14.1,0.17303123773307222
8410,1586,4514,3,4,7,42.86,0.026914285714285707,10.857142857142858,0.27477588112285495
8415,358,1342,2,0,2,100.0,0.0238,25.5,0.1846756675600476
8416,7358,-33158,3,7,10,30.0,-0.02414,12.4,0.1970671871669245
8418,610,-1060,2,3,5,40.0,-0.014379999999999999,13.8,0.22994499967148158
8420,0,0,0,0,0,0.0,,,
8421,910,-800,5,6,11,45.45,-0.0038090909090909082,21.818181818181817,0.16046826106180745
8423,308,-2108,0,2,2,0.0,-0.0441,6.5,0.20192430416789753
8424,286,-5186,0,1,1,0.0,-0.099,28.0,0.08324109386385281
8426,2537,-17587,3,7,10,30.0,-0.03171,16.1,0.20486047758655773
8431,2281,23819,3,3,6,50.0,0.08068333333333333,19.166666666666668,0.22454281940295626
8432,1657,1943,2,2,4,50.0,0.005800000000000001,16.5,0.1582058264289241
8433,0,0,0,0,0,0.0,,,
8435,896,3904,2,1,3,66.67,0.0261,15.0,0.1295723841119613
8436,19945,-31645,7,6,13,53.85,0.011215384615384615,16.692307692307693,0.23667581048167777
8437,9028,-18528,6,3,9,66.67,-0.008644444444444444,14.777777777777779,0.20172655479000923
8440,0,0,0,0,0,0.0,,,
8444,4084,-2284,2,5,7,28.57,-0.008771428571428572,27.142857142857142,0.2614317452282375
8446,3506,-68406,1,5,6,16.67,-0.09661666666666667,15.333333333333334,0.2753384878544334
8450,1489,11911,2,2,4,50.0,0.04357500000000001,30.75,0.24482344579412302
8455,173,-773,0,1,1,0.0,-0.0258,12.0,0.08650252878323261
8472,389,-7689,0,1,1,0.0,-0.1068,13.0,0.39912016427978325
8476,447,2753,1,2,3,33.33,0.0095,24.0,0.22889527215319685
8477,255,-55,0,1,1,0.0,-0.0013,47.0,0.09479557725662602
8489,8401,26579,3,5,8,37.5,0.009437499999999998,25.75,0.20325366494594094
8905,1520,4830,11,6,17,64.71,0.02677058823529412,22.647058823529413,0.20441899109497144
8906,887,-2747,4,11,15,26.67,-0.019073333333333334,22.2,0.18266239079173316
8908,0,0,0,0,0,0.0,,,
8916,417,-567,3,3,6,50.0,-0.009150000000000004,14.666666666666666,0.13464113179210854
8917,0,0,0,0,0,0.0,,,
8921,383,-3193,0,6,6,0.0,-0.05971666666666666,9.333333333333334,0.14937148526776148
8923,87,713,1,0,1,100.0,0.0499,45.0,0.11194715895202534
8924,1249,-8199,2,7,9,22.22,-0.017444444444444446,17.333333333333332,0.24180574778450412
8927,0,0,0,0,0,0.0,,,
8928,1323,-5823,4,12,16,25.0,-0.021862499999999997,20.5,0.2158987533272898
8929,194,-934,0,4,4,0.0,-0.0846,16.75,0.21641209815136364
8930,459,-1809,1,5,6,16.67,-0.023683333333333334,13.0,0.1683577468705931
8931,233,67,1,2,3,33.33,0.0013000000000000002,28.0,0.2536759440145096
8932,1292,-2352,6,12,18,33.33,-0.013488888888888885,14.88888888888889,0.2037061951950122
8933,1934,-3154,9,15,24,37.5,-0.001108333333333335,21.0,0.22882454628007723
8935,620,-3110,4,6,10,40.0,0.011769999999999997,19.4,0.226974614546754
8936,3455,4415,8,15,23,34.78,0.014208695652173914,16.956521739130434,0.25846902027603774
8937,669,3681,4,2,6,66.67,0.04485,24.333333333333332,0.21331433853665369
8938,3707,12193,3,9,12,25.0,0.029550000000000007,19.166666666666668,0.20166246131399887
8941,8356,13034,8,13,21,38.1,0.03905714285714286,14.047619047619047,0.20724997263313152
8942,7703,-8653,8,16,24,33.33,0.012466666666666668,21.75,0.18593116631899895
9949,1397,-4147,5,7,12,41.67,-0.011591666666666665,18.5,0.18210688492348126
9950,1062,-7282,1,10,11,9.09,-0.03948181818181819,13.545454545454545,0.14112619929634582
9951,10048,-46998,6,11,17,35.29,-0.02919411764705883,15.764705882352942,0.2294024716890003
9960,1564,-13964,2,8,10,20.0,-0.027950000000000003,23.4,0.17730682140191484
9962,453,-3053,2,3,5,40.0,-0.008679999999999993,32.6,0.2699332817248411
8916A,0,0,0,0,0,0.0,,,
4148,4107,-31707,1,9,10,10.0,-0.0364,24.9,0.24313679311379904
6781,0,0,0,0,0,0.0,,,
6776,0,0,0,0,0,0.0,,,
2211,297,-3447,0,1,1,0.0,-0.0649,34.0,0.12400110670956788
6768,388,912,1,0,1,100.0,0.0139,14.0,0.22064322869974107
3357,120,-120,0,1,1,0.0,-0.0059,5.0,0.22896194290931104
6741,3622,-54622,0,3,3,0.0,-0.06949999999999999,10.666666666666666,0.43974035867791517
2250,1763,-24763,0,2,2,0.0,-0.0733,8.5,0.38571954341908854
5236,676,-7176,0,1,1,0.0,-0.0596,4.0,0.212637808339472
1522A,0,0,0,0,0,0.0,,,
6684,1436,-15836,0,2,2,0.0,-0.0587,7.0,0.39950221607458547
2753,752,7748,1,0,1,100.0,0.0635,32.0,0.08543063027196074
2348A,0,0,0,0,0,0.0,,,
6790,0,0,0,0,0,0.0,,,
6788,1848,10152,1,1,2,50.0,0.023400000000000004,22.5,0.38989752162269253
2947,0,0,0,0,0,0.0,,,
4440,248,-2098,0,1,1,0.0,-0.0478,25.0,0.18568079936348747
5222,108,-748,0,1,1,0.0,-0.0397,4.0,0.14155182273166145
2881C,0,0,0,0,0,0.0,,,
6761,768,-10268,0,1,1,0.0,-0.0741,7.0,0.3487933019035485
6806,0,0,0,0,0,0.0,,,
2945,0,0,0,0,0,0.0,,,
6770,0,0,0,0,0,0.0,,,
6792,0,0,0,0,0,0.0,,,
4770,1392,-21392,0,1,1,0.0,-0.0846,6.0,0.11109846225817432
2883B,0,0,0,0,0,0.0,,,
6691,2097,8403,1,1,2,50.0,0.023,13.0,0.182646345501288
3592,1963,2437,1,2,3,33.33,0.05526666666666666,24.666666666666668,0.2853239188242423
6719,0,0,0,0,0,0.0,,,
2756,0,0,0,0,0,0.0,,,
5244,138,162,1,0,1,100.0,0.0069,17.0,0.12366506906798214
6693,0,0,0,0,0,0.0,,,
8112A,0,0,0,0,0,0.0,,,
8438,0,0,0,0,0,0.0,,,
6829,0,0,0,0,0,0.0,,,
4923,0,0,0,0,0,0.0,,,
6763,0,0,0,0,0,0.0,,,
4558,0,0,0,0,0,0.0,,,
3349,0,0,0,0,0,0.0,,,
6804,0,0,0,0,0,0.0,,,
4768,0,0,0,0,0,0.0,,,
6807,0,0,0,0,0,0.0,,,
6721,0,0,0,0,0,0.0,,,
6735,0,0,0,0,0,0.0,,,
4583,0,0,0,0,0,0.0,,,
6799,0,0,0,0,0,0.0,,,
6585,350,-350,0,1,1,0.0,-0.0058,2.0,0.10524174447585866
5228,466,-2936,0,3,3,0.0,-0.034833333333333334,6.333333333333333,0.1409295954227522
6546,792,-7332,0,2,2,0.0,-0.0532,4.0,0.4437981269730178
6796,0,0,0,0,0,0.0,,,
6550,519,-9859,0,2,2,0.0,-0.13635,13.0,0.14744863111917728
4577,0,0,0,0,0,0.0,,,
6789,0,0,0,0,0,0.0,,,
6823,0,0,0,0,0,0.0,,,
