代號,總成本,總損益(淨),獲利次數,損失次數,總交易次數,勝率%,平均持倉時間(日)
1101,8653,-16203,19,23,42,45.24,62.0
1102,8692,-20642,19,24,43,44.19,45.7906976744186
1103,4495,155,23,19,42,54.76,46.42857142857143
1104,4884,-17834,17,26,43,39.53,41.25581395348837
1108,3280,-170,23,23,46,50.0,37.26086956521739
1109,3310,-10780,17,20,37,45.95,65.48648648648648
1110,3746,8334,25,20,45,55.56,43.0
1201,7446,-43896,17,32,49,34.69,27.816326530612244
1203,5719,-4379,23,23,46,50.0,60.95652173913044
1210,9236,-6076,24,27,51,47.06,42.588235294117645
1213,3632,-18382,15,21,36,41.67,26.333333333333332
1215,8790,-37430,18,31,49,36.73,47.816326530612244
1216,10524,-17324,18,24,42,42.86,62.166666666666664
1217,3026,-2226,23,19,42,54.76,30.833333333333332
1218,5035,-11185,27,27,54,50.0,20.703703703703702
1219,3970,-10320,22,24,46,47.83,58.84782608695652
1220,3237,-6867,21,23,44,47.73,49.88636363636363
1225,9592,-66572,22,36,58,37.93,25.879310344827587
1227,14572,-37572,18,30,48,37.5,45.020833333333336
1229,7498,-22598,22,27,49,44.9,53.16326530612245
1231,8169,-35489,14,30,44,31.82,54.47727272727273
1232,12445,-109095,11,25,36,30.56,103.77777777777777
1233,5206,-20356,11,15,26,42.31,127.61538461538461
1234,5212,5718,20,18,38,52.63,84.92105263157895
1235,9886,-18236,20,31,51,39.22,39.76470588235294
1236,4919,-9819,20,21,41,48.78,53.90243902439025
1256,39870,-122370,12,17,29,41.38,24.20689655172414
1301,18175,26125,21,17,38,55.26,88.1842105263158
1303,15029,-28329,17,22,39,43.59,70.84615384615384
1304,5571,-14251,21,27,48,43.75,26.75
1305,5629,-34249,20,32,52,38.46,17.826923076923077
1307,6435,-6785,21,17,38,55.26,41.60526315789474
1308,7509,-2709,22,25,47,46.81,31.659574468085108
1309,5136,-16956,23,32,55,41.82,21.836363636363636
1310,5080,-11720,21,26,47,44.68,26.74468085106383
1312,6127,-11037,27,32,59,45.76,24.406779661016948
1313,5222,-4292,25,27,52,48.08,32.26923076923077
1314,5455,-11105,25,34,59,42.37,21.71186440677966
1315,7284,-18484,20,23,43,46.51,66.20930232558139
1316,4774,-5344,31,27,58,53.45,15.60344827586207
1319,10932,-57682,17,29,46,36.96,31.5
1321,7121,-7021,23,26,49,46.94,31.918367346938776
1323,5223,-11903,17,22,39,43.59,54.17948717948718
1324,3671,-10971,21,17,38,55.26,45.473684210526315
1325,9721,-193571,15,31,46,32.61,35.30434782608695
1326,16674,-86424,14,24,38,36.84,76.71052631578948
1337,3766,18344,8,5,13,61.54,24.076923076923077
1338,8526,35674,10,5,15,66.67,40.86666666666667
1339,5198,-29148,7,10,17,41.18,34.23529411764706
1340,1736,33664,6,0,6,100.0,19.333333333333332
1341,3256,-8656,3,5,8,37.5,62.875
1342,1528,2972,2,2,4,50.0,28.75
1402,9530,25520,26,25,51,50.98,46.86274509803921
1409,3840,-6710,25,26,51,49.02,32.35294117647059
1410,5061,-29961,17,29,46,36.96,45.97826086956522
1413,3122,-2882,25,27,52,48.08,20.192307692307693
1414,3777,-5547,27,28,55,49.09,19.581818181818182
1416,3705,-17035,19,29,48,39.58,38.5625
1417,3089,1121,21,25,46,45.65,21.73913043478261
1418,3750,-8680,26,32,58,44.83,15.517241379310345
1419,8246,-7196,20,24,44,45.45,55.81818181818182
1423,3664,376,27,25,52,51.92,37.21153846153846
1432,3839,-22639,21,25,46,45.65,14.0
1434,5961,-15961,15,22,37,40.54,58.2972972972973
1435,5569,-15889,27,37,64,42.19,18.109375
1436,6498,-24318,20,25,45,44.44,41.644444444444446
1437,6385,-26605,20,34,54,37.04,31.40740740740741
1438,3440,-3070,24,34,58,41.38,13.810344827586206
1439,6401,-87751,15,31,46,32.61,21.456521739130434
1440,4145,-20265,18,28,46,39.13,34.52173913043478
1441,2992,-13512,21,24,45,46.67,17.933333333333334
1442,5624,9746,28,21,49,57.14,37.795918367346935
1443,2894,-2794,23,25,48,47.92,22.333333333333332
1444,3620,1400,26,26,52,50.0,24.76923076923077
1445,2890,-8610,18,26,44,40.91,33.59090909090909
1446,5482,-14432,22,30,52,42.31,22.78846153846154
1447,3641,-12121,20,32,52,38.46,25.134615384615383
1449,3409,11181,28,30,58,48.28,9.637931034482758
1451,4457,8493,20,14,34,58.82,81.55882352941177
1452,5148,-6188,27,25,52,51.92,43.69230769230769
1453,3548,-22728,23,24,47,48.94,26.78723404255319
1454,2648,1652,21,19,40,52.5,51.3
1455,3944,-23744,16,33,49,32.65,23.244897959183675
1456,3979,4611,37,23,60,61.67,13.516666666666667
1457,3601,-5081,24,28,52,46.15,30.153846153846153
1459,3470,-1820,23,24,47,48.94,21.76595744680851
1460,3087,-197,22,22,44,50.0,29.363636363636363
1463,3360,-29600,11,32,43,25.58,32.093023255813954
1464,4623,-18983,20,29,49,40.82,27.93877551020408
1465,3364,-6694,20,20,40,50.0,37.175
1466,5162,-5902,27,29,56,48.21,15.589285714285714
1467,3651,-20681,16,27,43,37.21,24.488372093023255
1468,2636,-3506,18,13,31,58.06,58.645161290322584
1470,4055,-6835,23,25,48,47.92,31.75
1471,6414,-41034,19,31,50,38.0,10.56
1472,5634,-11584,27,26,53,50.94,11.452830188679245
1473,7832,-25282,16,22,38,42.11,40.44736842105263
1474,2841,-6071,17,21,38,44.74,47.36842105263158
1475,9570,-27450,23,33,56,41.07,12.446428571428571
1476,69531,-183781,27,41,68,39.71,32.48529411764706
1477,40227,-211527,15,35,50,30.0,50.14
1503,6460,-25610,14,17,31,45.16,114.45161290322581
1504,5864,-9784,18,27,45,40.0,53.75555555555555
1506,4442,-15642,20,24,44,45.45,28.113636363636363
1512,2712,-5902,19,21,40,47.5,20.325
1513,6537,-29387,21,24,45,46.67,58.75555555555555
1514,4394,-5314,26,27,53,49.06,26.41509433962264
1515,10892,-76022,26,39,65,40.0,16.338461538461537
1516,4740,-12420,20,27,47,42.55,15.574468085106384
1517,4250,-5870,24,25,49,48.98,23.612244897959183
1519,7495,-19675,21,26,47,44.68,24.51063829787234
1521,11480,11220,21,19,40,52.5,48.675
1522,6057,-20307,16,24,40,40.0,35.35
1524,3209,-2439,19,20,39,48.72,26.923076923076923
1525,14973,4027,22,22,44,50.0,21.727272727272727
1526,8806,-56586,28,35,63,44.44,12.46031746031746
1527,13134,-54034,18,27,45,40.0,43.53333333333333
1528,3743,-4993,23,22,45,51.11,27.622222222222224
1529,4116,5594,29,25,54,53.7,10.277777777777779
1530,11379,-41379,20,29,49,40.82,37.16326530612245
1531,6814,5986,22,21,43,51.16,39.30232558139535
1532,11137,-73187,18,32,50,36.0,29.56
1533,11076,-52676,18,29,47,38.3,18.425531914893618
1535,8846,-44696,16,24,40,40.0,54.6
1536,17526,9324,22,30,52,42.31,28.442307692307693
1537,18788,-7288,18,26,44,40.91,59.56818181818182
1538,8811,-8671,24,28,52,46.15,16.903846153846153
1539,5093,-9933,23,25,48,47.92,19.0
1540,5575,-13375,19,22,41,46.34,38.609756097560975
1541,8389,-24369,20,29,49,40.82,14.693877551020408
1558,20062,-91612,11,19,30,36.67,84.66666666666667
1560,24503,-52003,24,28,52,46.15,23.826923076923077
1568,3273,-20723,6,12,18,33.33,19.444444444444443
1582,10810,-41010,11,14,25,44.0,72.92
1583,9807,-20107,16,14,30,53.33,29.466666666666665
1587,3241,-10491,10,12,22,45.45,33.95454545454545
1589,19533,-23233,11,19,30,36.67,18.666666666666668
1590,101472,-296972,15,22,37,40.54,26.18918918918919
1597,14407,-25107,12,15,27,44.44,13.25925925925926
1598,6859,-35159,6,10,16,37.5,26.5
1603,4799,-24189,17,35,52,32.69,34.96153846153846
1604,3670,-7150,20,22,42,47.62,44.38095238095238
1605,5576,-4736,27,27,54,50.0,31.444444444444443
1608,3719,-3869,20,28,48,41.67,34.833333333333336
1609,3825,-11765,23,25,48,47.92,33.520833333333336
1611,4931,-10651,26,25,51,50.98,23.294117647058822
1612,5502,-22732,24,32,56,42.86,25.857142857142858
1614,7181,-11281,22,20,42,52.38,49.38095238095238
1615,5119,-20859,21,30,51,41.18,30.607843137254903
1616,3121,-11981,19,27,46,41.3,17.565217391304348
1617,2869,-489,18,17,35,51.43,36.142857142857146
1618,4603,-15043,21,30,51,41.18,21.019607843137255
1626,2181,-1281,6,7,13,46.15,21.846153846153847
1701,4986,-26236,17,27,44,38.64,35.68181818181818
1702,9513,28117,26,30,56,46.43,36.857142857142854
1707,29190,-189030,23,40,63,36.51,23.126984126984127
1708,8894,-30064,21,28,49,42.86,40.59183673469388
1709,3862,-9962,16,22,38,42.11,64.8157894736842
1710,7655,-22005,18,25,43,41.86,35.674418604651166
1711,6102,-3412,24,23,47,51.06,35.723404255319146
1712,4016,-22056,16,28,44,36.36,70.0909090909091
1713,3912,-8112,21,22,43,48.84,64.44186046511628
1714,3266,2904,22,20,42,52.38,32.69047619047619
1717,7460,6040,21,18,39,53.85,58.97435897435897
1718,3800,-360,25,23,48,52.08,18.708333333333332
1720,7443,-44693,13,26,39,33.33,61.8974358974359
1721,3271,-15781,20,21,41,48.78,15.902439024390244
1722,20474,-15824,23,27,50,46.0,44.7
1723,24103,-121703,14,26,40,35.0,57.375
1725,5736,29064,26,17,43,60.47,51.83720930232558
1726,10875,-27625,13,20,33,39.39,112.12121212121212
1727,5407,-17897,24,21,45,53.33,30.555555555555557
1730,7877,-2077,21,24,45,46.67,41.111111111111114
1731,4223,7677,24,17,41,58.54,40.51219512195122
1732,5329,1781,27,20,47,57.45,24.574468085106382
1733,11056,-12156,18,18,36,50.0,39.27777777777778
1734,7537,-21087,21,20,41,51.22,36.951219512195124
1735,3108,3102,18,15,33,54.55,60.15151515151515
1736,24048,-107448,16,30,46,34.78,22.630434782608695
1737,4808,-14208,15,17,32,46.88,48.8125
1760,32036,-182116,19,29,48,39.58,13.083333333333334
1762,6775,44325,15,8,23,65.22,17.08695652173913
1773,16459,-146259,10,24,34,29.41,54.64705882352941
1776,1229,4471,6,4,10,60.0,53.9
1783,4047,-7997,10,8,18,55.56,12.055555555555555
1786,5490,6960,7,5,12,58.33,11.0
1789,5238,-13488,8,8,16,50.0,33.0
1795,21130,-56230,19,22,41,46.34,15.75609756097561
1802,7369,4181,22,22,44,50.0,26.0
1805,3183,-12353,25,20,45,55.56,11.555555555555555
1806,4666,-13846,27,31,58,46.55,19.775862068965516
1808,10777,-46557,23,29,52,44.23,29.442307692307693
1809,4679,-11019,24,28,52,46.15,14.557692307692308
1810,3479,321,23,24,47,48.94,39.808510638297875
1817,2538,-788,5,6,11,45.45,67.45454545454545
1903,13629,-4329,23,26,49,46.94,21.693877551020407
1904,4727,-24097,18,28,46,39.13,53.108695652173914
1905,4759,481,28,21,49,57.14,26.93877551020408
1906,4768,-12648,22,34,56,39.29,18.607142857142858
1907,4843,-6073,24,24,48,50.0,31.854166666666668
1909,5904,-36024,21,37,58,36.21,27.775862068965516
2002,5674,-8474,14,16,30,46.67,103.0
2006,9598,-68548,15,34,49,30.61,44.285714285714285
2007,3700,-15920,25,28,53,47.17,11.49056603773585
2008,4192,-8762,23,31,54,42.59,23.75925925925926
2009,5775,-24315,27,31,58,46.55,20.189655172413794
2010,3550,8220,21,15,36,58.33,72.94444444444444
2012,4361,-18401,19,29,48,39.58,33.854166666666664
2013,7368,-44018,16,29,45,35.56,32.4
2014,5446,-23816,21,30,51,41.18,20.568627450980394
2015,14734,-42934,21,28,49,42.86,53.6530612244898
2017,4421,-20571,25,33,58,43.1,23.310344827586206
2020,6098,-17448,20,25,45,44.44,52.0
2022,3221,-10061,23,25,48,47.92,19.104166666666668
2023,5286,274,25,23,48,52.08,28.958333333333332
2024,3640,-16660,24,26,50,48.0,28.98
2025,3795,-7515,28,30,58,48.28,10.310344827586206
2027,10353,1447,31,31,62,50.0,22.467741935483872
2028,5434,-33864,24,38,62,38.71,17.532258064516128
2029,8010,-4660,19,23,42,45.24,47.333333333333336
2030,6590,-14390,26,28,54,48.15,20.666666666666668
2031,11801,-27351,25,31,56,44.64,28.178571428571427
2032,7185,-3275,31,27,58,53.45,16.775862068965516
2033,5046,-40586,20,26,46,43.48,28.08695652173913
2034,8247,-39947,20,28,48,41.67,40.729166666666664
2038,3594,-12164,15,14,29,51.72,13.931034482758621
2049,57655,-413955,11,30,41,26.83,26.48780487804878
2059,72261,-55761,22,22,44,50.0,42.0
2062,8087,-6987,13,18,31,41.94,33.54838709677419
2069,2578,-8178,7,9,16,43.75,17.8125
2101,11341,-18091,19,31,50,38.0,36.8
2102,5761,14089,24,22,46,52.17,20.847826086956523
2103,12472,2728,28,33,61,45.9,25.983606557377048
2104,6406,-5806,18,19,37,48.65,59.24324324324324
2105,12029,-44429,13,21,34,38.24,47.76470588235294
2106,8424,-26824,15,23,38,39.47,45.86842105263158
2107,6074,-2424,24,26,50,48.0,45.88
2108,10624,-42774,21,31,52,40.38,29.653846153846153
2109,3508,-8858,20,21,41,48.78,21.902439024390244
2114,14642,-42992,13,20,33,39.39,65.33333333333333
2115,4276,-14676,6,8,14,42.86,31.5
2201,8861,4139,22,17,39,56.41,46.69230769230769
2204,7415,-4265,18,17,35,51.43,50.857142857142854
2206,7529,-6949,26,30,56,46.43,31.767857142857142
2207,69813,-92113,22,29,51,43.14,61.07843137254902
2208,2666,15384,12,6,18,66.67,58.5
2227,39951,-212551,13,24,37,35.14,42.027027027027025
2228,11619,-30719,6,8,14,42.86,27.5
2231,48678,-63578,17,25,42,40.48,24.11904761904762
2233,18183,24917,16,13,29,55.17,20.724137931034484
2236,2933,-11183,5,7,12,41.67,18.0
2239,6553,38247,5,3,8,62.5,24.25
2241,2806,-12926,2,3,5,40.0,6.8
2243,805,9845,7,1,8,87.5,8.25
2247,0,0,0,0,0,0.0,
2301,10046,-12096,18,21,39,46.15,51.02564102564103
2302,3844,-6614,29,29,58,50.0,14.89655172413793
2303,6691,11909,26,23,49,53.06,31.877551020408163
2305,3351,3719,29,23,52,55.77,14.75
2308,36752,-74852,20,28,48,41.67,48.583333333333336
2312,3360,16900,27,15,42,64.29,38.61904761904762
2313,7264,-37674,20,34,54,37.04,24.59259259259259
2314,9004,-19184,30,27,57,52.63,15.192982456140351
2316,6107,-38067,19,32,51,37.25,21.784313725490197
2317,31043,-81343,18,22,40,45.0,42.175
2321,3351,489,28,18,46,60.87,12.652173913043478
2323,2980,100,18,19,37,48.65,23.7027027027027
2324,6821,8729,20,17,37,54.05,58.648648648648646
2327,78371,-595091,24,44,68,35.29,25.397058823529413
2328,11271,-72371,18,26,44,40.91,16.272727272727273
2329,4560,-31210,19,43,62,30.65,15.96774193548387
2330,48048,-293348,15,28,43,34.88,85.46511627906976
2331,5123,-16483,20,28,48,41.67,22.25
2332,7653,12697,23,19,42,54.76,27.023809523809526
2337,7318,-3538,29,29,58,50.0,18.844827586206897
2338,7469,-23639,20,23,43,46.51,38.48837209302326
2340,7745,-32575,23,35,58,39.66,22.70689655172414
2342,7676,-42056,24,35,59,40.68,7.5423728813559325
2344,5171,-5741,25,28,53,47.17,19.71698113207547
2345,25284,3296,25,34,59,42.37,25.35593220338983
2347,13922,9028,20,21,41,48.78,47.51219512195122
2348,11799,11131,31,28,59,52.54,13.40677966101695
2349,2582,-9932,17,18,35,48.57,11.228571428571428
2351,18255,-37905,29,40,69,42.03,20.217391304347824
2352,5939,-8709,19,26,45,42.22,32.8
2353,11794,-48394,17,27,44,38.64,37.84090909090909
2354,35768,-197468,15,32,47,31.91,30.70212765957447
2355,9024,-18174,18,27,45,40.0,41.266666666666666
2356,5360,1640,22,21,43,51.16,37.27906976744186
2357,54410,224090,26,19,45,57.78,50.022222222222226
2358,5354,146,31,25,56,55.36,11.964285714285714
2359,5434,-574,27,27,54,50.0,28.462962962962962
2360,28160,-49910,25,32,57,43.86,31.263157894736842
2362,10333,-16183,23,27,50,46.0,21.68
2363,3645,4895,21,18,39,53.85,18.641025641025642
2364,3104,-8794,26,22,48,54.17,10.520833333333334
2365,5338,-13408,17,21,38,44.74,28.57894736842105
2367,5343,-30743,18,30,48,37.5,18.541666666666668
2368,9829,5471,29,38,67,43.28,21.17910447761194
2369,5379,-9389,25,29,54,46.3,20.814814814814813
2371,6058,2572,30,26,56,53.57,14.321428571428571
2373,9636,-61536,14,23,37,37.84,85.91891891891892
2374,8238,-46938,16,29,45,35.56,34.46666666666667
2375,9438,-94098,20,36,56,35.71,20.803571428571427
2376,17062,-64212,20,34,54,37.04,31.944444444444443
2377,20178,-127128,17,37,54,31.48,28.40740740740741
2379,46906,-147856,24,31,55,43.64,29.272727272727273
2380,4129,-3809,21,21,42,50.0,17.452380952380953
2382,15840,20160,22,18,40,55.0,48.125
2383,30543,-20043,28,40,68,41.18,28.41176470588235
2385,16426,-27276,20,22,42,47.62,54.26190476190476
2387,8550,12950,22,23,45,48.89,24.266666666666666
2388,11401,6009,31,28,59,52.54,11.23728813559322
2390,5172,-24342,20,30,50,40.0,13.3
2392,16830,25920,22,20,42,52.38,29.38095238095238
2393,20564,-9114,24,27,51,47.06,26.88235294117647
2395,42324,-205924,16,28,44,36.36,60.13636363636363
2397,13470,-68220,18,28,46,39.13,38.30434782608695
2399,6501,-12381,28,29,57,49.12,14.736842105263158
2401,7948,-53498,25,22,47,53.19,23.893617021276597
2402,8716,-18216,28,26,54,51.85,19.685185185185187
2404,21688,-11838,22,32,54,40.74,37.31481481481482
2405,6350,-26770,20,31,51,39.22,13.882352941176471
2406,7837,-38717,27,35,62,43.55,13.53225806451613
2408,14860,-12780,28,31,59,47.46,24.47457627118644
2409,8005,-23705,20,26,46,43.48,27.065217391304348
2412,11559,-43959,11,14,25,44.0,195.68
2413,6149,-8979,27,27,54,50.0,14.944444444444445
2414,4623,-25723,14,25,39,35.9,64.64102564102564
2415,7078,-4338,28,27,55,50.91,17.181818181818183
2417,9549,-68399,17,31,48,35.42,23.083333333333332
2419,5140,9810,25,24,49,51.02,26.408163265306122
2420,8554,-12654,20,26,46,43.48,31.130434782608695
2421,8672,-2772,25,22,47,53.19,30.5531914893617
2423,4847,-25297,13,22,35,37.14,56.48571428571429
2424,5547,27003,29,14,43,67.44,23.302325581395348
2425,7956,-16016,27,31,58,46.55,12.620689655172415
2426,6803,-16513,27,29,56,48.21,16.910714285714285
2427,3109,-10029,18,21,39,46.15,25.53846153846154
2428,19299,-145349,22,32,54,40.74,35.7037037037037
2429,4485,-7965,22,20,42,52.38,19.333333333333332
2430,10140,3360,22,21,43,51.16,38.16279069767442
2431,4574,10366,28,23,51,54.9,22.333333333333332
2433,6842,-5392,19,20,40,47.5,84.175
2434,6546,-9826,30,24,54,55.56,14.296296296296296
2436,10706,-24106,26,29,55,47.27,18.527272727272727
2438,3388,-5908,25,25,50,50.0,13.54
2439,35543,-91043,24,35,59,40.68,19.06779661016949
2440,3923,-5933,27,26,53,50.94,20.09433962264151
2441,12018,-38168,21,27,48,43.75,51.041666666666664
2442,3825,-9065,22,27,49,44.9,26.693877551020407
2443,3597,-5117,27,29,56,48.21,10.982142857142858
2444,5960,-25470,24,34,58,41.38,13.0
2449,9874,20406,35,27,62,56.45,33.08064516129032
2450,14607,-92557,17,27,44,38.64,38.63636363636363
2451,22547,-43547,20,21,41,48.78,41.1219512195122
2453,4629,-11919,24,25,49,48.98,19.489795918367346
2454,144487,-639487,21,32,53,39.62,33.0188679245283
2455,27203,-69983,29,50,79,36.71,16.151898734177216
2457,8867,-12217,27,34,61,44.26,15.721311475409836
2458,21871,-66821,25,34,59,42.37,30.508474576271187
2459,9829,-8129,20,24,44,45.45,55.04545454545455
2460,7158,-12828,26,26,52,50.0,20.346153846153847
2461,6421,5479,24,24,48,50.0,23.708333333333332
2462,8122,4528,25,25,50,50.0,33.86
2464,9330,7020,23,22,45,51.11,40.422222222222224
2465,7465,-35295,29,32,61,47.54,8.278688524590164
2466,6486,-24636,18,21,39,46.15,51.333333333333336
2467,8038,-488,28,24,52,53.85,30.76923076923077
2468,3179,-2689,17,21,38,44.74,41.86842105263158
2471,5130,-13950,19,29,48,39.58,27.125
2472,9852,-21072,24,29,53,45.28,26.50943396226415
2474,73191,-204191,21,37,58,36.21,28.03448275862069
2476,10243,-10343,22,25,47,46.81,38.57446808510638
2477,7924,47836,35,20,55,63.64,24.345454545454544
2478,16837,-185987,22,36,58,37.93,15.241379310344827
2480,8507,-29007,19,23,42,45.24,58.42857142857143
2481,14994,-23194,35,36,71,49.3,19.929577464788732
2482,7088,-25938,26,23,49,53.06,14.653061224489797
2483,5529,1471,22,23,45,48.89,28.022222222222222
2484,7271,20569,33,24,57,57.89,29.210526315789473
2485,14757,-91657,23,28,51,45.1,23.80392156862745
2486,9733,-19223,26,31,57,45.61,20.94736842105263
2488,7039,-589,21,22,43,48.84,31.11627906976744
2489,7550,-4160,27,26,53,50.94,27.60377358490566
2491,5053,-4373,26,34,60,43.33,9.533333333333333
2492,30945,-164395,34,32,66,51.52,22.075757575757574
2493,5843,-14633,19,25,44,43.18,47.97727272727273
2495,10681,669,21,20,41,51.22,29.658536585365855
2496,13433,43157,33,24,57,57.89,9.68421052631579
2497,12596,-104646,18,36,54,33.33,19.703703703703702
2498,132052,-917302,20,32,52,38.46,19.826923076923077
2501,5519,-14909,21,30,51,41.18,32.529411764705884
2504,4760,1220,23,29,52,44.23,31.98076923076923
2505,7012,8048,38,28,66,57.58,20.742424242424242
2506,2987,-5437,23,25,48,47.92,22.645833333333332
2509,6279,-28509,20,25,45,44.44,31.333333333333332
2511,4654,-7504,22,28,50,44.0,35.3
2514,5306,-29326,21,33,54,38.89,22.296296296296298
2515,2760,-7000,17,26,43,39.53,31.25581395348837
2516,2756,-1906,20,24,44,45.45,29.5
2520,7745,-9415,21,35,56,37.5,21.910714285714285
2524,9577,-22877,25,28,53,47.17,36.60377358490566
2527,6589,-1419,34,31,65,52.31,22.46153846153846
2528,4197,-13877,24,34,58,41.38,11.155172413793103
2530,4084,-8854,29,29,58,50.0,31.46551724137931
2534,7185,-16535,24,34,58,41.38,34.53448275862069
2535,5993,-24243,26,29,55,47.27,34.10909090909091
2536,8503,13697,30,20,50,60.0,44.82
2537,3112,-4972,21,23,44,47.73,19.363636363636363
2538,6042,-3552,32,29,61,52.46,24.950819672131146
2539,6091,-4291,20,23,43,46.51,56.86046511627907
2540,9204,-12794,26,26,52,50.0,14.692307692307692
2542,12906,15734,27,32,59,45.76,35.13559322033898
2543,2821,-5391,18,22,40,45.0,24.975
2545,17874,-39574,27,38,65,41.54,23.415384615384614
2546,7080,-19920,27,29,56,48.21,50.07142857142857
2547,8511,-12881,25,30,55,45.45,15.290909090909091
2548,20667,-52367,23,35,58,39.66,38.275862068965516
2597,11382,-102482,9,20,29,31.03,46.96551724137931
2601,11546,16104,30,32,62,48.39,15.693548387096774
2603,15246,-22546,28,34,62,45.16,23.193548387096776
2605,9059,591,25,24,49,51.02,30.857142857142858
2606,18252,-4552,29,31,60,48.33,36.03333333333333
2607,5313,-30463,16,27,43,37.21,31.069767441860463
2608,8068,-23188,25,26,51,49.02,47.68627450980392
2609,13132,-121172,20,41,61,32.79,20.688524590163933
2610,4523,-2893,21,25,46,45.65,28.5
2611,3907,-28947,17,26,43,39.53,33.81395348837209
2612,16948,-29198,31,32,63,49.21,19.41269841269841
2613,6020,-590,30,24,54,55.56,24.0
2614,5303,-24013,20,36,56,35.71,17.089285714285715
2615,17539,-121439,24,36,60,40.0,23.716666666666665
2616,4736,-26086,12,25,37,32.43,92.43243243243244
2617,10711,-97211,18,36,54,33.33,24.11111111111111
2618,6091,11859,30,22,52,57.69,33.36538461538461
2630,505,-755,3,1,4,75.0,16.0
2633,1658,-9058,3,6,9,33.33,72.88888888888889
2634,1905,-5305,4,5,9,44.44,95.44444444444444
2636,13980,-28780,21,19,40,52.5,24.775
2637,8296,-19546,12,14,26,46.15,55.38461538461539
2642,5586,-45686,6,10,16,37.5,20.5
2701,2507,-3757,13,14,27,48.15,87.66666666666667
2702,6315,-22115,18,27,45,40.0,22.444444444444443
2704,8084,2216,19,26,45,42.22,47.666666666666664
2705,4707,-777,23,21,44,52.27,20.59090909090909
2706,5437,5013,19,17,36,52.78,56.05555555555556
2707,66998,-170098,18,23,41,43.9,41.5609756097561
2712,2909,-3459,5,8,13,38.46,105.61538461538461
2722,2126,19974,8,2,10,80.0,90.2
2723,33100,-128600,9,14,23,39.13,23.130434782608695
2727,19220,-8020,8,9,17,47.06,40.11764705882353
2731,11380,-43380,7,11,18,38.89,27.444444444444443
2739,1792,5108,8,2,10,80.0,40.3
2748,2982,19418,7,2,9,77.78,35.666666666666664
2801,3900,2300,17,17,34,50.0,71.70588235294117
2809,5501,-17831,20,26,46,43.48,55.56521739130435
2812,2686,-7566,15,23,38,39.47,90.60526315789474
2816,4192,5358,18,19,37,48.65,39.45945945945946
2820,1926,-4966,12,14,26,46.15,173.57692307692307
2832,3485,1915,14,13,27,51.85,120.44444444444444
2834,2511,-3341,17,18,35,48.57,95.4
2836,3265,5865,18,16,34,52.94,94.70588235294117
2838,2354,-12914,12,21,33,36.36,82.48484848484848
2841,3638,-2598,23,23,46,50.0,29.869565217391305
2845,3251,7909,22,18,40,55.0,72.575
2849,3348,10422,25,16,41,60.98,43.51219512195122
2850,6384,-36034,17,29,46,36.96,73.02173913043478
2851,3519,-13219,13,21,34,38.24,84.94117647058823
2852,3411,-24541,14,23,37,37.84,75.29729729729729
2855,4158,-16108,16,23,39,41.03,65.41025641025641
2867,1134,11096,9,3,12,75.0,98.83333333333333
2880,4024,-9474,13,17,30,43.33,104.3
2881,8905,-36855,14,22,36,38.89,87.61111111111111
2882,11320,-26570,15,21,36,41.67,64.36111111111111
2883,2955,1905,19,18,37,51.35,59.4054054054054
2884,4187,-9487,16,20,36,44.44,88.38888888888889
2885,5553,4947,27,24,51,52.94,51.8235294117647
2886,5237,-20187,15,22,37,40.54,88.43243243243244
2887,3818,-4288,17,20,37,45.95,73.21621621621621
2888,4441,-11061,18,24,42,42.86,46.5
2889,2494,-12764,11,23,34,32.35,90.73529411764706
2890,2908,8872,20,15,35,57.14,84.74285714285715
2891,5433,4417,18,19,37,48.65,88.4054054054054
2892,3924,5526,15,14,29,51.72,119.17241379310344
2897,319,-2039,2,3,5,40.0,81.2
2901,6311,10239,25,15,40,62.5,47.4
2903,7529,-42529,16,30,46,34.78,39.80434782608695
2904,4097,-8597,18,23,41,43.9,48.51219512195122
2905,5927,12563,24,26,50,48.0,25.0
2906,2883,-12953,15,20,35,42.86,67.62857142857143
2908,4281,4519,17,16,33,51.52,78.96969696969697
2910,9843,-7293,25,26,51,49.02,20.686274509803923
2911,5120,-12670,20,21,41,48.78,24.878048780487806
2912,35181,-99181,16,24,40,40.0,72.45
2913,5003,-15223,23,27,50,46.0,29.76
2915,18796,46354,28,28,56,50.0,31.035714285714285
2923,3101,-9951,10,9,19,52.63,32.36842105263158
2929,7231,-37531,5,7,12,41.67,36.333333333333336
2936,1166,-10216,2,5,7,28.57,61.57142857142857
2939,2765,-16515,1,3,4,25.0,7.25
3002,5254,-8804,19,25,44,43.18,25.704545454545453
3003,13334,-62584,21,32,53,39.62,20.37735849056604
3004,12926,-44016,25,29,54,46.3,18.166666666666668
3005,8308,-27408,20,29,49,40.82,36.97959183673469
3006,25559,-85459,26,34,60,43.33,14.166666666666666
3008,634507,-1995007,27,37,64,42.19,29.421875
3010,13482,2068,20,20,40,50.0,81.3
3011,3797,-2267,23,23,46,50.0,14.369565217391305
3013,6601,-16031,26,23,49,53.06,20.693877551020407
3014,22378,2722,36,30,66,54.55,20.757575757575758
3015,8109,12941,21,19,40,52.5,45.75
3016,18252,-40102,33,33,66,50.0,13.424242424242424
3017,13137,-30837,22,33,55,40.0,24.490909090909092
3018,6768,-8658,27,21,48,56.25,16.208333333333332
3019,31454,68646,24,25,49,48.98,16.428571428571427
3021,2859,-1949,17,16,33,51.52,32.78787878787879
3022,14032,-10082,26,24,50,52.0,36.66
3023,21061,-32461,24,27,51,47.06,58.3921568627451
3024,3116,16454,18,18,36,50.0,28.583333333333332
3025,6115,-17835,25,31,56,44.64,16.821428571428573
3026,21553,-63103,21,25,46,45.65,41.41304347826087
3027,6085,-11825,28,27,55,50.91,15.654545454545454
3028,4626,-4726,16,19,35,45.71,74.31428571428572
3029,6924,-16904,23,30,53,43.4,28.943396226415093
3030,14161,-58911,21,29,50,42.0,40.4
3031,9565,-60185,16,30,46,34.78,25.08695652173913
3032,7465,5845,26,26,52,50.0,25.673076923076923
3033,5146,-3696,18,23,41,43.9,70.7560975609756
3034,58687,-250987,23,32,55,41.82,32.14545454545455
3035,30618,-56318,31,33,64,48.44,17.421875
3036,10965,-32115,24,24,48,50.0,55.666666666666664
3037,21718,-23918,33,33,66,50.0,22.863636363636363
3038,5251,-31101,17,34,51,33.33,19.313725490196077
3040,6864,-34874,21,25,46,45.65,20.782608695652176
3041,14071,-33321,27,28,55,49.09,14.4
3042,14933,-44783,24,28,52,46.15,37.13461538461539
3043,11038,-146728,13,34,47,27.66,13.25531914893617
3044,28137,-109737,23,31,54,42.59,45.2962962962963
3045,12474,-16774,14,16,30,46.67,138.96666666666667
3046,5531,-14381,28,27,55,50.91,14.163636363636364
3047,4736,-19236,22,25,47,46.81,17.0
3048,5623,6957,21,23,44,47.73,27.136363636363637
3049,5314,-7964,24,31,55,43.64,10.763636363636364
3050,3534,5636,22,23,45,48.89,21.88888888888889
3051,8698,-63978,17,38,55,30.91,11.10909090909091
3052,3509,2491,25,23,48,52.08,24.104166666666668
3054,6084,-7784,24,20,44,54.55,12.159090909090908
3055,7700,-18350,20,29,49,40.82,23.877551020408163
3056,5185,-49105,11,27,38,28.95,33.3421052631579
3057,7893,-4343,29,25,54,53.7,14.166666666666666
3058,4558,-14578,22,25,47,46.81,32.255319148936174
3059,11727,-27227,23,25,48,47.92,22.729166666666668
3060,16975,-53925,19,22,41,46.34,20.24390243902439
3062,9873,-47573,21,22,43,48.84,23.372093023255815
3090,10897,-14247,23,23,46,50.0,39.43478260869565
3094,6357,3593,19,16,35,54.29,20.17142857142857
3130,20727,-77727,10,17,27,37.04,82.11111111111111
3138,16789,-102059,18,19,37,48.65,28.756756756756758
3149,2739,-15249,5,12,17,29.41,7.0588235294117645
3164,8338,-2838,22,13,35,62.86,24.314285714285713
3167,7210,-460,12,11,23,52.17,22.652173913043477
3189,30966,-11416,25,28,53,47.17,24.962264150943398
3209,5905,-14955,16,21,37,43.24,62.78378378378378
3229,5799,2441,24,19,43,55.81,12.069767441860465
3231,9459,-49359,15,28,43,34.88,32.883720930232556
3257,12065,-3565,14,17,31,45.16,18.29032258064516
3266,4817,6783,20,18,38,52.63,27.526315789473685
3296,6935,-29185,17,19,36,47.22,19.0
3305,12283,-96283,12,23,35,34.29,27.17142857142857
3308,2874,-2934,17,15,32,53.12,11.96875
3311,14223,-95823,16,18,34,47.06,25.735294117647058
3312,3783,-27563,15,27,42,35.71,24.69047619047619
3321,1038,4962,6,4,10,60.0,8.7
3338,5150,-13600,9,9,18,50.0,18.166666666666668
3346,1843,-15543,2,5,7,28.57,12.428571428571429
3356,23723,-199073,17,18,35,48.57,37.285714285714285
3376,25816,-103316,17,18,35,48.57,25.514285714285716
3380,7172,2428,21,23,44,47.73,32.61363636363637
3383,5279,-43439,11,13,24,45.83,12.833333333333334
3406,93441,-194591,22,34,56,39.29,8.875
3413,25637,123963,14,10,24,58.33,14.5
3416,10453,1147,14,12,26,53.85,65.38461538461539
3419,5894,-5844,19,23,42,45.24,24.142857142857142
3432,2478,4872,16,10,26,61.54,14.576923076923077
3437,3336,3064,10,8,18,55.56,15.722222222222221
3443,65626,87574,22,21,43,51.16,19.837209302325583
3450,22856,-24456,24,27,51,47.06,16.980392156862745
3454,26959,-71309,21,25,46,45.65,22.152173913043477
3481,7303,-60793,17,23,40,42.5,24.5
3494,4374,-28084,14,17,31,45.16,8.387096774193548
3501,7225,-11825,12,13,25,48.0,46.0
3504,26288,-97188,19,26,45,42.22,11.355555555555556
3515,26244,-154144,12,25,37,32.43,32.810810810810814
3518,9708,-6308,14,16,30,46.67,20.533333333333335
3528,4455,-13955,9,11,20,45.0,88.1
3530,17522,-43942,16,23,39,41.03,28.974358974358974
3532,30305,-102105,20,25,45,44.44,11.955555555555556
3533,71431,-32331,23,32,55,41.82,19.436363636363637
3535,4045,-9375,17,16,33,51.52,16.393939393939394
3536,2808,-8268,14,21,35,40.0,7.257142857142857
3543,4286,-9326,12,15,27,44.44,19.25925925925926
3545,18062,-24562,24,22,46,52.17,16.347826086956523
3550,2569,8381,15,10,25,60.0,22.68
3557,7788,-54288,20,20,40,50.0,11.475
3563,33668,-273368,11,22,33,33.33,25.272727272727273
3576,5398,-19008,15,15,30,50.0,16.9
3583,8662,-21662,8,12,20,40.0,24.15
3588,11172,-41272,16,15,31,51.61,10.67741935483871
3591,2447,2503,6,10,16,37.5,13.4375
3593,3656,-216,20,15,35,57.14,13.142857142857142
3596,14311,40639,22,14,36,61.11,25.22222222222222
3605,6394,-22994,12,17,29,41.38,29.06896551724138
3607,6174,-2074,10,12,22,45.45,24.90909090909091
3617,15116,-74016,12,16,28,42.86,33.142857142857146
3622,7282,-7782,12,10,22,54.55,18.59090909090909
3645,7853,-26653,10,16,26,38.46,19.96153846153846
3653,41721,55229,24,18,42,57.14,16.738095238095237
3661,77941,-585741,15,26,41,36.59,12.073170731707316
3665,32961,-241111,9,25,34,26.47,24.176470588235293
3669,6146,-34346,12,13,25,48.0,21.52
3673,29192,-180492,8,13,21,38.1,21.61904761904762
3679,11025,-52125,11,13,24,45.83,30.916666666666668
3682,679,3761,7,2,9,77.78,43.55555555555556
3686,2234,366,12,11,23,52.17,11.91304347826087
3694,3910,26540,20,8,28,71.43,13.5
3701,4947,-8457,19,24,43,44.19,33.093023255813954
3702,8467,-54517,14,24,38,36.84,62.86842105263158
3703,2261,-10291,11,12,23,47.83,76.6086956521739
3704,3413,-15263,10,16,26,38.46,24.923076923076923
3705,3280,-4580,6,5,11,54.55,101.9090909090909
3706,2560,-2160,6,8,14,42.86,56.57142857142857
3708,14730,-27330,10,11,21,47.62,13.047619047619047
3711,5140,-9440,5,5,10,50.0,33.6
3712,1372,-4872,4,3,7,57.14,7.285714285714286
3714,1643,7357,2,1,3,66.67,6.0
4104,13990,-7440,18,23,41,43.9,55.51219512195122
4106,8618,3482,25,18,43,58.14,25.13953488372093
4108,9238,6612,25,16,41,60.98,18.536585365853657
4119,19146,-19046,21,24,45,46.67,26.155555555555555
4133,8599,5751,13,10,23,56.52,20.391304347826086
4137,27079,-203579,5,15,20,25.0,21.95
4142,4565,22535,11,8,19,57.89,22.31578947368421
4155,5527,-54977,6,14,20,30.0,40.0
4164,4805,1645,8,9,17,47.06,29.294117647058822
4190,8180,18320,6,7,13,46.15,14.76923076923077
4306,5673,22227,27,20,47,57.45,37.06382978723404
4414,3883,11137,22,22,44,50.0,20.386363636363637
4426,13561,-50151,19,27,46,41.3,13.521739130434783
4438,6534,27966,5,3,8,62.5,58.75
4439,2720,-5220,1,2,3,33.33,24.333333333333332
4526,7677,673,20,19,39,51.28,45.61538461538461
4532,6180,9940,24,21,45,53.33,33.955555555555556
4536,10642,-30842,5,8,13,38.46,46.38461538461539
4540,4162,-6292,5,6,11,45.45,8.545454545454545
4545,1940,-9290,3,6,9,33.33,15.222222222222221
4551,17492,-6292,10,10,20,50.0,31.2
4552,750,5600,2,1,3,66.67,65.66666666666667
4555,3790,11610,6,4,10,60.0,51.2
4557,4035,-10735,4,5,9,44.44,74.44444444444444
4560,2860,-1910,5,4,9,55.56,48.333333333333336
4562,1295,2255,3,3,6,50.0,43.833333333333336
4564,1031,-981,2,2,4,50.0,32.75
4566,2440,-18640,3,5,8,37.5,16.625
4571,4101,-18601,2,4,6,33.33,32.666666666666664
4572,1929,-28829,0,3,3,0.0,12.0
4576,3983,-40883,2,4,6,33.33,8.833333333333334
4581,661,10389,3,0,3,100.0,55.0
4720,3584,6206,21,15,36,58.33,62.916666666666664
4722,6589,11751,24,22,46,52.17,44.78260869565217
4737,6051,-32451,6,9,15,40.0,52.266666666666666
4739,13669,-100019,12,21,33,36.36,20.96969696969697
4746,9909,-2009,12,12,24,50.0,24.541666666666668
4755,11343,-43593,10,16,26,38.46,30.03846153846154
4763,11614,47386,9,5,14,64.29,39.92857142857143
4764,3095,30715,6,1,7,85.71,30.428571428571427
4766,3784,31716,3,1,4,75.0,34.5
4807,1543,-7743,4,2,6,66.67,27.0
4904,10758,5992,17,17,34,50.0,129.2058823529412
4906,11317,13533,24,20,44,54.55,33.27272727272727
4912,21651,-110251,13,18,31,41.94,17.032258064516128
4915,8162,-19512,10,16,26,38.46,34.76923076923077
4916,3826,31974,13,5,18,72.22,19.27777777777778
4919,12065,19235,17,16,33,51.52,23.87878787878788
4927,10557,-3607,17,13,30,56.67,29.133333333333333
4930,3032,-15732,9,14,23,39.13,34.56521739130435
4934,3570,-11060,12,17,29,41.38,11.689655172413794
4935,9526,-75026,9,16,25,36.0,20.96
4938,9328,-38728,9,15,24,37.5,43.458333333333336
4942,5000,-1400,11,11,22,50.0,38.13636363636363
4943,23470,-68470,6,8,14,42.86,9.428571428571429
4952,7542,-22242,14,14,28,50.0,34.464285714285715
4956,2584,10416,11,8,19,57.89,15.842105263157896
4958,12046,20854,12,9,21,57.14,43.142857142857146
4960,2049,7431,12,6,18,66.67,25.666666666666668
4961,19096,-29596,19,20,39,48.72,15.692307692307692
4967,4312,19858,14,11,25,56.0,21.48
4968,35058,-188858,8,19,27,29.63,9.851851851851851
4976,7037,-28437,11,14,25,44.0,14.92
4977,11442,18158,9,10,19,47.37,21.36842105263158
4989,2303,1877,7,6,13,53.85,14.307692307692308
4994,14139,-22539,9,13,22,40.91,23.0
4999,4854,26696,10,5,15,66.67,52.4
5007,9154,-56804,15,25,40,37.5,54.375
5203,29202,-33802,23,20,43,53.49,41.627906976744185
5215,8718,-100068,8,15,23,34.78,31.608695652173914
5225,5427,-40227,8,11,19,42.11,23.789473684210527
5234,10003,-95703,7,15,22,31.82,36.59090909090909
5243,5446,-4496,8,11,19,42.11,21.63157894736842
5258,2962,-11012,8,7,15,53.33,7.666666666666667
5269,167588,-205388,15,25,40,37.5,12.875
5283,7550,-6170,8,9,17,47.06,107.41176470588235
5284,2892,-17792,4,5,9,44.44,100.44444444444444
5285,10572,24778,13,12,25,52.0,17.28
5288,14480,-12280,10,11,21,47.62,31.80952380952381
5388,14698,5302,24,28,52,46.15,39.80769230769231
5434,20228,-93528,19,26,45,42.22,38.93333333333333
5469,8381,5719,25,27,52,48.08,20.557692307692307
5471,17306,-41856,21,25,46,45.65,35.56521739130435
5484,7066,6704,24,22,46,52.17,18.456521739130434
5515,4539,4161,22,17,39,56.41,58.282051282051285
5519,8053,-52553,18,36,54,33.33,32.94444444444444
5521,4568,-15568,24,33,57,42.11,21.42105263157895
5522,15502,11748,26,25,51,50.98,36.705882352941174
5525,6920,-19270,20,27,47,42.55,53.59574468085106
5531,11708,-3508,27,23,50,54.0,19.8
5533,4889,-18289,18,25,43,41.86,59.627906976744185
5534,20957,-49707,20,34,54,37.04,31.90740740740741
5538,3357,-2507,5,9,14,35.71,78.71428571428571
5546,982,-2682,1,1,2,50.0,72.0
5607,8997,-17247,21,27,48,43.75,28.375
5608,9524,-55634,18,33,51,35.29,21.176470588235293
5706,15472,-672,22,26,48,45.83,38.0625
5871,16050,-170650,5,20,25,20.0,57.56
5876,2609,-24879,2,8,10,20.0,79.3
5880,1209,-8259,3,7,10,30.0,262.4
5906,2918,-3598,12,11,23,52.17,25.0
5907,3228,40972,14,2,16,87.5,27.9375
6005,4179,-4889,22,26,48,45.83,32.416666666666664
6024,4234,-15134,7,11,18,38.89,105.33333333333333
6108,7142,-23092,20,28,48,41.67,28.395833333333332
6112,7617,-14327,24,27,51,47.06,43.627450980392155
6115,8448,-39198,13,20,33,39.39,72.87878787878788
6116,3625,-28475,19,31,50,38.0,17.4
6117,5827,-10677,18,25,43,41.86,33.74418604651163
6120,8397,-18647,25,28,53,47.17,17.566037735849058
6128,6797,-52397,12,25,37,32.43,36.7027027027027
6133,4126,-14086,19,22,41,46.34,34.24390243902439
6136,4842,8358,16,12,28,57.14,104.17857142857143
6139,9867,-15917,18,18,36,50.0,37.02777777777778
6141,8030,25410,27,24,51,52.94,24.823529411764707
6142,4784,-1044,20,19,39,51.28,28.71794871794872
6152,7136,-31216,20,25,45,44.44,21.022222222222222
6153,12432,20768,29,25,54,53.7,21.35185185185185
6155,8744,21856,29,17,46,63.04,31.652173913043477
6164,5842,-12472,24,28,52,46.15,20.173076923076923
6165,9176,-59146,33,36,69,47.83,16.91304347826087
6166,14359,-19909,23,25,48,47.92,36.4375
6168,9652,-10402,24,31,55,43.64,19.545454545454547
6172,6046,-14246,32,32,64,50.0,14.28125
6176,28930,34570,25,32,57,43.86,34.40350877192982
6177,8296,6954,30,25,55,54.55,32.945454545454545
6183,5210,-28760,14,22,36,38.89,70.91666666666667
6184,7952,-71802,7,24,31,22.58,113.61290322580645
6189,8104,19596,21,19,40,52.5,84.475
6191,8577,-17877,24,23,47,51.06,25.23404255319149
6192,13895,-73595,15,24,39,38.46,53.43589743589744
6196,15928,-48238,25,26,51,49.02,21.50980392156863
6197,20861,-3311,26,28,54,48.15,18.27777777777778
6201,6525,-22375,14,17,31,45.16,91.70967741935483
6202,19152,8548,27,28,55,49.09,34.67272727272727
6205,12513,-20163,25,27,52,48.08,21.076923076923077
6206,23034,-6234,22,24,46,47.83,38.17391304347826
6209,13216,61234,23,21,44,52.27,12.613636363636363
6213,16603,-2553,28,29,57,49.12,29.56140350877193
6214,11288,-1988,18,19,37,48.65,58.4054054054054
6215,9006,-31206,29,24,53,54.72,18.41509433962264
6216,10457,-50157,19,20,39,48.72,53.38461538461539
6224,18413,-54313,21,28,49,42.86,32.816326530612244
6225,5316,-15596,28,29,57,49.12,9.263157894736842
6226,3640,-7960,20,24,44,45.45,17.34090909090909
6230,34974,-114724,25,40,65,38.46,15.830769230769231
6235,7013,12457,23,22,45,51.11,16.133333333333333
6239,23137,-94237,17,28,45,37.78,43.24444444444445
6243,18266,44584,33,30,63,52.38,10.746031746031745
6251,2824,17176,16,10,26,61.54,20.576923076923077
6257,7935,-22085,18,26,44,40.91,54.18181818181818
6269,22881,-24131,26,28,54,48.15,19.5
6271,31492,-23492,17,24,41,41.46,20.975609756097562
6277,17169,-39269,16,19,35,45.71,68.74285714285715
6278,22906,55344,26,30,56,46.43,24.196428571428573
6281,6578,-42678,6,14,20,30.0,186.65
6282,6122,4278,21,20,41,51.22,42.97560975609756
6283,9173,4247,26,26,52,50.0,15.211538461538462
6285,19994,1556,23,21,44,52.27,32.38636363636363
6288,3431,-17821,14,18,32,43.75,16.09375
6289,4985,-13555,23,21,44,52.27,9.727272727272727
6405,2325,-1025,7,8,15,46.67,15.266666666666667
6409,120468,74532,15,14,29,51.72,32.37931034482759
6412,7667,18733,12,10,22,54.55,35.04545454545455
6414,37457,52043,10,8,18,55.56,37.27777777777778
6415,352955,1577045,19,20,39,48.72,20.384615384615383
6416,20422,77308,18,12,30,60.0,16.633333333333333
6431,1710,-4810,7,6,13,53.85,22.23076923076923
6438,6635,45765,9,4,13,69.23,36.53846153846154
6442,2733,8367,6,4,10,60.0,20.7
6443,2869,501,10,9,19,52.63,11.052631578947368
6449,5803,-5053,10,10,20,50.0,26.85
6451,12314,-20814,7,8,15,46.67,11.866666666666667
6456,19145,-63545,10,9,19,52.63,17.894736842105264
6464,3550,32450,4,1,5,80.0,171.0
6477,5573,6477,13,11,24,54.17,12.333333333333334
6491,27246,-244566,6,11,17,35.29,18.235294117647058
6504,17086,-65086,7,8,15,46.67,43.46666666666667
6505,16862,26538,17,14,31,54.84,72.83870967741936
6515,11278,-2278,2,3,5,40.0,12.2
6525,7066,28334,9,5,14,64.29,15.214285714285714
6531,48888,-93388,10,18,28,35.71,9.535714285714286
6533,24354,-113354,6,9,15,40.0,13.733333333333333
6541,4084,-55884,3,7,10,30.0,12.4
6552,8141,-30191,8,12,20,40.0,8.05
6558,3689,-9789,6,8,14,42.86,8.785714285714286
6573,1022,-4672,4,3,7,57.14,9.285714285714286
6579,4387,34303,7,2,9,77.78,43.333333333333336
6581,4590,-26650,3,5,8,37.5,43.25
6582,14537,-81157,3,13,16,18.75,26.5
6591,3505,14195,7,3,10,70.0,18.8
6592,2876,-34676,1,4,5,20.0,73.4
6598,915,15435,3,0,3,100.0,3.3333333333333335
6605,17612,-83912,12,20,32,37.5,41.125
6625,195,2805,1,0,1,100.0,10.0
6641,1554,-4954,1,3,4,25.0,54.5
6655,4729,-54679,2,9,11,18.18,26.90909090909091
6666,1254,21246,1,0,1,100.0,3.0
6668,3788,-9388,4,4,8,50.0,17.0
6669,49567,-30567,4,7,11,36.36,29.272727272727273
6670,9513,-29513,3,5,8,37.5,31.0
6671,1268,-6018,2,3,5,40.0,98.8
6672,4905,-50605,2,5,7,28.57,17.571428571428573
6674,846,1704,2,2,4,50.0,10.0
6698,1254,15296,4,0,4,100.0,9.5
6706,6728,-33228,2,4,6,33.33,21.166666666666668
6715,4828,-2328,3,3,6,50.0,16.5
6743,0,0,0,0,0,0.0,
6754,535,-4585,0,2,2,0.0,71.0
6756,10911,-144911,0,4,4,0.0,4.25
8011,6368,-1068,18,16,34,52.94,19.08823529411765
8016,34826,-131676,23,27,50,46.0,26.38
8021,9876,-57876,20,28,48,41.67,25.625
8028,7130,-29510,13,20,33,39.39,14.303030303030303
8033,4508,-268,22,17,39,56.41,16.102564102564102
8039,14872,63978,31,20,51,60.78,21.823529411764707
8046,38589,-66289,20,25,45,44.44,20.533333333333335
8070,33511,-130161,22,26,48,45.83,26.854166666666668
8072,20614,24936,21,12,33,63.64,44.06060606060606
8081,46045,-60245,27,27,54,50.0,25.925925925925927
8101,5206,-12076,24,22,46,52.17,13.695652173913043
8103,11871,27579,28,20,48,58.33,32.645833333333336
8104,4895,91345,7,6,13,53.85,58.07692307692308
8105,5451,-16291,21,24,45,46.67,15.822222222222223
8110,2828,-6448,15,19,34,44.12,24.41176470588235
8112,6609,-36179,18,29,47,38.3,31.148936170212767
8114,20966,-72366,13,20,33,39.39,45.42424242424242
8131,6781,-8731,15,18,33,45.45,44.27272727272727
8150,4400,6500,10,9,19,52.63,29.0
8163,8955,16595,22,17,39,56.41,27.23076923076923
8201,4093,6927,14,17,31,45.16,13.32258064516129
8210,12752,-63252,18,31,49,36.73,29.612244897959183
8213,5342,-7142,12,10,22,54.55,54.77272727272727
8215,4362,-17512,11,18,29,37.93,15.10344827586207
8222,1960,3190,7,7,14,50.0,15.714285714285714
8249,6468,5032,19,19,38,50.0,40.73684210526316
8261,15695,-70745,24,39,63,38.1,13.587301587301587
8271,5830,25320,18,11,29,62.07,38.3448275862069
8341,17867,-62867,7,9,16,43.75,38.5
8367,3413,-17813,5,8,13,38.46,19.153846153846153
8374,8907,18643,23,20,43,53.49,20.3953488372093
8404,6766,-32416,13,18,31,41.94,21.419354838709676
8411,4072,-14322,6,12,18,33.33,37.388888888888886
8422,17494,34506,8,7,15,53.33,98.2
8429,4000,-7550,6,8,14,42.86,15.714285714285714
8442,3309,-11509,5,5,10,50.0,35.6
8443,398,1652,3,2,5,60.0,27.2
8454,105766,-48266,8,18,26,30.77,28.46153846153846
8462,16295,-160795,6,11,17,35.29,20.11764705882353
8463,2450,4400,8,5,13,61.54,12.23076923076923
8464,28862,-154862,5,9,14,35.71,33.57142857142857
8466,2411,14789,3,2,5,60.0,51.8
8467,3875,23675,8,5,13,61.54,11.23076923076923
8473,2005,-7105,3,3,6,50.0,35.5
8478,12208,-60058,6,12,18,33.33,6.944444444444445
8480,4065,14435,3,2,5,60.0,67.6
8481,2625,-22375,3,5,8,37.5,85.0
8482,3475,27725,4,1,5,80.0,96.6
8488,756,294,4,3,7,57.14,11.857142857142858
8499,6816,-13516,4,5,9,44.44,22.22222222222222
8926,5294,-17444,17,25,42,40.48,83.88095238095238
8940,5549,20151,25,15,40,62.5,28.4
8996,14242,-10692,22,25,47,46.81,22.93617021276596
9802,17725,-98225,13,23,36,36.11,32.333333333333336
9902,3276,-16546,18,26,44,40.91,18.431818181818183
9904,7706,-6506,18,21,39,46.15,60.794871794871796
9905,5556,8144,20,19,39,51.28,66.2051282051282
9906,10318,-64998,34,36,70,48.57,10.371428571428572
9907,5353,-4533,24,31,55,43.64,27.854545454545455
9908,3085,-20285,9,18,27,33.33,150.55555555555554
9910,28381,1119,24,24,48,50.0,46.020833333333336
9911,7865,-12405,25,30,55,45.45,29.854545454545455
9912,4068,-15108,24,27,51,47.06,15.450980392156863
9914,38888,-63738,22,37,59,37.29,29.135593220338983
9917,11268,-38068,13,17,30,43.33,150.8
9918,5155,-18355,11,20,31,35.48,136.38709677419354
9919,5466,12884,27,18,45,60.0,29.755555555555556
9921,38101,-294551,18,29,47,38.3,36.95744680851064
9924,6826,-17426,18,19,37,48.65,60.810810810810814
9925,4032,-16132,9,17,26,34.62,185.8846153846154
9926,5417,-11267,10,22,32,31.25,128.1875
9927,9672,-44672,16,28,44,36.36,48.72727272727273
9928,3652,-4652,22,17,39,56.41,21.564102564102566
9929,2754,-6344,19,24,43,44.19,23.906976744186046
9930,6723,-71523,7,23,30,23.33,129.26666666666668
