代號,總成本,總損益(淨),獲利次數,損失次數,總交易次數,勝率%,平均報酬,平均持倉時間(日)
1101,6409,-14509,13,15,28,46.43,-0.0059250000000000014,87.85714285714286
1102,5005,295,13,10,23,56.52,0.007665217391304347,107.0
1103,2866,9214,19,11,30,63.33,0.02417,71.83333333333333
1104,2760,3290,11,9,20,55.0,0.014049999999999998,130.65
1108,1599,4751,14,8,22,63.64,0.022645454545454545,116.72727272727273
1109,2913,7707,19,11,30,63.33,0.021696666666666663,78.86666666666666
1110,2057,93,11,10,21,52.38,0.003542857142857143,127.42857142857143
1201,3820,-2120,15,11,26,57.69,0.008334615384615386,94.76923076923077
1203,3021,12879,11,6,17,64.71,0.03338823529411765,173.64705882352942
1210,6431,18469,19,11,30,63.33,0.024373333333333337,74.96666666666667
1213,2503,-5603,11,20,31,35.48,-0.029922580645161293,79.12903225806451
1215,9181,-731,16,14,30,53.33,0.00814,80.43333333333334
1216,8569,-28919,11,12,23,47.83,-0.015339130434782614,126.56521739130434
1217,1735,335,14,12,26,53.85,0.008042307692307694,100.53846153846153
1218,3833,13667,19,11,30,63.33,0.02808,75.53333333333333
1219,2198,8552,13,7,20,65.0,0.029939999999999994,134.2
1220,1227,-747,8,7,15,53.33,0.005673333333333334,187.6
1225,9651,22349,24,14,38,63.16,0.029523684210526313,47.078947368421055
1227,8153,-80453,7,16,23,30.43,-0.04919565217391304,126.52173913043478
1229,5712,41688,19,6,25,76.0,0.046348,96.04
1231,7301,12949,16,10,26,61.54,0.020546153846153846,89.11538461538461
1232,10444,37956,12,5,17,70.59,0.032152941176470586,167.0
1233,1841,-6941,3,5,8,37.5,-0.0161375,416.375
1234,2750,-200,8,6,14,57.14,0.004921428571428574,220.57142857142858
1235,6902,47948,24,9,33,72.73,0.048781818181818176,63.06060606060606
1236,2604,-15454,9,13,22,40.91,-0.022477272727272728,123.63636363636364
1256,55142,-121142,23,19,42,54.76,0.004350000000000001,34.57142857142857
1301,11056,27344,13,8,21,61.9,0.018333333333333333,136.0952380952381
1303,8527,4073,13,8,21,61.9,0.011933333333333336,125.33333333333333
1304,3545,-8645,17,15,32,53.12,-0.0070593750000000005,63.15625
1305,6479,-7929,24,23,47,51.06,-0.002155319148936169,34.808510638297875
1307,5066,-11516,14,16,30,46.67,-0.004010000000000001,75.23333333333333
1308,4765,-22765,17,20,37,45.95,-0.020856756756756755,59.2972972972973
1309,5115,-4525,23,21,44,52.27,0.002263636363636365,41.04545454545455
1310,4055,-805,20,19,39,51.28,-0.00037435897435897326,54.07692307692308
1312,5882,-19032,22,26,48,45.83,-0.012085416666666668,37.520833333333336
1313,3578,-15208,19,21,40,47.5,-0.010677499999999998,49.825
1314,2945,-7725,20,20,40,50.0,-0.01149,50.875
1315,4646,56104,12,3,15,80.0,0.08281999999999999,190.2
1316,2821,729,16,15,31,51.61,0.01444193548387096,68.41935483870968
1319,8529,9771,19,14,33,57.58,0.012303030303030303,53.60606060606061
1321,4566,19534,15,8,23,65.22,0.03197826086956522,108.47826086956522
1323,4660,-23710,10,14,24,41.67,-0.021695833333333334,112.375
1324,1733,4377,13,9,22,59.09,0.02235454545454545,120.31818181818181
1325,7725,-17175,18,11,29,62.07,0.016317241379310347,72.17241379310344
1326,9223,-11523,9,10,19,47.37,-0.006800000000000002,147.10526315789474
1337,5774,-52104,17,28,45,37.78,-0.040975555555555564,40.24444444444445
1338,17016,-48966,15,19,34,44.12,-0.011802941176470587,65.3529411764706
1339,9012,34438,19,11,30,63.33,0.029426666666666663,74.5
1340,10669,-90969,17,23,40,42.5,-0.0241575,45.525
1341,3729,9471,7,3,10,70.0,0.025779999999999997,118.9
1342,5710,22790,6,4,10,60.0,0.03497,49.9
1402,3778,4422,13,9,22,59.09,0.013263636363636356,125.68181818181819
1409,2263,717,17,11,28,60.71,0.016482142857142862,85.07142857142857
1410,3526,10324,13,7,20,65.0,0.020964999999999998,143.8
1413,2559,-2549,20,19,39,51.28,0.006833333333333329,52.41025641025641
1414,2137,2333,18,11,29,62.07,0.02115862068965517,81.86206896551724
1416,2837,-6687,15,15,30,50.0,-0.013443333333333333,85.16666666666667
1417,1967,-4917,15,15,30,50.0,-0.0037533333333333325,74.96666666666667
1418,2387,12563,24,11,35,68.57,0.036988571428571426,43.8
1419,5088,6562,13,8,21,61.9,0.012138095238095236,134.33333333333334
1423,1900,7170,15,8,23,65.22,0.02980869565217392,116.08695652173913
1432,3846,5044,24,17,41,58.54,0.020251219512195124,31.48780487804878
1434,3763,787,11,9,20,55.0,0.003054999999999996,139.35
1435,2990,-21140,15,14,29,51.72,0.003524137931034484,60.37931034482759
1436,4307,-6157,8,8,16,50.0,-0.0067687500000000005,186.9375
1437,3952,10448,20,12,32,62.5,0.020565625,75.375
1438,3297,39323,22,13,35,62.86,0.08290571428571429,56.94285714285714
1439,4524,-9924,16,15,31,51.61,0.00613548387096774,66.96774193548387
1440,3083,-22763,13,17,30,43.33,-0.033793333333333335,71.73333333333333
1441,2461,-3921,16,19,35,45.71,-0.0026571428571428566,63.34285714285714
1442,3203,7847,16,8,24,66.67,0.026845833333333336,89.33333333333333
1443,2859,9181,21,15,36,58.33,0.023769444444444444,60.888888888888886
1444,2260,-1740,16,16,32,50.0,-0.0010000000000000026,74.96875
1445,1995,3615,17,10,27,62.96,0.008196296296296299,89.5925925925926
1446,5265,8185,19,14,33,57.58,0.012909090909090908,66.78787878787878
1447,2500,-1350,19,18,37,51.35,0.008394594594594594,54.0
1449,3008,5272,20,22,42,47.62,0.02445238095238096,37.095238095238095
1451,3270,9530,15,9,24,62.5,0.023979166666666673,99.75
1452,3498,-8048,15,13,28,53.57,-0.005200000000000001,80.85714285714286
1453,2206,3434,16,14,30,53.33,0.017143333333333337,78.13333333333334
1454,1885,8845,19,7,26,73.08,0.03013846153846154,93.5
1455,2665,-17995,17,19,36,47.22,-0.02391666666666666,54.69444444444444
1456,3992,1758,26,23,50,52.0,0.044278000000000005,29.72
1457,2600,8110,20,11,31,64.52,0.026987096774193548,77.0
1459,2401,-6361,18,16,34,52.94,-0.006311764705882352,64.82352941176471
1460,2992,-6682,18,20,38,47.37,-0.009244736842105262,51.36842105263158
1463,3265,7585,22,10,32,68.75,0.026465624999999996,68.0
1464,4655,-5555,19,18,37,51.35,3.783783783783733e-05,58.432432432432435
1465,1856,5194,10,10,20,50.0,0.023525,140.45
1466,3468,-7058,15,22,37,40.54,-0.01662432432432432,55.0
1467,3352,-2622,22,18,40,55.0,0.003622499999999995,44.275
1468,2170,14980,17,11,28,60.71,0.04904642857142857,89.10714285714286
1470,4056,-11606,17,19,36,47.22,-0.011266666666666664,65.08333333333333
1471,3030,-2650,23,28,51,45.1,0.007439215686274507,25.215686274509803
1472,6153,-13993,19,28,47,40.43,-0.007123404255319151,22.80851063829787
1473,4163,-21763,13,15,28,46.43,-0.020721428571428575,79.75
1474,2439,-2589,19,14,33,57.58,0.00017878787878787864,69.84848484848484
1475,7829,10881,23,30,53,43.4,0.013996226415094338,18.471698113207548
1476,98612,128888,27,15,42,64.29,0.018569047619047617,38.04761904761905
1477,44680,7820,22,19,41,53.66,0.004451219512195122,44.073170731707314
1503,5298,64302,12,3,15,80.0,0.07425999999999999,196.66666666666666
1504,5346,-5246,15,16,31,48.39,-0.004322580645161293,77.38709677419355
1506,3842,14898,24,14,38,63.16,0.03442894736842105,42.71052631578947
1512,2698,-5458,18,27,45,40.0,-0.00992888888888889,29.022222222222222
1513,7487,42113,21,9,30,70.0,0.03209666666666666,74.53333333333333
1514,4560,39330,28,10,38,73.68,0.047384210526315786,45.89473684210526
1515,11849,-7059,27,19,46,58.7,0.019715217391304347,28.130434782608695
1516,4911,10989,24,19,43,55.81,0.01836279069767441,38.395348837209305
1517,3632,-19132,17,20,37,45.95,-0.017721621621621622,59.054054054054056
1519,7662,79488,28,9,37,75.68,0.040416216216216216,49.86486486486486
1521,9998,-55948,11,15,26,42.31,-0.02737307692307692,96.6923076923077
1522,5512,-8262,21,17,38,55.26,-0.00697105263157895,48.94736842105263
1524,2399,9601,18,12,30,60.0,0.018980000000000004,78.26666666666667
1525,16734,-19434,20,16,36,55.56,0.004852777777777779,46.69444444444444
1526,8382,-27622,28,19,47,59.57,0.006199999999999997,28.914893617021278
1527,12830,-28630,20,20,40,50.0,-0.006285000000000001,51.025
1528,2609,4071,22,13,35,62.86,0.02168571428571429,54.94285714285714
1529,4852,4978,30,30,60,50.0,0.010366666666666665,15.916666666666666
1530,6041,11609,18,12,30,60.0,0.018903333333333334,74.03333333333333
1531,3005,-1555,15,13,28,53.57,0.0022571428571428564,79.92857142857143
1532,6118,-21868,16,17,33,48.48,-0.01455151515151515,68.6969696969697
1533,11622,23628,26,16,42,61.9,0.025478571428571434,37.404761904761905
1535,8456,-4406,16,14,30,53.33,0.006483333333333337,80.63333333333334
1536,24584,27966,22,19,41,53.66,0.00961219512195122,41.048780487804876
1537,14201,19199,12,6,18,66.67,0.01662777777777778,157.83333333333334
1538,3297,-5087,25,29,54,46.3,-0.0061888888888888905,22.962962962962962
1539,5886,38414,28,13,41,68.29,0.04169024390243902,32.65853658536585
1540,2630,18620,17,8,25,68.0,0.045564,91.8
1541,8969,22631,26,15,41,63.41,0.02379024390243902,35.02439024390244
1558,19536,-97536,9,14,23,39.13,-0.024456521739130436,122.21739130434783
1560,18784,54616,26,15,41,63.41,0.022136585365853657,44.48780487804878
1568,6699,2501,24,20,44,54.55,0.008474999999999996,29.772727272727273
1582,10217,2033,14,13,27,51.85,0.004025925925925925,94.33333333333333
1583,13651,-22801,16,19,35,45.71,-0.004414285714285712,64.62857142857143
1587,4562,3488,19,15,34,55.88,0.011152941176470591,52.588235294117645
1589,29193,-45943,27,22,49,55.1,0.0030897959183673503,31.591836734693878
1590,142629,397871,28,22,50,56.0,0.011194000000000003,22.7
1597,17363,48787,28,15,43,65.12,0.026872093023255817,29.88372093023256
1598,8126,35524,14,12,26,53.85,0.009784615384615385,41.26923076923077
1603,4523,-973,16,16,32,50.0,0.00639375,71.375
1604,2925,20035,19,7,26,73.08,0.04425769230769231,89.53846153846153
1605,5240,1530,24,19,43,55.81,0.005476744186046511,39.674418604651166
1608,3365,-15845,20,19,39,51.28,-0.004941025641025642,50.1025641025641
1609,3806,-10386,18,19,37,48.65,-0.0035243243243243253,53.054054054054056
1611,2636,8044,21,13,34,61.76,0.027361764705882353,59.1764705882353
1612,3654,16046,24,14,38,63.16,0.02576842105263158,57.6578947368421
1614,3553,18797,12,7,19,63.16,0.03126315789473685,141.47368421052633
1615,3815,16245,21,11,32,65.62,0.03729687499999999,68.9375
1616,2225,5815,25,12,37,67.57,0.02867297297297297,46.13513513513514
1617,2347,8163,19,10,29,65.52,0.025113793103448273,84.51724137931035
1618,2192,17428,23,6,29,79.31,0.06143793103448276,71.48275862068965
1626,8379,-46129,22,25,47,46.81,-0.013038297872340426,35.42553191489362
1701,2906,2644,13,10,23,56.52,0.011395652173913046,118.17391304347827
1702,9761,-37911,13,17,30,43.33,-0.015836666666666662,79.83333333333333
1707,34273,33227,19,13,32,59.38,0.013031249999999994,68.9375
1708,6471,-14171,17,16,33,51.52,-0.005933333333333336,72.06060606060606
1709,3174,16126,18,11,29,62.07,0.03570344827586207,83.20689655172414
1710,4874,-3774,20,16,36,55.56,0.0009305555555555555,56.361111111111114
1711,4170,9330,21,12,33,63.64,0.01892727272727273,63.78787878787879
1712,3358,22842,18,7,25,72.0,0.038708000000000006,94.56
1713,2367,16433,14,6,20,70.0,0.039235000000000006,138.5
1714,2724,-6234,19,21,40,47.5,-0.009632499999999997,53.625
1717,4899,9801,15,11,26,57.69,0.01683846153846154,100.38461538461539
1718,2922,-7222,20,23,43,46.51,-0.013648837209302328,46.04651162790697
1720,5792,11458,13,11,24,54.17,0.012466666666666668,105.5
1721,3383,-7643,21,20,41,51.22,0.00493170731707317,47.31707317073171
1722,7640,-6690,13,11,24,54.17,0.0026958333333333326,113.41666666666667
1723,16586,-12886,13,10,23,56.52,0.004186956521739132,115.3913043478261
1725,3226,6674,19,11,30,63.33,0.023773333333333327,69.86666666666666
1726,3996,15004,6,3,9,66.67,0.02685555555555556,364.0
1727,4026,-8976,16,14,30,53.33,0.0018933333333333395,75.83333333333333
1730,7045,48855,19,6,25,76.0,0.047760000000000004,94.04
1731,2486,6214,17,9,26,65.38,0.021438461538461538,100.15384615384616
1732,3738,14772,18,11,29,62.07,0.0321655172413793,68.79310344827586
1733,7229,-37579,15,19,34,44.12,-0.01558529411764706,65.23529411764706
1734,5391,14859,19,10,29,65.52,0.02402413793103448,70.3103448275862
1735,2501,1249,15,13,28,53.57,0.011921428571428569,93.60714285714286
1736,15184,-40934,22,20,42,52.38,-0.010850000000000002,41.857142857142854
1737,3035,4915,10,8,18,55.56,0.012544444444444445,160.5
1760,45636,-105586,22,31,53,41.51,-0.025439622641509438,25.67924528301887
1762,10697,3703,23,18,41,56.1,0.014458536585365854,40.63414634146341
1773,21851,69799,25,12,37,67.57,0.0259,56.21621621621622
1776,1518,-11418,5,9,14,35.71,-0.033057142857142854,144.64285714285714
1783,7804,23146,24,14,38,63.16,0.013618421052631575,33.526315789473685
1786,18345,-7495,25,24,49,51.02,0.0016244897959183677,28.244897959183675
1789,8314,-49464,16,21,37,43.24,-0.02081621621621622,57.7027027027027
1795,34055,56195,29,24,53,54.72,0.015469811320754718,25.90566037735849
1802,3953,-14013,17,18,35,48.57,-0.009337142857142858,56.542857142857144
1805,2648,722,18,18,36,50.0,0.010808333333333335,47.333333333333336
1806,2403,-6033,17,19,36,47.22,-0.007219444444444439,59.888888888888886
1808,7679,17071,17,10,27,62.96,0.019511111111111108,84.11111111111111
1809,3031,2049,22,16,38,57.89,0.008842105263157892,50.18421052631579
1810,1943,6697,16,9,25,64.0,0.03008,97.16
1817,4972,11978,14,9,23,60.87,0.021626086956521736,104.8695652173913
1903,8948,9452,17,15,32,53.12,0.011484375000000003,70.15625
1904,3716,4984,16,10,26,61.54,0.01752692307692308,88.38461538461539
1905,3582,4458,23,14,37,62.16,0.0155,55.108108108108105
1906,4357,11623,27,16,43,62.79,0.03298604651162791,36.651162790697676
1907,4055,-575,16,17,33,48.48,-0.00016363636363636496,67.9090909090909
1909,4932,-14382,19,22,41,46.34,-0.005929268292682927,42.90243902439025
2002,2752,-2802,9,8,17,52.94,0.0061823529411764696,163.41176470588235
2006,5353,26947,16,10,26,61.54,0.023765384615384612,95.0
2007,2810,-7090,19,22,41,46.34,-0.004478048780487808,43.97560975609756
2008,2459,11661,17,10,27,62.96,0.03587407407407408,89.4074074074074
2009,5227,-13517,20,20,40,50.0,0.007075000000000002,47.625
2010,2197,-4707,12,12,24,50.0,-0.004129166666666667,109.58333333333333
2012,2863,-5663,13,10,23,56.52,0.005317391304347829,104.08695652173913
2013,5784,5366,15,13,28,53.57,0.02135714285714286,84.85714285714286
2014,4487,-5217,21,18,39,53.85,0.007297435897435896,42.43589743589744
2015,7100,9000,12,9,21,57.14,0.008047619047619045,124.0
2017,2397,8063,18,13,31,58.06,0.015077419354838709,62.54838709677419
2020,2710,-610,13,11,24,54.17,0.012633333333333331,105.91666666666667
2022,2259,1831,19,17,36,52.78,0.01728055555555556,51.97222222222222
2023,3110,-21180,13,23,36,36.11,-0.029191666666666664,58.333333333333336
2024,3188,12802,24,12,36,66.67,0.037380555555555556,51.611111111111114
2025,2419,431,23,25,48,47.92,0.0004854166666666664,30.895833333333332
2027,7307,-1857,23,18,41,56.1,0.00881219512195122,48.853658536585364
2028,4443,12297,29,17,46,63.04,0.026960869565217392,29.58695652173913
2029,4368,-7168,15,15,30,50.0,-0.0009133333333333315,73.06666666666666
2030,3853,3767,22,15,37,59.46,0.022721621621621623,48.945945945945944
2031,7969,1331,23,17,40,57.5,0.016802499999999998,41.9
2032,3496,-3446,18,21,39,46.15,-0.0006846153846153844,52.0
2033,2828,522,18,16,34,52.94,0.014908823529411763,64.70588235294117
2034,4736,5914,17,13,30,56.67,0.015493333333333336,71.73333333333333
2038,3604,11106,20,16,36,55.56,0.016394444444444448,53.27777777777778
2049,72340,-125340,25,23,48,52.08,-0.004629166666666666,28.166666666666668
2059,83286,-167286,19,18,37,51.35,-0.005154054054054053,54.37837837837838
2062,8979,-9629,20,20,40,50.0,-0.006669999999999998,51.675
2069,3460,-5060,14,11,25,56.0,-0.0009639999999999999,57.48
2101,5832,-20932,12,16,28,42.86,-0.016478571428571426,92.53571428571429
2102,3467,-22397,13,20,33,39.39,-0.02893939393939394,68.45454545454545
2103,6158,-23908,16,20,36,44.44,-0.01551388888888889,61.916666666666664
2104,5522,15128,20,11,31,64.52,0.024125806451612903,74.06451612903226
2105,8268,-38368,11,16,27,40.74,-0.020429629629629634,89.81481481481481
2106,6973,-46123,10,17,27,37.04,-0.031229629629629625,93.77777777777777
2107,3053,-3003,13,12,25,52.0,-0.0010640000000000003,104.6
2108,8151,299,18,18,36,50.0,-0.0037944444444444414,52.333333333333336
2109,3011,1619,19,15,34,55.88,0.011488235294117648,58.6764705882353
2114,14293,53807,17,8,25,68.0,0.028884000000000003,91.28
2115,9353,5697,18,17,35,51.43,0.005668571428571429,53.34285714285714
2201,7183,-18433,15,18,33,45.45,-0.013354545454545456,69.36363636363636
2204,6656,-4806,13,14,27,48.15,0.02477777777777777,89.03703703703704
2206,4629,15021,15,11,26,57.69,0.018403846153846153,90.61538461538461
2207,92509,-132509,18,16,34,52.94,-0.002638235294117649,60.14705882352941
2208,4426,-20726,14,21,35,40.0,-0.01252857142857143,58.82857142857143
2227,50428,-122428,15,16,31,48.39,-0.013309677419354836,74.96774193548387
2228,28265,-46565,21,19,40,52.5,-0.000837499999999998,41.95
2231,74872,-84372,27,23,50,54.0,0.002776000000000002,25.82
2233,27339,-109439,23,23,46,50.0,-0.011149999999999998,36.26086956521739
2236,7006,39044,23,12,35,65.71,0.03945428571428571,37.4
2239,21346,20554,19,14,33,57.58,0.003036363636363636,33.93939393939394
2241,6041,-30211,10,8,18,55.56,-0.013177777777777776,34.77777777777778
2243,3637,-25217,12,20,32,37.5,-0.013493749999999999,19.25
2247,8389,5111,3,3,6,50.0,0.00134999999999999,120.5
2301,10481,-12281,19,18,37,51.35,-0.004878378378378378,60.2972972972973
2302,3245,13675,26,17,43,60.47,0.022818604651162786,33.23255813953488
2303,5756,34344,22,12,34,64.71,0.03715588235294118,61.23529411764706
2305,3509,-6889,26,20,46,56.52,0.01860217391304348,27.76086956521739
2308,46416,70584,23,18,41,56.1,0.009929268292682928,47.73170731707317
2312,2936,2494,22,16,38,57.89,0.011339473684210523,49.44736842105263
2313,8224,2926,26,17,43,60.47,0.017383720930232556,36.395348837209305
2314,8490,18950,28,21,49,57.14,0.0053979591836734704,24.714285714285715
2316,6123,-3873,23,22,45,51.11,0.0029088888888888892,37.24444444444445
2317,13119,-34719,12,13,25,48.0,-0.007908,101.88
2321,2887,-6157,18,36,54,33.33,-0.028198148148148146,19.296296296296298
2323,2155,4695,21,15,36,58.33,0.029124999999999998,49.55555555555556
2324,3407,3593,15,12,27,55.56,0.008007407407407411,90.96296296296296
2327,79522,-115372,29,19,48,60.42,0.019299999999999998,28.604166666666668
2328,5221,-11221,18,16,34,52.94,-0.011370588235294118,61.23529411764706
2329,4218,-9968,26,23,49,53.06,0.0028673469387755133,32.326530612244895
2330,53368,103632,19,10,29,65.52,0.03051034482758621,77.6896551724138
2331,5097,-17397,20,25,45,44.44,-0.009759999999999998,33.93333333333333
2332,3969,-2189,23,20,43,53.49,0.004232558139534884,41.18604651162791
2337,7197,24573,25,22,47,53.19,0.02329574468085106,34.255319148936174
2338,9976,-39366,21,21,42,50.0,-0.000640476190476189,39.833333333333336
2340,6431,1539,28,19,47,59.57,0.012968085106382981,31.148936170212767
2342,8091,-12041,28,28,56,50.0,0.006244642857142859,17.375
2344,5555,3795,28,23,51,54.9,0.010080392156862747,31.03921568627451
2345,44542,214058,33,17,50,66.0,0.027261999999999998,29.78
2347,6100,7650,13,10,23,56.52,0.012747826086956522,106.78260869565217
2348,13926,-41476,20,24,44,45.45,-0.007606818181818182,44.06818181818182
2349,2970,-970,25,24,49,51.02,-0.005857142857142861,30.612244897959183
2351,23739,94961,35,17,52,67.31,0.02775769230769231,25.423076923076923
2352,3901,14099,19,14,33,57.58,0.015557575757575756,56.24242424242424
2353,5592,-2642,23,22,45,51.11,0.0008111111111111075,42.68888888888889
2354,15473,-102973,14,22,36,38.89,-0.03149444444444445,67.08333333333333
2355,9898,-15148,22,19,41,53.66,-0.0017048780487804872,42.90243902439025
2356,4132,-8982,15,15,30,50.0,-0.009139999999999997,73.3
2357,53737,-235737,15,18,33,45.45,-0.018018181818181815,75.51515151515152
2358,4883,-8483,23,29,52,44.23,0.0007923076923076894,27.03846153846154
2359,5505,22345,30,15,45,66.67,0.027406666666666663,34.266666666666666
2360,33730,102870,29,15,44,65.91,0.02609772727272727,38.13636363636363
2362,5184,3966,14,11,25,56.0,0.015108,97.6
2363,4016,-8426,26,24,50,52.0,-0.007862000000000001,33.94
2364,5657,-39107,19,30,49,38.78,-0.023697959183673473,24.142857142857142
2365,2590,-190,21,15,36,58.33,0.0053500000000000015,59.5
2367,4506,-15856,21,22,43,48.84,-0.008339534883720929,41.30232558139535
2368,10159,27781,33,17,50,66.0,0.020396,28.58
2369,3831,-10081,23,20,43,53.49,-0.002188372093023255,35.53488372093023
2371,5134,-10634,23,20,43,53.49,0.002651162790697673,37.41860465116279
2373,4471,25229,5,6,11,45.45,0.04411818181818181,290.3636363636364
2374,4211,10439,23,16,39,58.97,0.021548717948717943,48.23076923076923
2375,11178,-21508,24,21,45,53.33,0.013257777777777778,26.8
2376,17198,35702,26,17,43,60.47,0.01713488372093023,30.86046511627907
2377,21456,62294,26,14,40,65.0,0.024032500000000002,34.425
2379,55510,418190,32,9,41,78.05,0.054239024390243896,36.048780487804876
2380,2696,-7806,19,23,42,45.24,-0.017407142857142857,42.404761904761905
2382,11803,16997,16,13,29,55.17,0.011417241379310343,75.62068965517241
2383,35524,-106974,25,23,48,52.08,-0.004612499999999998,33.3125
2385,11561,37239,15,9,24,62.5,0.0218875,109.91666666666667
2387,8260,-17060,23,23,46,50.0,-0.0019934782608695663,36.45652173913044
2388,10438,10392,26,26,52,50.0,0.0019115384615384608,21.596153846153847
2390,5241,-21481,21,27,48,43.75,-0.015414583333333336,33.166666666666664
2392,8624,-624,19,16,35,54.29,0.008508571428571431,56.542857142857144
2393,9857,17093,21,15,36,58.33,0.018375,48.083333333333336
2395,62485,43515,23,16,39,58.97,0.012515384615384614,49.82051282051282
2397,10560,77490,22,9,31,70.97,0.04869677419354839,60.645161290322584
2399,4411,6729,27,22,49,55.1,0.018991836734693873,27.46938775510204
2401,5253,-1253,28,18,46,60.87,0.01854565217391304,33.84782608695652
2402,5364,6336,26,20,46,56.52,0.014239130434782607,34.19565217391305
2404,27504,112246,25,14,39,64.1,0.02726923076923077,48.282051282051285
2405,3204,-2304,24,18,42,57.14,0.007609523809523811,34.642857142857146
2406,5967,-13297,24,26,50,48.0,-0.014294000000000003,24.72
2408,17463,78187,26,23,49,53.06,0.17969387755102037,30.224489795918366
2409,3734,1936,24,20,44,54.55,0.011672727272727272,39.04545454545455
2412,6043,14357,5,4,9,55.56,0.019888888888888887,360.8888888888889
2413,6123,17557,31,23,54,57.41,0.025498148148148148,20.666666666666668
2414,3693,11157,18,9,27,66.67,0.03017037037037037,89.22222222222223
2415,6328,9572,27,19,46,58.7,0.016254347826086958,31.369565217391305
2417,5681,-16881,25,22,47,53.19,0.0053,35.148936170212764
2419,4773,-8803,19,21,40,47.5,-0.007544999999999999,48.8
2420,7046,-11646,16,15,31,51.61,-0.0044709677419354854,70.90322580645162
2421,9583,58417,28,13,41,68.29,0.039099999999999996,35.68292682926829
2423,3616,14084,18,8,26,69.23,0.025765384615384614,90.23076923076923
2424,7647,-23197,20,27,47,42.55,-0.008238297872340426,26.872340425531913
2425,6620,29280,25,15,40,62.5,0.0334525,36.975
2426,5170,-18440,27,25,52,51.92,-0.0020423076923076896,27.78846153846154
2427,2801,3519,20,17,37,54.05,0.011535135135135134,59.83783783783784
2428,23451,13299,25,17,42,59.52,0.012592857142857143,44.04761904761905
2429,4946,-22046,19,33,52,36.54,-0.01954423076923077,22.807692307692307
2430,4981,11219,15,14,29,51.72,0.019782758620689653,80.93103448275862
2431,4343,-8523,24,25,49,48.98,0.0007836734693877535,32.04081632653061
2433,4951,2549,10,8,18,55.56,0.007505555555555557,152.66666666666666
2434,4422,10568,23,23,46,50.0,0.06583913043478261,32.80434782608695
2436,11340,1510,29,22,51,56.86,0.017450980392156864,28.235294117647058
2438,3143,9607,25,18,43,58.14,0.03487906976744186,33.95348837209303
2439,34466,-81766,24,22,46,52.17,-0.005732608695652174,34.08695652173913
2440,3133,14407,25,17,42,59.52,0.028576190476190474,39.73809523809524
2441,8527,-1577,17,12,29,58.62,0.012341379310344826,76.72413793103448
2442,2811,14989,26,13,39,66.67,0.04097692307692307,49.05128205128205
2443,2324,-5344,18,22,40,45.0,-0.008569999999999998,37.4
2444,5109,-17459,27,26,53,50.94,-0.006084905660377357,24.30188679245283
2449,7645,30005,27,14,41,65.85,0.026397560975609757,42.4390243902439
2450,5529,-18029,11,9,20,55.0,0.002624999999999998,133.4
2451,11111,-47911,10,13,23,43.48,-0.01786086956521739,110.08695652173913
2453,4135,6215,22,13,35,62.86,0.026508571428571426,45.97142857142857
2454,122145,276355,24,19,43,55.81,0.012527906976744182,37.16279069767442
2455,23795,60055,32,19,51,62.75,0.015388235294117649,24.666666666666668
2457,5564,10346,26,19,45,57.78,0.012284444444444443,28.177777777777777
2458,20367,10033,23,18,41,56.1,0.0171,41.048780487804876
2459,6057,20543,15,10,25,60.0,0.025239999999999995,103.52
2460,4387,16213,29,18,47,61.7,0.02926808510638298,29.27659574468085
2461,4254,-5554,21,20,41,51.22,-0.0024439024390243906,46.24390243902439
2462,6376,28724,26,14,40,65.0,0.035795,46.4
2464,8725,5675,21,17,38,55.26,0.008915789473684214,48.3421052631579
2465,8490,-24120,27,33,60,45.0,0.014421666666666662,22.983333333333334
2466,4433,15767,14,8,22,63.64,0.027100000000000003,117.86363636363636
2467,6849,1851,21,17,38,55.26,0.015128947368421053,50.26315789473684
2468,2474,14166,16,10,26,61.54,0.04397692307692309,93.46153846153847
2471,3601,-3151,16,13,29,55.17,0.008513793103448276,76.82758620689656
2472,10935,18565,23,17,40,57.5,0.0160175,41.0
2474,60259,-91259,21,20,41,51.22,-0.0002463414634146334,46.21951219512195
2476,5121,19979,16,9,25,64.0,0.022952000000000004,92.36
2477,5863,10387,27,18,45,60.0,0.020940000000000007,37.4
2478,10532,21968,24,16,40,60.0,0.038645,42.65
2480,7675,21275,15,8,23,65.22,0.029082608695652178,106.82608695652173
2481,11228,2982,31,19,50,62.0,0.012346,26.86
2482,3657,19653,22,13,35,62.86,0.03134857142857142,47.285714285714285
2483,4198,10402,19,14,33,57.58,0.018142424242424238,69.60606060606061
2484,6075,7425,26,18,44,59.09,0.009918181818181819,36.61363636363637
2485,6460,-13710,22,18,40,55.0,0.002777500000000002,44.725
2486,5008,-1058,26,18,44,59.09,0.015079545454545457,30.681818181818183
2488,7517,1883,23,17,40,57.5,0.0052474999999999996,48.775
2489,2570,-8040,14,14,28,50.0,-0.008185714285714286,80.32142857142857
2491,3868,12192,28,23,51,54.9,0.028629411764705882,21.901960784313726
2492,33708,-128718,27,23,50,54.0,0.010785999999999997,25.46
2493,3967,20633,15,6,21,71.43,0.035723809523809526,112.9047619047619
2495,3327,2773,18,16,34,52.94,0.009085294117647058,61.294117647058826
2496,13926,-70906,14,27,41,34.15,-0.027297560975609755,46.78048780487805
2497,13957,-31757,27,25,52,51.92,-0.002305769230769231,27.557692307692307
2498,19761,-103511,22,29,51,43.14,-0.018611764705882352,25.03921568627451
2501,2089,3261,11,8,19,57.89,0.013110526315789474,133.89473684210526
2504,3244,11276,21,11,32,65.62,0.026062500000000002,63.65625
2505,3801,-601,17,18,35,48.57,0.0027085714285714317,61.714285714285715
2506,1814,6056,13,11,24,54.17,0.026254166666666665,105.66666666666667
2509,3938,2862,16,13,29,55.17,0.012406896551724134,80.13793103448276
2511,1845,-2825,12,12,24,50.0,-0.004395833333333332,111.79166666666667
2514,2988,2062,16,12,28,57.14,0.010417857142857144,89.17857142857143
2515,1990,4120,19,12,31,61.29,0.024170967741935487,68.6774193548387
2516,1296,-816,12,10,22,54.55,-0.0009409090909090933,118.31818181818181
2520,6061,-11061,21,17,38,55.26,0.0029605263157894755,42.89473684210526
2524,4798,-248,14,14,28,50.0,0.006178571428571432,90.78571428571429
2527,4811,-3861,20,17,37,54.05,0.001918918918918918,57.567567567567565
2528,3396,16244,21,14,35,60.0,0.03998571428571429,52.91428571428571
2530,2419,10781,17,8,25,68.0,0.030423999999999996,100.6
2534,2811,14539,16,6,22,72.73,0.04503181818181818,105.63636363636364
2535,2559,3791,11,8,19,57.89,0.012999999999999998,142.8421052631579
2536,2646,-6746,9,10,19,47.37,-0.00882105263157895,155.78947368421052
2537,2197,-4407,16,16,32,50.0,-0.005543749999999998,70.59375
2538,2625,-9515,15,16,31,48.39,-0.01092258064516129,72.19354838709677
2539,4138,30162,16,6,22,72.73,0.04645,117.0
2540,10865,56185,24,16,40,60.0,0.032034999999999994,37.525
2542,7204,-42554,12,13,25,48.0,-0.023404,105.12
2543,1717,4203,15,11,26,57.69,0.022957692307692307,88.96153846153847
2545,6987,-34037,15,16,31,48.39,-0.012061290322580642,68.83870967741936
2546,5572,21878,20,9,29,68.97,0.03308275862068965,80.86206896551724
2547,2768,-13718,14,19,33,42.42,-0.024184848484848486,69.84848484848484
2548,9345,-745,12,10,22,54.55,0.009581818181818181,124.0
2597,12943,9457,16,13,29,55.17,0.011424137931034485,73.89655172413794
2601,3268,-5768,20,22,42,47.62,-0.0070380952380952365,44.23809523809524
2603,14923,-115573,24,20,44,54.55,-0.008640909090909091,39.13636363636363
2605,5250,2650,22,19,41,53.66,0.013117073170731708,45.073170731707314
2606,8872,-15372,18,20,38,47.37,-0.0026815789473684207,52.078947368421055
2607,3306,7244,16,9,25,64.0,0.024207999999999997,98.44
2608,5561,-2511,12,11,23,52.17,0.0011782608695652167,119.26086956521739
2609,7696,-2146,18,25,43,41.86,-0.025469767441860466,40.27906976744186
2610,2866,324,16,14,30,53.33,0.0006233333333333295,75.0
2611,2662,-5192,18,14,32,56.25,0.0042749999999999976,61.0625
2612,8208,-15858,21,17,38,55.26,-0.0018578947368421048,51.63157894736842
2613,3863,-2313,19,15,34,55.88,0.009676470588235293,61.73529411764706
2614,4105,-1535,22,23,45,48.89,-0.0009622222222222224,32.37777777777778
2615,11614,-60264,21,18,39,53.85,-0.001625641025641026,43.58974358974359
2616,2647,2353,8,7,15,53.33,0.007886666666666665,203.53333333333333
2617,5059,-16009,19,20,39,48.72,-0.007792307692307691,50.41025641025641
2618,4003,-2153,16,17,33,48.48,0.003678787878787881,71.48484848484848
2630,2386,214,11,9,20,55.0,0.017335,54.45
2633,2827,17073,11,5,16,68.75,0.040487499999999996,99.4375
2634,5299,33251,18,7,25,72.0,0.042148000000000005,78.68
2636,11995,7755,19,19,38,50.0,0.007839473684210523,49.26315789473684
2637,8871,-13521,15,15,30,50.0,-0.014600000000000002,81.5
2642,8492,-50492,14,21,35,40.0,-0.02620857142857143,53.05714285714286
2701,729,1121,5,4,9,55.56,0.01561111111111111,360.77777777777777
2702,3306,15894,18,10,28,64.29,0.03323214285714286,76.96428571428571
2704,2345,4705,9,5,14,64.29,0.015035714285714288,212.57142857142858
2705,2388,5752,17,12,29,58.62,0.02019310344827586,77.10344827586206
2706,1334,2916,8,6,14,57.14,0.01813571428571428,216.28571428571428
2707,29388,-12388,15,10,25,60.0,0.008216000000000003,92.68
2712,6273,8127,19,11,30,63.33,0.019303333333333336,73.16666666666667
2722,6193,-12643,13,17,30,43.33,-0.0046300000000000004,83.2
2723,61486,-257886,25,25,50,50.0,-0.00987,23.56
2727,50036,-152436,21,26,47,44.68,-0.007906382978723401,35.95744680851064
2731,23318,-26318,22,16,38,57.89,0.005010526315789474,44.0
2739,4989,3061,14,11,25,56.0,0.010584,62.8
2748,6445,15255,11,8,19,57.89,0.0194,76.6842105263158
2801,1610,4690,9,6,15,60.0,0.021600000000000005,201.33333333333334
2809,4944,8156,15,11,26,57.69,0.012438461538461539,100.1923076923077
2812,1073,4537,10,4,14,71.43,0.03063571428571429,222.35714285714286
2816,2858,-4908,14,12,26,53.85,0.0013923076923076905,90.23076923076923
2820,951,1699,7,4,11,63.64,0.01669090909090909,290.90909090909093
2832,1237,-437,5,5,10,50.0,0.001589999999999999,330.0
2834,1310,2210,11,7,18,61.11,0.01396111111111111,165.38888888888889
2836,872,2368,7,5,12,58.33,0.021725000000000005,266.9166666666667
2838,1170,4960,10,5,15,66.67,0.03117333333333333,198.13333333333333
2845,877,-567,7,5,12,58.33,0.0008583333333333339,263.5833333333333
2849,2001,6199,15,8,23,65.22,0.021991304347826087,116.78260869565217
2850,4213,34087,16,5,21,76.19,0.04899523809523809,127.66666666666667
2851,2685,15815,16,7,23,69.57,0.04001304347826087,114.73913043478261
2852,1460,-3810,9,8,17,52.94,-0.0092,178.2941176470588
2855,2361,-4111,13,11,24,54.17,0.00435,106.29166666666667
2867,2060,-4820,10,15,25,40.0,-0.018376,109.08
2880,1930,4320,10,7,17,58.82,0.016911764705882355,172.8235294117647
2881,6870,14930,13,9,22,59.09,0.01574545454545455,121.0909090909091
2882,7234,8516,15,11,26,57.69,0.013980769230769225,102.23076923076923
2883,1927,-1247,14,12,26,53.85,0.002823076923076923,102.34615384615384
2884,2472,4728,11,6,17,64.71,0.01662352941176471,173.41176470588235
2885,2412,9138,15,9,24,62.5,0.02921666666666667,111.66666666666667
2886,3806,15844,15,7,22,68.18,0.03027727272727273,122.54545454545455
2887,2134,7516,16,8,24,66.67,0.026608333333333335,104.33333333333333
2888,1751,-2421,14,12,26,53.85,-0.0020230769230769243,103.53846153846153
2889,1613,-3443,12,10,22,54.55,-0.00435909090909091,122.95454545454545
2890,1322,6608,12,4,16,75.0,0.03545625,180.1875
2891,2724,6976,14,8,22,63.64,0.020959090909090906,121.04545454545455
2892,1942,11308,11,4,15,73.33,0.03845333333333334,201.46666666666667
2897,779,461,6,6,12,50.0,0.009033333333333326,151.58333333333334
2901,2628,2022,7,9,16,43.75,0.010362500000000004,179.6875
2903,2991,-11091,11,13,24,45.83,-0.014566666666666665,102.75
2904,2575,-8875,9,10,19,47.37,-0.014863157894736842,147.42105263157896
2905,4614,5086,22,16,38,57.89,0.011465789473684212,54.36842105263158
2906,2335,18895,18,9,27,66.67,0.05031111111111111,91.88888888888889
2908,1402,-9502,4,7,11,36.36,-0.03040909090909091,296.8181818181818
2910,5044,30956,19,7,26,73.08,0.04735,86.11538461538461
2911,2479,-11699,15,17,32,46.88,-0.01723125,70.40625
2912,31635,-80635,10,11,21,47.62,-0.011890476190476187,137.1904761904762
2913,2897,9353,17,10,27,62.96,0.020877777777777776,92.29629629629629
2915,15103,-24703,21,16,37,56.76,0.00277027027027027,52.86486486486486
2923,5727,32873,27,12,39,69.23,0.036874358974358985,49.07692307692308
2929,22601,-86151,20,27,47,42.55,-0.03526382978723404,30.48936170212766
2939,11890,-58840,13,13,26,50.0,-0.010050000000000003,27.76923076923077
3002,2468,16362,23,8,31,74.19,0.04594193548387097,69.74193548387096
3003,14943,24557,28,19,47,59.57,0.01986595744680851,34.702127659574465
3004,17050,41150,27,19,46,58.7,0.014458695652173916,37.69565217391305
3005,8117,43883,25,12,37,67.57,0.034197297297297306,49.270270270270274
3006,16870,1230,26,22,48,54.17,0.0073854166666666625,29.520833333333332
3008,960135,-1050135,27,25,52,51.92,0.006742307692307692,26.826923076923077
3010,9389,26661,15,8,23,65.22,0.030056521739130437,111.65217391304348
3011,3561,11809,28,19,47,59.57,0.025406382978723403,28.617021276595743
3013,5357,23693,30,17,47,63.83,0.027265957446808507,30.53191489361702
3014,13735,24665,26,18,44,59.09,0.004886363636363633,41.04545454545455
3015,5231,11219,17,13,30,56.67,0.011213333333333332,73.6
3016,14106,25624,30,22,52,57.69,0.014898076923076918,21.807692307692307
3017,15098,43452,32,18,50,64.0,0.016918000000000002,28.7
3018,7069,2021,23,24,47,48.94,0.006751063829787234,32.787234042553195
3019,18735,-31535,24,24,48,50.0,-0.0029291666666666667,31.041666666666668
3021,3623,5377,21,16,37,56.76,0.017551351351351354,47.24324324324324
3022,10709,-25859,19,17,36,52.78,-0.004827777777777776,49.666666666666664
3023,31510,162240,26,11,37,70.27,0.04046486486486486,52.67567567567568
3024,2629,12271,27,12,39,69.23,0.03404871794871796,42.46153846153846
3025,5660,21930,27,21,48,56.25,0.029504166666666665,28.354166666666668
3026,19203,81897,22,13,35,62.86,0.042091428571428564,55.91428571428571
3027,4455,1815,24,19,43,55.81,0.0002976744186046537,32.41860465116279
3028,3166,6034,14,9,23,60.87,0.01676521739130435,114.34782608695652
3029,6586,32764,26,14,40,65.0,0.03296249999999999,44.8
3030,8399,27951,17,10,27,62.96,0.02492962962962963,82.4074074074074
3031,4568,9512,28,21,49,57.14,0.015895918367346936,29.20408163265306
3032,6637,-6037,18,18,36,50.0,-0.003008333333333331,55.416666666666664
3033,3620,12830,17,9,26,65.38,0.026769230769230767,94.92307692307692
3034,54894,225606,26,15,41,63.41,0.02603658536585366,39.02439024390244
3035,24057,81843,33,19,52,63.46,0.02940961538461538,21.98076923076923
3036,7561,25689,16,10,26,61.54,0.028480769230769233,95.61538461538461
3037,19403,1297,27,22,49,55.1,0.012097959183673462,29.877551020408163
3038,3936,8114,25,18,43,58.14,0.011965116279069767,41.93023255813954
3040,6987,4763,17,17,34,50.0,0.018800000000000004,59.588235294117645
3041,6557,-45647,21,32,53,39.62,-0.027483018867924522,29.09433962264151
3042,12805,41045,24,14,38,63.16,0.023105263157894736,49.10526315789474
3043,3492,-8012,24,34,58,41.38,-0.008986206896551722,13.275862068965518
3044,21663,74237,26,14,40,65.0,0.02646,44.2
3045,7665,-13765,6,7,13,46.15,-0.007692307692307692,243.07692307692307
3046,5951,27849,31,20,51,60.78,0.023007843137254902,20.15686274509804
3047,3342,-2082,25,19,44,56.82,0.0011931818181818228,41.5
3048,4806,-11256,21,17,38,55.26,-0.0036315789473684245,50.86842105263158
3049,3202,-1662,23,24,47,48.94,-0.0023808510638297885,32.638297872340424
3050,2882,5328,25,13,38,65.79,0.018610526315789473,53.21052631578947
3051,3648,-2088,29,25,54,53.7,0.006768518518518515,18.962962962962962
3052,2341,6589,17,13,30,56.67,0.023343333333333334,76.66666666666667
3054,5086,1764,22,18,40,55.0,0.011764999999999998,48.175
3055,5705,17695,24,16,40,60.0,0.0146575,43.275
3056,5356,3144,19,16,35,54.29,0.005611428571428574,50.714285714285715
3057,5301,-21111,22,26,48,45.83,-0.005560416666666672,33.5625
3058,2815,-4455,18,19,37,48.65,-0.0029513513513513517,52.62162162162162
3059,8720,-22570,22,27,49,44.9,-0.010283673469387753,34.55102040816327
3060,12333,-34633,22,22,44,50.0,-0.011515909090909089,34.0
3062,5572,-23822,22,23,45,48.89,-0.012335555555555554,41.06666666666667
3090,9110,13090,23,12,35,65.71,0.022177142857142857,56.82857142857143
3094,7694,7706,28,20,48,58.33,0.01320833333333333,33.8125
3130,19862,101638,17,5,22,77.27,0.03623181818181819,116.5
3138,13350,-49720,14,16,30,46.67,0.15114333333333338,71.46666666666667
3149,5462,-17062,20,28,48,41.67,-0.005491666666666668,23.208333333333332
3164,6362,3038,21,17,38,55.26,0.018636842105263157,49.94736842105263
3167,11178,6772,22,20,42,52.38,0.014535714285714287,35.976190476190474
3189,30463,-35963,30,24,54,55.56,0.004203703703703701,28.555555555555557
3209,4952,-402,16,15,31,51.61,0.00652258064516129,73.0
3229,6300,-29700,19,33,52,36.54,-0.0194826923076923,27.5
3231,5787,3463,21,17,38,55.26,0.009257894736842104,48.28947368421053
3257,15228,-19328,23,19,42,54.76,4.76190476190437e-05,34.976190476190474
3266,2798,2652,17,13,30,56.67,0.022413333333333334,79.53333333333333
3296,5051,-11801,22,28,50,44.0,-0.008385999999999998,31.38
3305,8038,7612,20,18,38,52.63,0.008736842105263163,51.1578947368421
3308,3206,4964,27,17,44,61.36,0.022522727272727274,30.863636363636363
3311,6001,31699,27,14,41,65.85,0.04459024390243902,39.90243902439025
3312,3575,13965,27,15,42,64.29,0.025290476190476197,40.42857142857143
3321,3731,-12921,19,26,45,42.22,-0.01664222222222222,16.866666666666667
3338,11798,14202,25,20,45,55.56,0.00591777777777778,32.355555555555554
3346,8285,5515,18,12,30,60.0,0.029513333333333332,26.833333333333332
3356,17266,-127766,21,32,53,39.62,-0.03150188679245283,32.339622641509436
3376,23073,-34073,22,18,40,55.0,-0.0017899999999999986,47.3
3380,5945,5955,25,17,42,59.52,0.00837142857142857,35.23809523809524
3406,93662,298338,33,18,51,64.71,0.03876666666666667,17.45098039215686
3413,43850,9050,28,16,44,63.64,0.014450000000000001,22.136363636363637
3416,9900,14450,15,12,27,55.56,0.006833333333333334,90.62962962962963
3419,4714,-7154,25,21,46,54.35,-0.0027826086956521745,33.04347826086956
3432,4311,22479,33,14,47,70.21,0.03964255319148936,29.425531914893618
3437,7146,32354,28,17,45,62.22,0.03107777777777777,24.866666666666667
3443,98354,577546,32,19,51,62.75,0.03157254901960784,25.215686274509803
3450,27743,-35143,29,24,53,54.72,0.0023773584905660383,26.264150943396228
3454,27524,-77424,21,25,46,45.65,-0.016193478260869563,42.369565217391305
3481,3694,-15584,20,26,46,43.48,-0.020013043478260873,38.08695652173913
3494,3697,-8357,26,21,47,55.32,0.0138531914893617,23.70212765957447
3501,7340,-6390,13,12,25,52.0,-0.001439999999999999,95.08
3504,16743,89157,28,16,44,63.64,0.03325000000000001,26.181818181818183
3515,23752,79648,25,16,41,60.98,0.025563414634146343,35.926829268292686
3518,8977,14973,27,24,51,52.94,0.009041176470588235,23.705882352941178
3528,6534,32516,20,8,28,71.43,0.032603571428571426,87.57142857142857
3530,24505,11035,25,23,48,52.08,0.014447916666666664,24.041666666666668
3532,36986,11314,29,25,54,53.7,0.009400000000000004,21.333333333333332
3533,103967,91133,31,24,55,56.36,0.013196363636363635,29.672727272727272
3535,5850,-10190,28,29,57,49.12,-0.002435087719298243,24.49122807017544
3543,2605,3655,15,10,25,60.0,0.022572000000000002,55.52
3545,16917,-23967,24,25,49,48.98,0.0009183673469387809,24.387755102040817
3550,3733,3567,23,16,39,58.97,0.007715384615384615,45.666666666666664
3557,7226,-3186,21,17,38,55.26,0.012528947368421053,40.39473684210526
3563,55165,-64565,24,22,46,52.17,-0.002667391304347824,34.19565217391305
3576,5106,13594,25,21,46,54.35,0.01826739130434782,33.15217391304348
3583,16293,77007,27,14,41,65.85,0.033926829268292685,37.951219512195124
3588,17499,-17749,32,26,58,55.17,0.0065137931034482755,21.810344827586206
3591,6134,-134,28,25,53,52.83,0.0023528301886792486,27.150943396226417
3593,3400,-1510,20,25,45,44.44,0.0037088888888888887,27.42222222222222
3596,19670,45180,26,19,45,57.78,0.011700000000000002,33.733333333333334
3605,9314,-23814,24,27,51,47.06,-0.011105882352941174,26.764705882352942
3607,8137,-35087,23,22,45,51.11,-0.010028888888888893,36.68888888888889
3617,22052,21448,24,15,39,61.54,0.01596666666666667,48.205128205128204
3622,6415,-2605,28,22,50,56.0,0.010366,28.74
3645,14103,24847,32,20,52,61.54,0.021436538461538462,22.96153846153846
3653,55671,110929,31,21,52,59.62,0.016744230769230768,21.192307692307693
3661,96239,262511,29,19,48,60.42,0.023716666666666664,14.0625
3665,59304,93196,30,21,51,58.82,0.007621568627450979,26.137254901960784
3669,8587,-32237,20,20,40,50.0,-0.001755000000000001,40.25
3673,24088,69562,30,18,48,62.5,0.01721666666666667,28.25
3679,16951,16599,22,19,41,53.66,0.01803658536585366,47.853658536585364
3682,2316,-11386,14,19,33,42.42,-0.02338787878787879,66.3030303030303
3686,3389,-7339,21,26,47,44.68,-0.017834042553191494,30.638297872340427
3694,5425,18875,29,18,47,61.7,0.01731702127659575,30.21276595744681
3701,5049,-34959,14,24,38,36.84,-0.03462631578947367,47.973684210526315
3702,7494,19056,18,12,30,60.0,0.018716666666666666,86.8
3703,3361,1799,19,11,30,63.33,0.01673,71.5
3704,6484,-18274,24,28,52,46.15,-0.014682692307692306,29.73076923076923
3705,3854,2596,7,7,14,50.0,0.008257142857142855,209.57142857142858
3706,4734,14966,19,9,28,67.86,0.024978571428571433,77.32142857142857
3708,21665,-57565,19,18,37,51.35,-0.002375675675675675,24.054054054054053
3711,11746,6754,13,10,23,56.52,0.010543478260869567,38.95652173913044
3712,4134,2566,14,10,24,58.33,0.014162500000000001,33.416666666666664
3714,4982,-22232,6,7,13,46.15,-0.017730769230769234,32.07692307692308
4104,6823,127,12,9,21,57.14,0.0004476190476190472,130.0952380952381
4106,8549,-9049,23,20,43,53.49,0.002358139534883719,41.55813953488372
4108,6546,-41896,17,27,44,38.64,-0.02304318181818182,45.52272727272727
4119,19991,18709,24,14,38,63.16,0.017439473684210526,53.68421052631579
4133,9088,-10538,18,18,36,50.0,0.0042138888888888885,52.138888888888886
4137,49361,-239861,18,23,41,43.9,-0.020717073170731706,36.21951219512195
4142,8720,-30620,21,21,42,50.0,-0.008897619047619048,43.142857142857146
4155,7438,-30298,19,20,39,48.72,-0.013369230769230772,50.30769230769231
4164,10620,-12270,18,18,36,50.0,0.0006999999999999973,52.916666666666664
4190,17458,-125658,14,19,33,42.42,-0.027093939393939396,37.484848484848484
4306,2704,-2814,17,14,31,54.84,0.0011225806451612937,67.93548387096774
4414,4455,-13825,21,29,50,42.0,-0.020774,28.18
4426,14860,-28560,23,24,47,48.94,-0.015617021276595745,26.19148936170213
4438,17737,-89737,9,14,23,39.13,-0.023773913043478253,56.34782608695652
4439,11867,2133,9,6,15,60.0,0.009073333333333333,43.333333333333336
4526,4318,4082,19,17,36,52.78,0.018086111111111115,60.861111111111114
4532,4644,19756,20,11,31,64.52,0.031690322580645164,76.35483870967742
4536,28048,-76748,16,19,35,45.71,-0.008462857142857143,54.2
4540,8261,90749,16,14,30,53.33,0.10462666666666669,61.13333333333333
4545,5979,36371,17,12,29,58.62,0.04104827586206896,39.10344827586207
4551,35293,56207,27,15,42,64.29,0.018192857142857143,20.69047619047619
4552,8525,-83975,9,16,25,36.0,-0.04844799999999999,59.32
4555,6636,24514,11,8,19,57.89,0.027257894736842102,104.42105263157895
4557,10374,-8574,12,10,22,54.55,0.00426363636363636,84.0
4560,5983,-48573,8,13,21,38.1,-0.039299999999999995,78.9047619047619
4562,3873,-23173,8,15,23,34.78,-0.019721739130434783,87.1304347826087
4564,5290,480,12,11,23,52.17,0.012178260869565216,29.217391304347824
4566,7267,-6927,14,11,25,56.0,-0.00043599999999999916,41.28
4571,8388,-37288,7,10,17,41.18,-0.011670588235294115,41.470588235294116
4572,11708,105592,12,5,17,70.59,0.060447058823529416,24.058823529411764
4576,11141,-10441,10,10,20,50.0,0.0021399999999999987,27.85
4581,2420,10030,7,3,10,70.0,0.03785000000000001,72.8
4720,2026,6224,13,10,23,56.52,0.022895652173913043,116.34782608695652
4722,5622,6078,16,14,30,53.33,0.006013333333333335,79.8
4737,13668,57132,21,16,37,56.76,0.027729729729729737,51.972972972972975
4739,21116,35384,27,21,48,56.25,0.012045833333333334,25.5625
4746,17742,-46292,23,25,48,47.92,-0.011160416666666667,35.708333333333336
4755,16870,72580,25,14,39,64.1,0.02745897435897435,46.56410256410256
4763,28686,91514,20,13,33,60.61,0.012154545454545453,35.60606060606061
4764,7507,-8697,10,10,20,50.0,-0.003565000000000001,86.5
4766,14359,-9859,9,8,17,52.94,0.0005823529411764705,60.64705882352941
4807,5168,-43228,7,15,22,31.82,-0.03636818181818182,67.72727272727273
4904,6195,-15695,7,8,15,46.67,-0.008306666666666667,196.33333333333334
4906,6424,6576,27,16,43,62.79,0.011623255813953487,39.55813953488372
4912,38070,-2470,30,23,53,56.6,0.012526415094339624,27.18867924528302
4915,13585,65065,30,15,45,66.67,0.03053555555555556,33.55555555555556
4916,8615,-14365,24,21,45,53.33,-0.002611111111111112,31.488888888888887
4919,21534,48066,33,21,54,61.11,0.02415185185185185,28.814814814814813
4927,13348,24602,29,17,46,63.04,0.015910869565217395,31.97826086956522
4930,4479,18471,24,16,40,60.0,0.0297175,44.825
4934,6346,5354,29,25,54,53.7,0.0040462962962962935,25.185185185185187
4935,17518,-126168,16,29,45,35.56,-0.0386,38.17777777777778
4938,14126,-57426,17,19,36,47.22,-0.012983333333333331,56.888888888888886
4942,6194,2556,17,15,32,53.12,0.004746874999999999,64.71875
4943,29295,-46455,18,25,43,41.86,-0.013672093023255814,14.930232558139535
4952,10656,-7706,23,18,41,56.1,0.004624390243902439,39.90243902439025
4956,5513,-17583,21,27,48,43.75,-0.012045833333333332,33.166666666666664
4958,21983,3217,23,17,40,57.5,0.011075000000000002,43.625
4960,3931,-10561,23,22,45,51.11,0.00033777777777777636,33.77777777777778
4961,22046,-211956,17,23,40,42.5,-0.027012500000000002,47.1
4967,7045,12475,21,20,41,51.22,0.010312195121951225,29.146341463414632
4968,38439,-68039,25,17,42,59.52,0.009528571428571428,16.904761904761905
4976,11948,-13498,27,25,52,51.92,0.0002750000000000028,23.653846153846153
4977,25472,-33672,25,23,48,52.08,-0.005129166666666664,29.75
4989,5053,14417,18,15,33,54.55,0.00022424242424242584,22.393939393939394
4994,21943,54357,27,18,45,60.0,0.019946666666666665,31.6
4999,7593,3957,15,12,27,55.56,0.008200000000000004,85.0
5007,6531,-53531,6,12,18,33.33,-0.03591111111111111,166.38888888888889
5203,15878,88122,19,11,30,63.33,0.03579333333333333,82.23333333333333
5215,12998,31402,22,20,42,52.38,0.012680952380952383,41.166666666666664
5225,11375,-12175,24,24,48,50.0,0.0003458333333333334,34.6875
5234,16090,26060,23,15,38,60.53,0.01726315789473684,43.23684210526316
5243,12000,-8050,24,21,45,53.33,-0.0023444444444444446,34.77777777777778
5258,6821,58129,20,13,33,60.61,0.0370030303030303,26.87878787878788
5269,199963,1452037,36,17,53,67.92,0.03315471698113208,14.735849056603774
5283,9081,94949,17,4,21,80.95,0.07724761904761905,120.85714285714286
5284,8183,9467,12,11,23,52.17,0.0036565217391304338,91.69565217391305
5285,14405,11445,21,15,36,58.33,0.00836388888888889,41.333333333333336
5288,23339,73061,22,12,34,64.71,0.019441176470588236,47.705882352941174
5388,14538,-5738,19,15,34,55.88,0.002605882352941177,64.44117647058823
5434,21138,94762,24,12,36,66.67,0.030477777777777777,58.55555555555556
5469,7520,15010,27,19,46,58.7,0.010119565217391305,33.76086956521739
5471,10291,-18491,18,16,34,52.94,0.0013647058823529406,61.1764705882353
5484,3106,754,21,24,45,46.67,0.0023733333333333323,37.888888888888886
5515,1504,-6034,8,12,20,40.0,-0.02241999999999999,149.7
5519,2769,-14119,12,15,27,44.44,-0.02192222222222222,92.29629629629629
5521,2335,-565,17,16,33,51.52,0.008136363636363638,64.72727272727273
5522,7294,-1394,14,14,28,50.0,0.0023535714285714262,90.71428571428571
5525,2519,-3519,10,10,20,50.0,-0.0029749999999999976,138.5
5531,2601,3339,17,14,31,54.84,0.014729032258064512,74.29032258064517
5533,1268,5082,7,5,12,58.33,0.02691666666666667,253.91666666666666
5534,11908,2292,16,12,28,57.14,0.010489285714285711,88.53571428571429
5538,5845,5855,16,11,27,59.26,0.014337037037037037,81.66666666666667
5546,4473,-23423,4,8,12,33.33,-0.029508333333333334,43.583333333333336
5607,6625,-4925,19,17,36,52.78,-0.004580555555555553,57.166666666666664
5608,4564,-244,19,20,39,48.72,-0.002035897435897439,49.58974358974359
5706,7335,10365,15,10,25,60.0,0.01636,92.16
5871,28077,87923,26,13,39,66.67,0.031212820512820504,47.87179487179487
5876,4767,4963,11,8,19,57.89,0.007921052631578945,105.42105263157895
5880,1865,11485,11,4,15,73.33,0.041426666666666674,201.2
5906,5357,3493,27,24,51,52.94,0.03191764705882353,24.137254901960784
5907,6875,-14475,18,20,38,47.37,-0.0020736842105263165,49.921052631578945
6005,1885,865,15,10,25,60.0,0.010736,98.0
6024,4724,-11624,10,10,20,50.0,-0.004375000000000002,128.15
6108,3961,-17061,15,16,31,48.39,-0.01261935483870968,73.38709677419355
6112,5428,-27378,11,14,25,44.0,-0.017552,103.88
6115,3505,15195,9,5,14,64.29,0.031657142857142856,216.14285714285714
6116,3278,-6198,23,23,46,50.0,-0.0010717391304347834,35.58695652173913
6117,3737,17413,26,13,39,66.67,0.027679487179487178,45.07692307692308
6120,4629,-11719,23,27,50,46.0,-0.004104000000000001,29.92
6128,4507,4793,13,10,23,56.52,0.01045217391304348,110.65217391304348
6133,2284,13416,19,10,29,65.52,0.03783448275862069,70.79310344827586
6136,1789,-2389,6,8,14,42.86,-0.0021714285714285737,216.92857142857142
6139,7195,41755,24,14,38,63.16,0.030734210526315798,52.21052631578947
6141,5298,4642,28,19,47,59.57,0.012393617021276596,33.638297872340424
6142,2581,5039,24,15,39,61.54,0.021258974358974357,40.69230769230769
6152,3245,-7905,22,24,46,47.83,0.000671739130434783,35.28260869565217
6153,8772,-27472,23,26,49,46.94,-0.010161224489795917,31.714285714285715
6155,4917,29633,26,9,35,74.29,0.048548571428571434,49.142857142857146
6164,3366,-4236,23,20,43,53.49,0.0008395348837209301,35.348837209302324
6165,6579,18761,33,18,51,64.71,0.027100000000000003,19.901960784313726
6166,17210,-29160,22,25,47,46.81,-0.008657446808510636,38.61702127659574
6168,4799,1841,28,19,47,59.57,0.010448936170212765,28.595744680851062
6176,21527,42823,25,14,39,64.1,0.02075641025641026,49.58974358974359
6177,4857,20843,18,10,28,64.29,0.030678571428571434,86.35714285714286
6183,3790,41610,13,3,16,81.25,0.06288125,178.1875
6184,3600,9800,9,5,14,64.29,0.02413571428571428,208.78571428571428
6189,3698,14102,12,6,18,66.67,0.02792222222222222,156.33333333333334
6191,5687,-8137,29,22,51,56.86,0.0007921568627450987,33.98039215686274
6192,8401,27399,13,9,22,59.09,0.022236363636363637,120.5909090909091
6196,17970,86230,31,14,45,68.89,0.03942666666666667,33.46666666666667
6197,8053,36497,25,14,39,64.1,0.02574615384615384,46.02564102564103
6201,3593,18607,11,7,18,61.11,0.030661111111111108,161.72222222222223
6202,16353,58547,23,15,38,60.53,0.02900789473684211,50.60526315789474
6205,9455,-45655,16,23,39,41.03,-0.016751282051282054,39.38461538461539
6206,15884,-27084,16,14,30,53.33,-0.001516666666666667,80.03333333333333
6209,8359,-359,28,22,50,56.0,0.007097999999999996,27.06
6213,19687,-41437,23,22,45,51.11,-0.006946666666666666,36.48888888888889
6214,9654,13596,15,10,25,60.0,0.012508000000000003,94.56
6215,5663,-1013,23,27,50,46.0,0.003606,28.76
6216,3989,27761,17,7,24,70.83,0.048220833333333324,104.54166666666667
6224,17754,33946,22,17,39,56.41,0.02020769230769231,54.205128205128204
6225,3070,-8700,23,33,56,41.07,-0.01711964285714286,14.982142857142858
6226,3101,6879,25,19,44,56.82,0.022454545454545453,35.90909090909091
6230,31958,-104358,20,20,40,50.0,-0.009597499999999998,35.7
6235,7148,-34548,29,23,52,55.77,0.005644230769230771,29.0
6239,15534,55816,21,12,33,63.64,0.023193939393939395,64.12121212121212
6243,5925,68005,34,15,49,69.39,0.0742142857142857,21.489795918367346
6257,7155,2045,18,14,32,56.25,0.00488125,69.53125
6269,22017,68383,23,15,38,60.53,0.023426315789473687,48.05263157894737
6271,41124,-73724,23,24,47,48.94,-0.0011659574468085127,31.851063829787233
6277,11421,-18521,11,12,23,47.83,-0.0031434782608695667,117.30434782608695
6278,19459,-36609,24,21,45,53.33,-0.0006333333333333336,37.68888888888889
6281,3147,6453,5,3,8,62.5,0.012450000000000003,411.875
6282,7234,20816,27,17,44,61.36,0.01904772727272727,40.79545454545455
6283,8915,8245,25,26,51,49.02,0.0035666666666666646,22.941176470588236
6285,16639,-25939,20,17,37,54.05,-0.0027918918918918914,58.86486486486486
6288,5779,-21089,22,25,47,46.81,-0.011231914893617021,29.085106382978722
6405,6280,-8880,22,20,42,52.38,-0.000804761904761904,34.92857142857143
6409,211383,441117,27,14,41,65.85,0.02517317073170732,40.390243902439025
6412,11614,31186,19,13,32,59.38,0.018903124999999996,65.125
6414,93191,141809,33,20,53,62.26,0.01967735849056603,23.962264150943398
6415,407249,-1153249,32,23,55,58.18,0.005234545454545455,21.672727272727272
6416,26188,82762,27,16,43,62.79,0.02823953488372093,36.48837209302326
6431,4416,9774,20,16,36,55.56,0.026088888888888898,38.47222222222222
6438,15283,19317,19,13,32,59.38,0.012731250000000001,26.96875
6442,7322,9078,16,13,29,55.17,0.01811034482758621,55.310344827586206
6443,4978,-4268,19,20,39,48.72,-0.0008461538461538454,26.666666666666668
6449,10315,14685,23,17,40,57.5,0.015425,33.775
6451,26101,-15101,21,19,40,52.5,-0.0025675000000000003,22.675
6456,26424,-10024,19,19,38,50.0,-0.00024999999999999984,29.94736842105263
6464,7055,-22155,5,6,11,45.45,-0.017372727272727272,215.36363636363637
6477,7406,17994,21,13,34,61.76,0.02384411764705882,29.058823529411764
6491,42497,105123,16,12,28,57.14,0.04472857142857143,62.607142857142854
6504,33687,-20587,18,19,37,48.65,0.002197297297297301,56.45945945945946
6505,12769,7831,13,10,23,56.52,0.0048347826086956504,120.43478260869566
6515,33388,192612,9,4,13,69.23,0.045492307692307686,19.846153846153847
6525,11149,35451,15,11,26,57.69,0.022942307692307692,52.80769230769231
6531,51973,38627,23,15,38,60.53,0.02341315789473684,18.86842105263158
6533,54130,-130730,18,19,37,48.65,-0.006099999999999997,20.243243243243242
6541,18755,-71815,18,22,40,45.0,-0.017220000000000003,26.125
6552,11334,-41284,13,19,32,40.62,-0.012215625,26.1875
6558,5400,26990,19,7,26,73.08,0.04377307692307692,23.884615384615383
6573,4586,-7336,16,13,29,55.17,0.004186206896551725,24.103448275862068
6579,12329,4021,12,12,24,50.0,0.0032458333333333315,69.625
6581,12329,-12579,13,11,24,54.17,0.008104166666666668,51.375
6582,18861,-96361,13,16,29,44.83,-0.017272413793103448,36.44827586206897
6591,11511,7489,19,12,31,61.29,0.016193548387096773,32.225806451612904
6592,5200,29700,7,2,9,77.78,0.0409,87.22222222222223
6598,6071,-69611,5,15,20,25.0,-0.05786999999999999,17.3
6605,16743,-4743,16,16,32,50.0,0.0011031250000000017,69.25
6625,5272,-9422,11,10,21,52.38,0.005185714285714284,38.23809523809524
6641,4392,-8492,6,6,12,50.0,-0.007058333333333337,94.66666666666667
6655,6510,48540,11,4,15,73.33,0.05932666666666667,63.13333333333333
6666,10914,23686,10,8,18,55.56,0.014633333333333332,45.166666666666664
6668,8565,5285,13,12,25,52.0,0.003648000000000001,21.36
6669,84921,79079,11,8,19,57.89,0.01306315789473684,31.94736842105263
6670,18397,101103,12,4,16,75.0,0.04016875,53.1875
6671,2446,3204,6,4,10,60.0,0.010789999999999998,92.4
6672,11954,-87654,8,15,23,34.78,-0.03534782608695652,30.17391304347826
6674,3320,-11820,8,11,19,42.11,-0.008226315789473679,46.31578947368421
6698,4836,-236,9,10,19,47.37,0.0021421052631578957,26.210526315789473
6706,16391,-20991,9,10,19,47.37,-0.006026315789473686,21.94736842105263
6715,11062,-71062,6,9,15,40.0,-0.023139999999999997,44.13333333333333
6743,5369,-12469,7,5,12,58.33,0.003333333333333332,18.833333333333332
6754,2493,9407,5,4,9,55.56,0.020644444444444448,73.33333333333333
6756,28087,-37087,8,8,16,50.0,0.0029687500000000026,13.5625
8011,6061,12289,26,19,45,57.78,0.015177777777777781,35.44444444444444
8016,34253,31297,25,18,43,58.14,0.012776744186046511,36.06976744186046
8021,5395,-9645,18,17,35,51.43,-0.004248571428571427,61.142857142857146
8028,10754,9096,23,15,38,60.53,0.02668421052631579,35.89473684210526
8033,4128,21132,26,15,41,63.41,0.03460731707317073,34.90243902439025
8039,9130,21270,21,13,34,61.76,0.01783529411764706,62.73529411764706
8046,38247,-125947,30,20,50,60.0,0.012948,25.44
8070,22292,22708,23,18,41,56.1,0.01025853658536585,47.65853658536585
8072,6213,-53463,16,19,35,45.71,-0.020685714285714283,63.0
8081,29513,35287,23,15,38,60.53,0.011013157894736843,52.60526315789474
8101,2791,-8061,20,27,47,42.55,-0.0004234042553191463,33.5531914893617
8103,8620,-19270,21,22,43,48.84,-0.010490697674418603,43.627906976744185
8104,9896,-59916,11,16,27,40.74,-0.02073703703703704,32.44444444444444
8105,4113,-14913,23,26,49,46.94,-0.013804081632653061,32.91836734693877
8110,3537,63,24,19,43,55.81,0.0067534883720930215,41.116279069767444
8112,6145,12655,22,13,35,62.86,0.019234285714285714,55.57142857142857
8114,27175,18925,20,15,35,57.14,0.012691428571428572,57.91428571428571
8131,4252,25248,17,8,25,68.0,0.034696,92.64
8150,7973,3227,22,18,40,55.0,0.008747500000000004,41.125
8163,8194,-1694,25,19,44,56.82,0.008768181818181816,40.52272727272727
8201,3448,-2218,23,21,44,52.27,0.0009090909090909105,37.15909090909091
8210,15380,4070,24,20,44,54.55,0.006224999999999998,41.27272727272727
8213,7787,15013,21,14,35,60.0,0.012945714285714291,61.885714285714286
8215,8144,-6994,29,25,54,53.7,0.004609259259259258,23.333333333333332
8222,4202,548,17,15,32,53.12,0.015740625000000005,46.53125
8249,4472,7128,20,13,33,60.61,0.013736363636363635,65.27272727272727
8261,13457,-30607,25,24,49,51.02,-0.0008816326530612229,26.285714285714285
8271,9217,-24417,20,24,44,45.45,-0.010677272727272728,47.20454545454545
8341,33437,-22937,15,16,31,48.39,-0.0011580645161290333,49.45161290322581
8367,4920,-5220,13,11,24,54.17,0.012629166666666664,51.708333333333336
8374,5479,35741,28,12,40,70.0,0.03770749999999999,38.9
8404,7860,-32860,18,20,38,47.37,-0.01078421052631579,52.3421052631579
8411,5992,-23392,24,12,36,66.67,0.019411111111111115,45.55555555555556
8422,17145,-17645,9,8,17,52.94,0.003088235294117648,156.05882352941177
8429,9055,-82545,18,30,48,37.5,-0.03707708333333334,32.5625
8442,5732,52568,13,4,17,76.47,0.061,81.0
8443,2259,-1199,12,11,23,52.17,0.006630434782608697,87.3913043478261
8454,132848,375652,20,17,37,54.05,0.012010810810810811,38.432432432432435
8462,22885,-10885,15,11,26,57.69,0.006734615384615385,50.07692307692308
8463,4605,-3205,12,15,27,44.44,0.0065370370370370365,61.370370370370374
8464,60264,115236,21,13,34,61.76,0.015223529411764707,36.705882352941174
8466,7514,-58814,7,13,20,35.0,-0.03934,83.75
8467,7013,-1163,12,13,25,48.0,0.011032000000000004,56.64
8473,5189,-41539,5,14,19,26.32,-0.04192631578947368,94.84210526315789
8478,31821,123819,19,13,32,59.38,0.019534375,31.4375
8481,5773,-2723,9,8,17,52.94,0.0057529411764705865,98.82352941176471
8482,6862,-12762,5,7,12,41.67,-0.009941666666666665,105.25
8488,2270,-14420,8,11,19,42.11,-0.007747368421052631,85.0
8499,13952,4748,10,12,22,45.45,0.0018681818181818086,47.27272727272727
8926,3087,11063,12,6,18,66.67,0.02932222222222221,130.27777777777777
8940,2747,5983,15,14,29,51.72,0.012072413793103452,76.27586206896552
8996,17503,-56453,23,23,46,50.0,-0.005902173913043478,26.47826086956522
9802,21363,56987,26,15,41,63.41,0.02322682926829268,39.609756097560975
9902,2289,5841,18,12,30,60.0,0.02402666666666666,76.23333333333333
9904,7492,-42042,14,22,36,38.89,-0.02749722222222222,60.861111111111114
9905,2447,-9397,7,8,15,46.67,-0.013513333333333339,196.26666666666668
9906,7713,13637,24,20,44,54.55,0.008613636363636367,33.95454545454545
9907,3274,-11504,16,16,32,50.0,-0.014153124999999999,67.71875
9908,1453,5797,6,3,9,66.67,0.029411111111111117,360.8888888888889
9910,43143,-11143,24,20,44,54.55,0.004965909090909091,38.61363636363637
9911,5703,29497,16,9,25,64.0,0.030232000000000002,90.84
9912,2394,8976,21,13,34,61.76,0.034079411764705886,54.1764705882353
9914,57041,28959,27,22,49,55.1,0.007802040816326531,35.02040816326531
9917,5930,31570,8,3,11,72.73,0.036927272727272725,275.0
9918,2544,14406,9,3,12,75.0,0.03605,271.5833333333333
9919,3801,1199,16,14,30,53.33,0.021110000000000004,73.26666666666667
9921,49362,-189862,16,22,38,42.11,-0.01952105263157895,52.86842105263158
9924,5556,-756,13,11,24,54.17,0.0026750000000000016,110.58333333333333
9925,1996,-5596,4,5,9,44.44,-0.012711111111111112,369.77777777777777
9926,3271,16079,8,4,12,66.67,0.03140833333333334,270.3333333333333
9927,3809,22791,12,6,18,66.67,0.04088333333333334,145.44444444444446
9928,2950,4830,20,21,41,48.78,0.02311951219512194,43.36585365853659
9929,2307,553,15,15,30,50.0,0.006166666666666668,74.73333333333333
9930,4353,9947,8,5,13,61.54,0.01820769230769231,228.92307692307693
9931,2830,520,8,5,13,61.54,0.005076923076923075,243.23076923076923
9933,8165,-26065,15,17,32,46.88,-0.012234374999999999,78.59375
9934,3230,1420,18,15,33,54.55,0.0026303030303030345,61.78787878787879
9935,4497,-6157,20,20,40,50.0,0.006557499999999999,41.475
9937,3436,23164,9,4,13,69.23,0.04826923076923078,233.69230769230768
9938,19687,91613,31,15,46,67.39,0.030656521739130436,32.69565217391305
9939,8456,46694,17,6,23,73.91,0.03290434782608696,110.21739130434783
9940,5047,-6447,14,10,24,58.33,0.0014291666666666712,109.66666666666667
9941,21687,135713,21,9,30,70.0,0.04291666666666667,73.76666666666667
9942,15104,18296,16,11,27,59.26,0.015922222222222216,84.77777777777777
9943,6635,15865,12,8,20,60.0,0.01949,137.15
9944,5129,-9879,16,16,32,50.0,0.004859375000000001,65.9375
9945,10385,-18935,19,18,37,51.35,-0.0010945945945945914,59.108108108108105
9946,3343,-593,18,16,34,52.94,0.004576470588235297,55.529411764705884
9955,4530,5670,24,17,41,58.54,0.014814634146341462,38.829268292682926
9958,15150,32810,21,18,39,53.85,0.00599230769230769,46.64102564102564
1312A,2436,-136,9,6,15,60.0,0.006879999999999999,198.66666666666666
2002A,1389,-3489,2,3,5,40.0,-0.005000000000000004,680.6
2836A,125,-1675,0,1,1,0.0,-0.0738,877.0
2838A,619,1881,1,1,2,50.0,0.0207,998.5
2881A,1080,-280,2,1,3,66.67,0.002099999999999999,836.6666666666666
2881B,347,-1947,0,1,1,0.0,-0.0321,1843.0
2882A,673,-3373,1,1,2,50.0,-0.0248,1120.5
2882B,667,-2767,1,1,2,50.0,-0.019950000000000002,881.0
2887E,571,-3421,1,1,2,50.0,-0.030899999999999997,1139.0
2887F,551,-4601,1,1,2,50.0,-0.04355,772.0
2888A,864,-13714,0,4,4,0.0,-0.084275,300.5
2888B,423,-8423,0,2,2,0.0,-0.1071,469.0
2891B,1083,-1683,1,2,3,33.33,-0.006733333333333334,620.3333333333334
2891C,347,-2747,0,1,1,0.0,-0.045,1514.0
2897A,138,-1028,1,1,2,50.0,-0.0491,773.5
3702A,542,-10592,0,2,2,0.0,-0.10375,642.5
5871A,573,-1473,0,1,1,0.0,-0.0149,993.0
9941A,284,-3934,0,1,1,0.0,-0.0767,1682.0
1240,4422,25728,10,5,15,66.67,0.03904,75.2
1259,6500,200,8,7,15,53.33,0.003620000000000003,188.4
1264,20003,69497,9,5,14,64.29,0.02519285714285714,158.5
1268,10565,-5145,7,6,13,53.85,0.006000000000000001,158.15384615384616
1336,4136,2454,23,17,40,57.5,0.015865000000000004,42.125
1565,130503,-580503,19,23,42,45.24,-0.012585714285714287,43.357142857142854
1569,7018,-9828,27,24,51,52.94,-0.004301960784313725,29.372549019607842
1570,3337,10863,22,14,36,61.11,0.019691666666666666,51.97222222222222
1580,20583,-36683,14,13,27,51.85,-8.518518518518551e-05,82.62962962962963
1584,3782,13328,28,16,44,63.64,0.032575,34.31818181818182
1586,6678,14372,20,13,33,60.61,0.022736363636363627,63.121212121212125
1591,6523,4427,23,17,40,57.5,0.0139975,35.35
1593,11764,-1314,19,16,35,54.29,0.012642857142857147,58.4
1595,10409,-32559,16,20,36,44.44,-0.0073472222222222255,54.77777777777778
1599,9537,-6587,19,19,38,50.0,0.00023421052631578815,54.44736842105263
1742,4620,-6120,19,22,41,46.34,-0.0023829268292682934,39.75609756097561
1752,7753,28347,19,13,32,59.38,0.023409375000000003,62.375
1777,11344,7456,13,11,24,54.17,0.009979166666666666,108.29166666666667
1781,5328,-19818,18,25,43,41.86,-0.011453488372093024,32.325581395348834
1784,10325,9475,25,20,45,55.56,0.008926666666666664,39.644444444444446
1785,6605,18895,25,13,38,65.79,0.021534210526315788,41.68421052631579
1788,10596,73904,13,3,16,81.25,0.048975000000000005,182.1875
1796,6973,-1513,13,11,24,54.17,0.0061458333333333365,38.833333333333336
1799,6466,16524,28,20,48,58.33,0.025024999999999995,25.354166666666668
1813,4618,-21768,14,17,31,45.16,-0.01505806451612903,72.87096774193549
1815,3210,3790,23,15,38,60.53,0.01234736842105263,44.578947368421055
2035,5367,-9717,10,13,23,43.48,-0.00345217391304348,121.52173913043478
2061,4180,-19310,19,26,45,42.22,-0.007086666666666668,33.24444444444445
2063,4658,8042,14,10,24,58.33,0.015629166666666666,96.45833333333333
2064,2736,-3536,12,15,27,44.44,0.000540740740740741,74.5925925925926
2065,4867,4333,11,8,19,57.89,0.005626315789473682,69.73684210526316
2066,18331,88369,21,13,34,61.76,0.03179705882352941,57.73529411764706
2067,3290,5580,18,18,36,50.0,0.023994444444444447,51.166666666666664
2070,4553,-12533,10,11,21,47.62,0.003952380952380952,82.71428571428571
2221,6790,19660,26,18,44,59.09,0.02625,37.02272727272727
2230,4382,10488,24,17,41,58.54,0.013541463414634145,41.80487804878049
2235,13566,-25466,14,16,30,46.67,-0.007603333333333333,58.333333333333336
2596,2573,-10823,10,13,23,43.48,-0.018339130434782608,107.52173913043478
2640,17365,-14665,19,14,33,57.58,0.014296969696969693,56.06060606060606
2641,3102,958,20,18,38,52.63,0.0046026315789473695,35.89473684210526
2643,7614,27286,16,10,26,61.54,0.01639615384615384,51.11538461538461
2718,5112,-21162,13,16,29,44.83,-0.016610344827586214,70.0
2719,5097,-39407,17,33,50,34.0,-0.03647,32.28
2724,4129,-33449,15,31,46,32.61,-0.02897826086956522,29.17391304347826
2726,11101,11249,19,15,34,55.88,0.017117647058823533,39.470588235294116
2729,35143,60857,14,10,24,58.33,0.013020833333333334,95.375
2732,24353,-73153,17,21,38,44.74,-0.015002631578947365,36.60526315789474
2734,6645,7435,23,21,44,52.27,0.018465909090909092,28.863636363636363
2736,3310,-10110,15,14,29,51.72,4.137931034483068e-05,44.58620689655172
2740,6357,-27407,14,25,39,35.9,-0.01709487179487179,30.897435897435898
2743,5687,5013,15,13,28,53.57,0.01349642857142857,24.785714285714285
2745,5340,5380,17,10,27,62.96,0.03286666666666666,46.77777777777778
2752,10129,-13129,5,5,10,50.0,-0.00765,94.5
2754,5131,85569,6,2,8,75.0,0.07209999999999998,72.375
2755,3694,26106,5,3,8,62.5,0.027737500000000002,65.75
2916,2340,9610,12,6,18,66.67,0.03476666666666666,151.27777777777777
2924,6279,-19429,11,15,26,42.31,-0.0035269230769230772,92.26923076923077
2926,15560,-77410,10,13,23,43.48,-0.01668695652173913,109.52173913043478
2937,4087,9063,14,10,24,58.33,0.022487499999999997,67.33333333333333
3064,6664,6436,23,27,50,46.0,0.030070000000000006,24.98
3066,3779,-7039,23,24,47,48.94,-0.0003872340425531893,29.638297872340427
3067,4989,-7399,18,19,37,48.65,0.0075027027027027016,53.351351351351354
3071,4407,1183,24,18,42,57.14,0.005004761904761905,33.976190476190474
3073,4446,11614,25,24,49,51.02,0.015036734693877557,19.163265306122447
3078,8368,21082,28,18,46,60.87,0.02350652173913043,31.565217391304348
3081,73705,-32705,24,20,44,54.55,-0.0036249999999999967,25.181818181818183
3083,13564,55536,26,20,46,56.52,0.02954565217391304,23.956521739130434
3085,4154,-26064,20,31,51,39.22,-0.030988235294117646,15.372549019607844
3086,8489,-103709,20,30,50,40.0,-0.020518,20.84
3088,13120,56780,23,13,36,63.89,0.02826944444444444,53.166666666666664
3089,8917,7273,29,23,52,55.77,0.012836538461538465,13.615384615384615
3092,11726,-22976,25,25,50,50.0,0.001816000000000001,27.66
3093,9583,50017,23,12,35,65.71,0.028205714285714285,59.22857142857143
3095,3219,-7509,24,30,54,44.44,-0.001392592592592591,20.833333333333332
3105,59175,-29075,32,25,57,56.14,0.011842105263157895,21.0
3114,4155,18645,23,10,33,69.7,0.039427272727272734,50.84848484848485
3115,3753,-2613,20,22,42,47.62,-0.00024285714285714253,41.30952380952381
3118,4472,4478,13,10,23,56.52,0.010073913043478263,115.08695652173913
3122,5384,24906,23,15,38,60.53,0.019178947368421052,27.86842105263158
3128,4653,12497,27,18,45,60.0,0.013120000000000001,31.755555555555556
3131,67666,71334,29,20,49,59.18,0.012451020408163267,25.775510204081634
3141,16950,-57650,26,21,47,55.32,-0.0005978723404255337,22.23404255319149
3147,6922,24908,17,16,33,51.52,0.015303030303030303,42.45454545454545
3152,78812,39688,28,24,52,53.85,0.0024673076923076923,23.5
3162,6175,24455,28,17,45,62.22,0.024744444444444447,28.466666666666665
3163,15166,-13166,26,24,50,52.0,-0.003396,26.42
3169,16526,-12076,25,20,45,55.56,0.0012466666666666613,31.444444444444443
3171,3100,-10550,12,17,29,41.38,-0.015758620689655178,76.82758620689656
3176,25949,701,24,23,47,51.06,0.005553191489361704,27.680851063829788
3178,10618,16842,23,19,42,54.76,0.013116666666666669,25.714285714285715
3188,3403,-1253,18,20,38,47.37,0.004223684210526315,51.3421052631579
3191,5244,18116,26,22,48,54.17,0.02239374999999999,27.1875
3202,4489,-1819,27,23,50,54.0,0.007953999999999996,23.54
3205,25845,-145095,22,31,53,41.51,-0.005877358490566037,25.50943396226415
3206,6014,15836,25,14,39,64.1,0.023887179487179482,49.51282051282051
3207,5530,38560,25,21,46,54.35,0.02979347826086956,35.369565217391305
3211,12108,21742,19,12,31,61.29,0.01126774193548387,68.29032258064517
3213,8140,-25790,14,16,30,46.67,-0.014209999999999993,75.3
3217,16076,-8776,27,19,46,58.7,0.010697826086956524,31.97826086956522
3218,31359,104541,26,13,39,66.67,0.029692307692307695,39.0
3219,11833,-14033,18,29,47,38.3,0.0008744680851063823,21.872340425531913
3221,6240,10010,26,18,44,59.09,0.01693409090909091,29.522727272727273
3224,12163,-9563,25,23,48,52.08,0.01100625,32.291666666666664
3226,8591,-22091,12,13,25,48.0,-0.005224000000000002,99.64
3227,29200,93800,28,17,45,62.22,0.02768,33.82222222222222
3228,31168,50982,27,20,47,57.45,0.020561702127659568,23.340425531914892
3230,2721,579,23,17,40,57.5,0.006235000000000002,34.175
3232,8104,-20854,24,27,51,47.06,0.001190196078431375,22.980392156862745
3234,11904,-954,31,21,52,59.62,0.013007692307692307,23.03846153846154
3236,7228,21592,31,20,51,60.78,0.017894117647058824,26.372549019607842
3252,4630,3120,19,17,36,52.78,0.018411111111111114,47.361111111111114
3259,7598,24402,30,16,46,65.22,0.026680434782608693,21.23913043478261
3260,16905,47695,27,19,46,58.7,0.01826086956521739,32.73913043478261
3264,8803,21647,27,16,43,62.79,0.022446511627906972,37.97674418604651
3265,8080,37320,28,15,43,65.12,0.02746511627906977,34.651162790697676
3268,4970,-3590,19,26,45,42.22,-0.0025066666666666714,30.755555555555556
3272,13132,-9932,23,20,43,53.49,0.002355813953488367,27.325581395348838
3276,3556,-13746,18,26,44,40.91,-0.013104545454545454,40.5
3284,3298,12352,23,15,38,60.53,0.028418421052631575,51.31578947368421
3285,6114,7986,25,21,46,54.35,0.007484782608695651,35.45652173913044
3287,4005,3695,27,23,50,54.0,0.0031060000000000003,27.94
3288,3913,7817,24,25,49,48.98,0.02144489795918367,16.93877551020408
3289,20133,6617,25,22,47,53.19,0.0032425531914893626,29.46808510638298
3290,4982,-5732,23,21,44,52.27,-0.0007181818181818167,37.38636363636363
3293,103300,-402300,28,24,52,53.85,-0.0017096153846153862,25.365384615384617
3294,5571,79,28,24,52,53.85,0.008299999999999998,30.134615384615383
3297,5493,-14903,21,24,45,46.67,0.000795555555555553,43.06666666666667
3303,4352,-852,18,16,34,52.94,0.002211764705882355,62.1764705882353
3306,6518,47232,28,14,42,66.67,0.04175238095238095,32.76190476190476
3310,6191,18709,21,15,36,58.33,0.021766666666666667,48.47222222222222
3313,3973,21837,25,15,40,62.5,0.0327925,35.75
3317,10470,-720,29,19,48,60.42,0.015152083333333335,23.583333333333332
3322,3870,8500,25,22,47,53.19,0.01729787234042553,25.29787234042553
3323,6695,18405,23,14,37,62.16,0.022078378378378383,53.4054054054054
3324,34401,69199,30,21,51,58.82,0.011098039215686278,19.235294117647058
3325,4667,-5967,24,19,43,55.81,0.008027906976744187,25.651162790697676
3332,4671,10679,11,8,19,57.89,0.01821052631578948,143.42105263157896
3339,4045,-6435,28,30,58,48.28,-0.011484482758620691,18.586206896551722
3354,3952,11738,27,16,43,62.79,0.032130232558139536,32.674418604651166
3360,4844,-27974,20,27,47,42.55,-0.024040425531914895,35.91489361702128
3362,14541,-26591,23,28,51,45.1,-0.003341176470588235,21.784313725490197
3363,8773,10477,27,22,49,55.1,0.010214285714285714,27.877551020408163
3372,3201,3139,22,21,43,51.16,0.0007976744186046505,40.04651162790697
3373,9042,-47692,20,24,44,45.45,-0.008436363636363632,36.61363636363637
3374,22250,-3800,25,19,44,56.82,0.014918181818181823,22.795454545454547
3379,3596,16764,27,13,40,67.5,0.0390125,36.725
3388,6720,3480,9,7,16,56.25,0.009762499999999999,185.875
3390,4592,10308,23,14,37,62.16,0.023643243243243246,43.810810810810814
3402,5920,-3020,20,16,36,55.56,0.007213888888888887,57.25
3426,4696,-6796,8,7,15,53.33,0.006226666666666662,119.86666666666666
3434,4053,14277,27,15,42,64.29,0.026623809523809525,37.214285714285715
3438,11630,-38730,26,27,53,49.06,-0.008271698113207547,25.11320754716981
3441,9106,23844,31,23,54,57.41,0.024085185185185185,19.87037037037037
3444,8520,6530,23,20,43,53.49,0.008337209302325581,41.55813953488372
3455,14082,-582,27,21,48,56.25,0.007391666666666665,31.75
3465,11150,111500,28,15,43,65.12,0.0457,27.813953488372093
3466,6127,-23577,18,29,47,38.3,-0.013423404255319144,33.808510638297875
3479,11177,-24777,16,17,33,48.48,-0.004366666666666666,55.93939393939394
3483,13459,-23009,26,24,50,52.0,-0.008077999999999998,26.08
3484,11846,-47196,22,23,45,48.89,-0.013337777777777775,35.91111111111111
3489,2616,-26,20,13,33,60.61,0.014003030303030307,66.21212121212122
3490,11979,1971,26,24,50,52.0,0.0048280000000000016,30.06
3491,23288,56112,26,19,45,57.78,0.011682222222222219,33.022222222222226
3492,6039,-5389,23,19,42,54.76,0.00650238095238095,32.07142857142857
3498,14555,-6605,25,23,48,52.08,0.001070833333333331,26.3125
3499,4288,5612,26,19,45,57.78,0.016704444444444445,29.08888888888889
3508,9529,-36729,28,29,57,49.12,-0.009424561403508775,19.912280701754387
3511,8846,-18446,28,27,55,50.91,-0.011198181818181822,22.2
3512,6754,-10194,20,15,35,57.14,0.005831428571428572,52.17142857142857
3516,2887,8793,21,15,36,58.33,0.019383333333333332,53.361111111111114
3520,14017,-4037,23,28,51,45.1,-0.008139215686274511,17.705882352941178
3521,4686,-6946,27,23,50,54.0,0.0014439999999999998,30.32
3522,5509,-20149,20,27,47,42.55,-0.011919148936170212,28.93617021276596
3523,4639,971,20,30,50,40.0,-0.002901999999999998,28.86
3526,21611,-42511,26,20,46,56.52,0.0028086956521739133,29.23913043478261
3527,30461,-25911,30,24,54,55.56,0.0035240740740740757,27.59259259259259
3529,171155,538645,25,16,41,60.98,0.024009756097560973,29.78048780487805
3531,4241,10309,19,14,33,57.58,0.018515151515151516,71.12121212121212
3537,7080,-15280,24,18,42,57.14,4.52380952380971e-05,44.11904761904762
3540,9244,-29894,27,25,52,51.92,-0.003996153846153845,26.73076923076923
3541,22684,-73784,23,22,45,51.11,-0.01408,33.666666666666664
3546,18498,52902,30,15,45,66.67,0.03002444444444444,30.022222222222222
3548,13547,50503,26,15,41,63.41,0.025697560975609754,37.78048780487805
3551,12064,21786,25,18,43,58.14,0.01703488372093023,42.23255813953488
3552,49688,38112,34,18,52,65.38,0.027640384615384615,18.53846153846154
3555,8384,30496,24,24,48,50.0,0.025518749999999996,28.333333333333332
3556,14073,16127,20,17,37,54.05,0.011440540540540538,56.86486486486486
3558,41603,-82403,24,21,45,53.33,-0.003297777777777775,34.733333333333334
3564,9197,4403,23,18,41,56.1,0.0013170731707317091,33.1219512195122
3567,4811,42039,25,8,33,75.76,0.057445454545454536,57.96969696969697
3570,17340,-18940,19,17,36,52.78,0.004327777777777776,55.27777777777778
3577,9768,53782,25,12,37,67.57,0.0346972972972973,50.108108108108105
3580,9899,-16779,28,23,51,54.9,0.011637254901960783,21.03921568627451
3581,4271,22629,26,10,36,72.22,0.037752777777777774,32.75
3587,28940,96910,28,21,49,57.14,0.0173734693877551,32.3469387755102
3594,7948,-8898,24,17,41,58.54,0.002078048780487806,37.65853658536585
3597,2808,22612,16,7,23,69.57,0.05220869565217392,109.56521739130434
3609,6792,10508,23,21,44,52.27,0.019509090909090906,44.84090909090909
3611,56719,-10719,22,19,41,53.66,0.006007317073170733,46.21951219512195
3615,6299,-13249,23,26,49,46.94,-0.010451020408163265,30.306122448979593
3623,9361,-31661,24,26,50,48.0,-0.003792000000000001,30.46
3624,9273,427,25,24,49,51.02,0.004857142857142856,28.877551020408163
3625,5008,14492,28,17,45,62.22,0.02584888888888889,32.28888888888889
3628,9596,11104,21,15,36,58.33,0.011258333333333335,52.416666666666664
3629,9733,33827,28,19,47,59.57,0.037202127659574466,21.170212765957448
3630,15070,-57520,25,28,53,47.17,-0.0029754716981132056,23.528301886792452
3631,8532,-39582,18,25,43,41.86,-0.017302325581395352,36.0
3632,4145,-1065,19,23,42,45.24,-0.006564285714285715,42.57142857142857
3646,5652,-10802,24,22,46,52.17,0.0028239130434782604,31.152173913043477
3652,5796,37404,29,15,44,65.91,0.042611363636363635,33.47727272727273
3663,6252,23298,28,15,43,65.12,0.031104651162790695,39.69767441860465
3664,5562,15068,32,22,54,59.26,0.018977777777777777,18.833333333333332
3666,6820,-4470,23,21,44,52.27,0.013254545454545458,21.386363636363637
3672,5186,-12086,17,20,37,45.95,-0.013327027027027032,36.027027027027025
3675,32194,63206,32,24,56,57.14,0.009546428571428572,24.875
3680,38776,31224,30,22,52,57.69,0.007607692307692306,25.26923076923077
3684,9215,435,18,15,33,54.55,0.013475757575757575,57.03030303030303
3685,10376,-25576,20,27,47,42.55,-0.0011787234042553156,26.72340425531915
3687,18887,36663,25,23,48,52.08,0.009308333333333332,24.3125
3689,11698,29352,26,15,41,63.41,0.027939024390243903,37.292682926829265
3691,91777,-355177,29,26,55,52.73,-0.0033163636363636377,24.4
3693,21449,-34399,22,22,44,50.0,0.005168181818181821,21.318181818181817
3707,12566,-5776,27,25,52,51.92,0.01228076923076923,16.903846153846153
3709,3099,1801,12,10,22,54.55,0.020768181818181814,53.81818181818182
3710,2127,7243,18,13,31,58.06,0.02747096774193548,19.35483870967742
3713,2904,8496,7,7,14,50.0,0.015064285714285712,27.214285714285715
4102,5759,-22259,20,23,43,46.51,-0.016411627906976745,45.7906976744186
4105,15872,-16072,17,15,32,53.12,0.0019312500000000024,70.8125
4107,22109,-13209,20,15,35,57.14,0.004522857142857142,55.542857142857144
4109,4133,-4333,18,18,36,50.0,-0.0007749999999999999,54.833333333333336
4111,4371,10229,17,10,27,62.96,0.022159259259259257,83.81481481481481
4113,2261,3949,15,10,25,60.0,0.014084,97.52
4114,6646,-5396,18,17,35,51.43,-0.002068571428571429,63.857142857142854
4116,6299,-13999,11,13,24,45.83,0.0034625000000000016,61.375
4120,15113,-63263,20,23,43,46.51,-0.012432558139534885,48.604651162790695
4121,4053,7577,23,18,41,56.1,0.014646341463414635,40.073170731707314
4123,14690,13210,21,16,37,56.76,0.007448648648648652,45.810810810810814
4126,14028,-22328,16,15,31,51.61,-0.005870967741935483,74.61290322580645
4127,3995,8745,25,17,42,59.52,0.019007142857142854,41.476190476190474
4128,10261,-18911,24,18,42,57.14,0.004971428571428573,42.333333333333336
4129,10065,185,18,15,33,54.55,0.0005000000000000009,62.878787878787875
4130,8122,-14172,18,20,38,47.37,-0.005994736842105264,47.18421052631579
4131,3495,-6615,23,26,49,46.94,-0.00028163265306122465,27.959183673469386
4138,10582,21768,17,10,27,62.96,0.019855555555555553,83.03703703703704
4139,11016,-40416,13,20,33,39.39,-0.016090909090909097,57.06060606060606
4147,33512,-137412,18,23,41,43.9,-0.011348780487804876,23.4390243902439
4153,13410,-28860,26,23,49,53.06,-0.000716326530612248,30.73469387755102
4154,7176,-29126,19,25,44,43.18,-0.01524090909090909,37.63636363636363
4157,5770,-32570,19,24,43,44.19,-0.019220930232558133,39.7906976744186
4160,5524,23126,18,13,31,58.06,0.02993225806451613,67.70967741935483
4161,12538,-54688,19,20,39,48.72,-0.011394871794871796,54.282051282051285
4162,41616,-78116,22,28,50,44.0,-0.014001999999999997,24.3
4163,30121,-51221,21,19,40,52.5,-0.002590000000000001,41.95
4167,4618,-3468,17,16,33,51.52,0.005006060606060607,38.09090909090909
4168,10206,-56206,19,25,44,43.18,-0.014602272727272731,32.59090909090909
4171,17462,45988,21,22,43,48.84,0.013846511627906977,25.209302325581394
4173,5815,-6665,19,20,39,48.72,-0.0003923076923076879,47.12820512820513
4174,54204,-178804,20,24,44,45.45,-0.0036750000000000042,26.386363636363637
4175,10333,4367,13,10,23,56.52,0.010178260869565216,97.91304347826087
4183,2038,-6588,9,9,18,50.0,-0.011083333333333334,70.61111111111111
4188,3958,-24458,12,15,27,44.44,-0.010607407407407406,60.22222222222222
4192,8382,-24532,17,20,37,45.95,-0.0035837837837837836,35.75675675675676
4198,4208,-15498,16,24,40,40.0,0.034282499999999994,28.225
4205,9277,30073,12,6,18,66.67,0.030900000000000007,156.33333333333334
4207,2521,2669,18,13,31,58.06,0.013364516129032257,75.61290322580645
4303,8075,135535,23,17,40,57.5,0.08502250000000001,49.075
4304,3687,-2137,25,31,56,44.64,0.0008357142857142814,20.892857142857142
4305,2538,212,8,6,14,57.14,0.005014285714285714,219.28571428571428
4401,13007,-32957,16,20,36,44.44,-0.014658333333333332,51.77777777777778
4402,2767,3493,23,21,44,52.27,0.02775909090909091,28.0
4406,1895,-295,14,13,27,51.85,0.006092592592592594,92.48148148148148
4413,3687,-1077,23,20,43,53.49,0.012988372093023256,37.23255813953488
4416,14103,33397,14,11,25,56.0,0.018128,98.88
4417,5191,-1291,15,11,26,57.69,0.008457692307692308,87.03846153846153
4419,3359,-6519,19,32,51,37.25,-0.00893137254901961,20.019607843137255
4420,5425,7475,18,13,31,58.06,0.015899999999999997,68.83870967741936
4430,4638,-15488,15,12,27,55.56,-0.011851851851851855,93.11111111111111
4432,11512,-31912,22,25,47,46.81,0.0042234042553191496,33.808510638297875
4433,6917,2833,18,18,36,50.0,0.009372222222222223,42.861111111111114
4502,9094,-30754,16,21,37,43.24,-0.0021999999999999984,47.054054054054056
4503,8065,10885,26,23,49,53.06,0.01632857142857143,22.73469387755102
4506,6338,53762,18,6,24,75.0,0.04904166666666666,103.29166666666667
4510,3292,1888,20,15,35,57.14,0.017594285714285715,58.885714285714286
4513,3141,7149,25,13,38,65.79,0.025942105263157895,47.78947368421053
4523,5136,11964,20,14,34,58.82,0.0196,57.73529411764706
4527,3642,-1042,13,9,22,59.09,0.005109090909090911,121.0909090909091
4528,12735,615,23,20,43,53.49,0.0044813953488372065,36.95348837209303
4529,6621,11389,25,27,52,48.08,0.023496153846153847,20.557692307692307
4530,3615,3985,28,30,58,48.28,0.0399155172413793,21.379310344827587
4533,2318,-668,17,12,29,58.62,0.005172413793103449,75.93103448275862
4534,4407,-10037,25,21,46,54.35,0.007867391304347826,25.652173913043477
4535,4893,17557,13,9,22,59.09,0.023568181818181818,116.72727272727273
4538,2436,6084,15,9,24,62.5,0.022270833333333333,112.16666666666667
4541,6805,4845,21,16,37,56.76,0.018083783783783784,41.4054054054054
4542,4970,-18420,15,17,32,46.88,-0.015246875,55.71875
4543,3607,-2657,14,15,29,48.28,0.0037103448275862057,47.172413793103445
4549,14443,14857,17,10,27,62.96,0.009537037037037037,70.81481481481481
4550,3598,-798,13,14,27,48.15,0.003385185185185186,74.5925925925926
4554,5232,-3382,18,15,33,54.55,0.0010636363636363651,26.151515151515152
4556,2721,3079,8,6,14,57.14,0.00865,140.92857142857142
4561,3524,6076,12,9,21,57.14,0.01601428571428571,45.38095238095238
4563,6337,-30307,13,11,24,54.17,-0.0061125000000000025,49.25
4568,3296,-13596,4,5,9,44.44,-0.01626666666666667,141.33333333333334
4580,4307,-21907,4,4,8,50.0,-0.021037500000000008,110.875
4609,2727,14003,23,16,39,58.97,0.039125641025641034,48.666666666666664
4702,3869,4021,24,23,47,51.06,0.0038595744680851064,34.87234042553192
4706,1989,2561,12,7,19,63.16,0.012078947368421054,151.21052631578948
4707,2226,-586,17,14,31,54.84,-0.00018709677419354457,77.09677419354838
4711,2625,-13425,10,17,27,37.04,-0.020037037037037037,97.25925925925925
4712,4164,-31814,16,34,50,32.0,-0.034672,20.74
4714,3445,14735,28,14,42,66.67,0.031388095238095236,38.80952380952381
4716,3289,811,20,15,35,57.14,0.014142857142857143,53.25714285714286
4721,20363,-21913,27,22,49,55.1,0.00964285714285714,25.714285714285715
4726,10350,-8750,22,25,47,46.81,0.00031489361702127675,28.19148936170213
4728,17192,3558,24,20,44,54.55,0.0056454545454545455,32.65909090909091
4729,4162,2048,24,22,46,52.17,0.009802173913043482,28.76086956521739
4735,10936,21864,25,19,44,56.82,0.008804545454545454,38.13636363636363
4736,35274,-97674,21,20,41,51.22,-0.007995121951219512,35.97560975609756
4741,11914,-58404,16,18,34,47.06,-0.00930294117647059,56.73529411764706
4743,35761,-30111,26,24,50,52.0,-0.0010119999999999981,24.06
4744,6815,37995,24,15,39,61.54,0.04174358974358975,33.17948717948718
4745,12583,-27033,19,19,38,50.0,0.00012894736842105267,50.3421052631579
4747,7837,-30437,12,14,26,46.15,-0.012415384615384616,86.07692307692308
4754,4730,-18230,7,10,17,41.18,-0.015247058823529414,96.58823529411765
4760,10950,-37740,12,17,29,41.38,-0.020889655172413788,30.79310344827586
4767,2107,12443,11,3,14,78.57,0.038085714285714285,71.21428571428571
4804,7155,-54335,13,24,37,35.14,-0.050686486486486486,21.35135135135135
4806,6305,-43595,14,29,43,32.56,-0.03016744186046512,19.046511627906977
4903,5199,-13759,22,29,51,43.14,-0.007925490196078426,23.96078431372549
4905,6273,3177,15,8,23,65.22,0.015443478260869564,104.21739130434783
4907,4596,-9396,18,19,37,48.65,0.00024054054054054011,50.5945945945946
4908,7360,10840,30,15,45,66.67,0.01653333333333333,26.266666666666666
4909,5665,-33665,19,24,43,44.19,-0.027088372093023252,43.06976744186046
4911,15731,-86831,16,26,42,38.1,-0.02073571428571428,37.45238095238095
4924,4274,5836,21,20,41,51.22,0.01994878048780488,43.707317073170735
4931,4266,2084,12,14,26,46.15,-0.005015384615384614,22.615384615384617
4933,8537,-24137,19,23,42,45.24,-0.006969047619047618,42.166666666666664
4939,4955,5065,27,21,48,56.25,0.017799999999999996,32.645833333333336
4944,5450,7570,28,25,53,52.83,0.004867924528301888,19.77358490566038
4945,5325,29775,10,4,14,71.43,0.04136428571428571,21.5
4946,11284,-15634,20,24,44,45.45,0.0022181818181818184,27.522727272727273
4950,4879,-25809,18,27,45,40.0,-0.015724444444444444,43.0
4953,17672,11428,27,19,46,58.7,0.02049782608695652,28.5
4966,238519,-308519,28,30,58,48.28,-0.008589655172413791,25.086206896551722
4971,24340,-88740,27,29,56,48.21,-0.013598214285714285,24.107142857142858
4972,4904,-2604,11,14,25,44.0,0.003128,104.88
4973,5347,6153,21,17,38,55.26,0.01589473684210526,47.05263157894737
4974,10354,7796,21,16,37,56.76,0.005875675675675674,55.972972972972975
4979,12426,624,31,26,57,54.39,0.0001859649122807,17.80701754385965
4987,10055,-27005,12,13,25,48.0,-0.005951999999999997,94.16
4991,15881,-45581,21,24,45,46.67,-0.009228888888888889,35.022222222222226
4995,9188,13712,22,17,39,56.41,0.01863333333333333,48.38461538461539
5009,4385,19615,22,10,32,68.75,0.03471250000000001,62.3125
5011,6305,-11705,21,21,42,50.0,-0.00037380952380952425,46.04761904761905
5013,3914,28786,18,7,25,72.0,0.04746399999999999,97.8
5014,4095,-2735,26,22,48,54.17,0.009989583333333331,31.0
5015,6245,15055,18,14,32,56.25,0.025015625,65.28125
5016,3734,11816,11,10,21,52.38,0.022452380952380953,135.85714285714286
5201,4856,20294,23,12,35,65.71,0.03431714285714286,53.857142857142854
5202,4712,16978,30,15,45,66.67,0.03009777777777778,26.333333333333332
5205,4134,-12904,23,21,44,52.27,0.013652272727272725,23.0
5206,2293,5737,15,12,27,55.56,0.021570370370370368,88.37037037037037
5209,7503,-7903,14,7,21,66.67,0.020061904761904763,118.0952380952381
5210,2566,2344,18,15,33,54.55,0.019133333333333336,61.878787878787875
5211,5911,1389,24,22,46,52.17,0.011980434782608695,35.52173913043478
5212,7620,17580,22,19,41,53.66,0.015460975609756095,48.78048780487805
5213,2647,703,14,11,25,56.0,0.009919999999999998,87.0
5220,4371,-9071,12,13,25,48.0,-0.008048000000000001,60.68
5223,6054,4946,12,8,20,60.0,0.025719999999999993,41.6
5227,10278,-28458,23,27,50,46.0,-0.0002560000000000007,23.94
5230,11031,-44081,20,25,45,44.44,-0.016362222222222216,40.53333333333333
5245,16924,-100424,18,27,45,40.0,-0.03652666666666667,24.88888888888889
5251,7729,-49729,23,22,45,51.11,-0.012315555555555555,39.77777777777778
5263,57806,-132406,24,24,48,50.0,-0.004293749999999996,27.020833333333332
5272,11629,-12429,27,24,51,52.94,0.004962745098039216,24.07843137254902
5274,370213,866787,32,24,56,57.14,0.010189285714285717,19.321428571428573
5276,3342,-4732,17,16,33,51.52,0.003321212121212118,54.84848484848485
5278,28229,47471,25,21,46,54.35,0.007293478260869565,31.217391304347824
5281,6219,-13519,17,15,32,53.12,0.005871874999999993,39.1875
5287,52256,-202756,16,18,34,47.06,-0.014064705882352938,58.61764705882353
5289,30122,40578,23,16,39,58.97,0.01364871794871795,42.30769230769231
5291,5077,20573,23,14,37,62.16,0.02837027027027027,32.810810810810814
5299,23343,15897,21,22,43,48.84,0.03624651162790697,39.395348837209305
5301,6311,-38341,19,23,42,45.24,-0.005221428571428576,30.38095238095238
5302,2991,6989,26,20,46,56.52,0.024913043478260868,31.82608695652174
5306,27366,-84866,16,17,33,48.48,-0.019603030303030303,66.93939393939394
5309,6536,674,26,23,49,53.06,0.003571428571428573,26.816326530612244
5310,7021,5649,22,21,43,51.16,0.017790697674418602,34.95348837209303
5312,8061,-12161,9,9,18,50.0,0.0,158.77777777777777
5314,3320,4270,30,25,55,54.55,0.006458181818181818,20.254545454545454
5315,4466,-1046,26,17,43,60.47,0.01784883720930233,33.53488372093023
5321,14001,-21471,23,34,57,40.35,0.01718771929824561,19.12280701754386
5324,2883,-31443,13,18,31,41.94,-0.027022580645161286,72.38709677419355
5328,3130,1550,23,21,44,52.27,0.015477272727272728,32.70454545454545
5340,6145,1795,25,20,45,55.56,0.011113333333333333,28.733333333333334
5344,3571,1749,22,23,45,48.89,0.012528888888888893,29.377777777777776
5345,2881,-13761,14,33,47,29.79,-0.03735531914893617,32.319148936170215
5347,21472,-5372,27,22,49,55.1,0.005255102040816328,36.265306122448976
5348,3343,1607,23,28,51,45.1,0.007668627450980394,27.07843137254902
5351,7817,-12867,27,25,52,51.92,0.0046865384615384625,26.153846153846153
5353,3799,5671,22,14,36,61.11,0.016450000000000006,56.388888888888886
5355,2328,-328,22,15,37,59.46,0.008975675675675674,41.891891891891895
5356,6828,18422,18,13,31,58.06,0.024245161290322576,69.64516129032258
5364,5947,-6547,17,16,33,51.52,0.015172727272727273,57.666666666666664
5371,9856,14794,20,18,38,52.63,0.01688421052631579,47.3421052631579
5381,2452,-2452,21,25,46,45.65,-0.004980434782608691,31.130434782608695
5383,4835,16875,26,20,46,56.52,0.019163043478260863,32.76086956521739
5386,11776,-96376,21,33,54,38.89,-0.025592592592592594,21.98148148148148
5392,9347,-19447,22,15,37,59.46,-0.0014162162162162158,48.729729729729726
5398,5964,-31864,13,25,38,34.21,-0.018247368421052634,48.31578947368421
5403,5547,37353,14,6,20,70.0,0.04479,129.75
5410,2544,8406,13,9,22,59.09,0.023036363636363633,114.13636363636364
5425,16443,-1743,31,22,53,58.49,0.00015660377358490306,23.37735849056604
5426,2238,11432,19,8,27,70.37,0.03794814814814815,80.48148148148148
5432,6441,25259,26,19,45,57.78,0.031095555555555564,36.355555555555554
5438,2915,1135,17,16,33,51.52,0.006696969696969697,62.484848484848484
5439,8831,4069,22,17,39,56.41,0.00990769230769231,42.205128205128204
5443,6451,2199,27,19,46,58.7,0.007367391304347826,32.369565217391305
5450,4420,2020,25,23,48,52.08,0.011139583333333333,32.354166666666664
5452,3522,-12642,18,23,41,43.9,-0.015556097560975611,45.0
5455,4422,2318,24,28,52,46.15,-0.00398846153846154,25.75
5457,16912,19288,29,24,53,54.72,0.022275471698113204,25.77358490566038
5460,1771,-3421,11,11,22,50.0,-0.0038545454545454547,126.95454545454545
5464,4038,812,19,15,34,55.88,0.011564705882352935,54.44117647058823
5465,3760,1550,20,16,36,55.56,0.0061555555555555565,46.888888888888886
5468,4706,-7856,26,37,63,41.27,-0.019504761904761907,15.333333333333334
5474,26505,-149205,22,28,50,44.0,-0.014127999999999996,24.32
5475,3476,-16696,21,28,49,42.86,-0.00996938775510204,20.714285714285715
5478,19834,68666,27,14,41,65.85,0.025760975609756098,34.19512195121951
5481,3858,-7788,20,19,39,51.28,-0.004635897435897437,48.51282051282051
5483,22097,115303,28,15,43,65.12,0.028176744186046508,29.976744186046513
5487,5645,12955,20,13,33,60.61,0.01954848484848485,62.09090909090909
5488,2764,2126,25,18,43,58.14,0.01135581395348837,39.41860465116279
5489,7432,-10582,14,13,27,51.85,0.0031777777777777785,90.29629629629629
5490,10301,-7301,21,21,42,50.0,-0.003814285714285712,38.57142857142857
5493,6010,19340,17,11,28,60.71,0.019935714285714286,86.39285714285714
5498,2896,7514,24,15,39,61.54,0.026258974358974358,38.30769230769231
5508,8203,1397,16,13,29,55.17,0.010396551724137932,84.93103448275862
5511,3078,11722,12,6,18,66.67,0.02005555555555556,147.55555555555554
5512,1735,1185,13,11,24,54.17,0.01192916666666667,112.0
5514,3307,-6147,15,17,32,46.88,0.0016093749999999997,76.5
5516,3389,7261,21,20,41,51.22,0.010099999999999996,46.5609756097561
5520,5094,29456,15,7,22,68.18,0.03653636363636364,130.72727272727272
5523,3247,4643,19,15,34,55.88,0.019997058823529413,52.55882352941177
5529,4000,-17190,20,30,50,40.0,-0.0048360000000000035,26.86
5530,7060,-39610,7,13,20,35.0,-0.032795000000000005,137.9
5536,29801,49299,20,15,35,57.14,0.018279999999999994,65.68571428571428
5543,5544,-1294,12,11,23,52.17,0.0035391304347826037,70.43478260869566
5601,3754,10596,12,9,21,57.14,0.019066666666666666,126.0
5603,3614,13586,19,13,32,59.38,0.021621875000000002,63.40625
5604,6466,6634,13,10,23,56.52,0.016217391304347822,113.04347826086956
5609,9490,-190,20,14,34,58.82,0.0187,60.44117647058823
5701,1987,-3907,19,21,40,47.5,-0.023665,47.3
5703,3317,6083,13,12,25,52.0,0.015476,99.88
5704,6461,28539,18,14,32,56.25,0.020015625000000002,68.0
5864,2305,-5965,15,14,29,51.72,0.0023448275862068975,68.34482758620689
5878,2781,-10831,5,5,10,50.0,-0.01371,275.9
5902,4091,9259,19,18,37,51.35,0.019270270270270274,54.432432432432435
5903,23730,48770,12,7,19,63.16,0.019194736842105264,143.05263157894737
5904,86347,-53347,22,17,39,56.41,0.008141025641025638,47.0
5905,2686,1564,21,15,36,58.33,0.0076055555555555555,55.05555555555556
6015,2964,-7394,20,21,41,48.78,-0.0010634146341463428,47.36585365853659
6016,2291,-4911,18,15,33,54.55,0.0005060606060606062,64.6969696969697
6020,1932,2668,10,9,19,52.63,0.022426315789473676,148.1578947368421
6021,3090,-6070,17,20,37,45.95,-0.007270270270270271,58.86486486486486
6023,4497,9503,11,6,17,64.71,0.020135294117647057,170.94117647058823
6026,2052,-2912,15,11,26,57.69,0.004315384615384614,59.11538461538461
6101,8586,8864,27,23,50,54.0,0.012582,26.08
6103,4321,-3421,25,34,59,42.37,0.0012762711864406785,17.305084745762713
6104,21348,-2898,30,24,54,55.56,0.010146296296296296,23.09259259259259
6109,3180,-2370,19,21,40,47.5,0.0032125000000000035,44.3
6111,25294,168746,34,16,50,68.0,0.04268799999999999,24.52
6113,3827,-8947,22,30,52,42.31,-0.012619230769230765,28.51923076923077
6114,10063,-21203,24,17,41,58.54,0.015270731707317072,32.24390243902439
6118,4564,2546,29,17,46,63.04,0.016473913043478262,30.608695652173914
6121,46902,-46502,18,19,37,48.65,0.008924324324324323,54.513513513513516
6122,2707,8703,22,12,34,64.71,0.018158823529411762,56.1764705882353
6123,8117,21633,21,14,35,60.0,0.023891428571428574,57.34285714285714
6124,7499,17651,27,20,47,57.45,0.016217021276595744,29.914893617021278
6125,5007,9233,28,19,47,59.57,0.013929787234042555,33.8936170212766
6126,4740,15130,29,18,47,61.7,0.025270212765957447,33.680851063829785
6127,5115,18545,29,21,50,58.0,0.027714,23.94
6129,5176,704,29,22,51,56.86,0.00795294117647059,24.392156862745097
6130,9365,-15865,22,22,44,50.0,0.007547727272727273,30.613636363636363
6134,3905,-2295,22,23,45,48.89,0.009648888888888887,29.444444444444443
6138,23751,19449,35,17,52,67.31,0.03717884615384616,24.692307692307693
6140,3816,8924,25,18,43,58.14,0.016467441860465115,35.325581395348834
6143,16854,-58354,27,25,52,51.92,-0.010425,28.384615384615383
6144,3738,-10978,18,31,49,36.73,-0.01596530612244898,33.46938775510204
6146,43661,-31661,22,18,40,55.0,0.003837499999999998,47.675
6147,14870,6530,24,18,42,57.14,0.008942857142857145,43.19047619047619
6148,3194,20116,28,13,41,68.29,0.03799024390243903,31.829268292682926
6150,21030,-33610,29,27,56,51.79,0.0068464285714285745,16.482142857142858
6151,4285,-2035,15,14,29,51.72,0.0027931034482758603,79.79310344827586
6154,1402,-2752,6,8,14,42.86,-0.002342857142857142,224.5
6156,4787,17523,29,18,47,61.7,0.035455319148936175,30.06382978723404
6158,7438,13582,31,20,51,60.78,0.016149019607843144,29.705882352941178
6160,5017,19833,23,17,40,57.5,0.032420000000000004,33.525
6161,5084,10176,26,20,46,56.52,0.005404347826086955,34.891304347826086
6163,3787,-1077,23,17,40,57.5,0.006012499999999999,44.225
6167,2759,8471,30,15,45,66.67,0.024540000000000003,28.555555555555557
6169,7608,32142,26,23,49,53.06,0.030718367346938773,24.591836734693878
6170,5713,16867,30,19,49,61.22,0.027365306122448974,32.204081632653065
6171,4227,-15227,18,24,42,42.86,-0.018478571428571428,51.07142857142857
6173,11160,10150,27,23,50,54.0,0.009341999999999996,27.72
6174,4312,10538,24,13,37,64.86,0.023391891891891888,47.54054054054054
6175,7217,6533,25,22,47,53.19,0.010755319148936172,30.361702127659573
6179,7304,16896,21,17,38,55.26,0.019892105263157895,52.0
6180,14528,-59228,20,25,45,44.44,-0.012731111111111108,40.733333333333334
6182,9997,-19587,26,23,49,53.06,0.0031571428571428597,28.122448979591837
6185,4575,-13575,20,17,37,54.05,-0.009686486486486488,50.21621621621622
6186,4720,17580,18,12,30,60.0,0.025890000000000007,71.3
6187,21574,-6674,30,24,54,55.56,0.0043722222222222235,21.666666666666668
6188,8684,38266,26,15,41,63.41,0.028465853658536586,36.170731707317074
6190,5043,-7083,25,21,46,54.35,-0.005352173913043477,37.95652173913044
6194,3503,3947,14,11,25,56.0,0.017283999999999997,93.52
6195,9703,-47103,14,17,31,45.16,-0.014438709677419358,74.90322580645162
6198,5215,-1425,15,25,40,37.5,0.0184325,40.5
6199,4430,6010,24,19,43,55.81,0.021088372093023253,41.30232558139535
6203,12109,32791,24,15,39,61.54,0.025761538461538464,40.53846153846154
6204,7653,-34203,16,14,30,53.33,0.006986666666666669,74.73333333333333
6207,7152,14998,25,19,44,56.82,0.01741818181818182,37.65909090909091
6208,6421,21899,25,14,39,64.1,0.021289743589743584,44.794871794871796
6210,6773,2477,14,12,26,53.85,0.011661538461538461,95.0
6212,6057,-8457,13,14,27,48.15,-0.0029666666666666656,93.44444444444444
6217,11728,32772,33,17,50,66.0,0.017424000000000005,29.42
6218,3510,15940,18,11,29,62.07,0.02795862068965517,86.79310344827586
6219,3663,3887,23,16,39,58.97,0.009979487179487177,48.35897435897436
6220,8251,35449,32,16,48,66.67,0.026204166666666667,29.229166666666668
6221,7642,32858,23,8,31,74.19,0.03324838709677418,70.12903225806451
6222,3193,6487,23,21,44,52.27,0.019193181818181818,22.59090909090909
6223,26018,96182,32,18,50,64.0,0.026419999999999996,23.36
6227,6461,15389,29,15,44,65.91,0.019088636363636367,33.36363636363637
6228,3745,15165,25,22,47,53.19,0.040670212765957434,27.148936170212767
6229,5595,20955,28,18,46,60.87,0.028654347826086952,33.06521739130435
6231,18521,57579,34,18,52,65.38,0.02932115384615384,22.846153846153847
6233,5763,17317,25,25,50,50.0,0.020147999999999996,27.08
6234,5556,-18706,21,20,41,51.22,-0.00847317073170732,46.90243902439025
6236,5884,-6904,16,24,40,40.0,0.0031324999999999977,28.525
6237,10366,-27066,23,24,47,48.94,-0.0023659574468085105,27.872340425531913
6240,5675,-17525,22,19,41,53.66,0.003773170731707319,27.121951219512194
6241,5091,7349,24,23,47,51.06,0.0120404255319149,33.340425531914896
6242,8044,836,14,17,31,45.16,0.008383870967741935,60.0
6244,8450,-32770,23,28,51,45.1,-0.012017647058823532,29.274509803921568
6245,14618,18282,27,16,43,62.79,0.014418604651162788,37.7906976744186
6246,4507,-16347,19,39,58,32.76,-0.0276,20.448275862068964
6248,4850,-750,18,21,39,46.15,-0.00303846153846154,40.256410256410255
6259,4220,-6620,22,33,55,40.0,-0.015450909090909093,19.509090909090908
6261,10509,-33159,14,16,30,46.67,-0.012883333333333333,77.13333333333334
6263,8015,64335,17,6,23,73.91,0.04234347826086956,104.56521739130434
6264,2097,-417,16,16,32,50.0,0.001190624999999999,65.3125
6265,2560,3990,24,15,39,61.54,0.020730769230769226,39.1025641025641
6266,4237,15173,22,14,36,61.11,0.03338333333333334,55.94444444444444
6270,2910,12360,18,12,30,60.0,0.02739333333333334,77.46666666666667
6274,23632,-50082,29,26,55,52.73,-0.006440000000000001,24.854545454545455
6275,4949,15951,22,17,39,56.41,0.024033333333333334,41.35897435897436
6276,5168,-1058,24,22,46,52.17,0.01238695652173913,27.304347826086957
6279,31979,-8879,26,19,45,57.78,0.006957777777777779,33.422222222222224
6284,12209,14841,30,22,52,57.69,0.013313461538461545,27.153846153846153
6287,3632,-6412,29,29,58,50.0,0.016282758620689654,14.637931034482758
6290,12528,-7128,26,22,48,54.17,-0.0005895833333333331,28.208333333333332
6291,6377,-6997,21,40,61,34.43,-0.022650819672131145,13.311475409836065
6292,4996,40304,16,8,24,66.67,0.05569166666666667,106.70833333333333
6294,20591,-102891,17,19,36,47.22,-0.023411111111111108,56.916666666666664
6404,7751,-22241,32,22,54,59.26,0.012374074074074072,21.0
6411,26978,-48928,26,24,50,52.0,-0.0017539999999999988,23.7
6417,9326,34424,16,9,25,64.0,0.020396,62.84
6418,3377,-14577,14,19,33,42.42,-0.02111212121212121,44.54545454545455
6419,4951,-2971,15,24,39,38.46,0.017576923076923084,35.41025641025641
6425,7375,-8315,17,17,34,50.0,0.0025117647058823535,40.61764705882353
6426,20427,-1477,24,19,43,55.81,0.012295348837209303,22.930232558139537
6432,6594,42156,25,11,36,69.44,0.04308055555555556,34.388888888888886
6435,22285,12565,21,16,37,56.76,0.01153243243243243,29.594594594594593
6441,18343,-60023,21,25,46,45.65,-0.00892826086956522,25.73913043478261
6446,43355,-129655,15,17,32,46.88,-0.004293750000000001,36.3125
6457,14788,-108838,16,20,36,44.44,-0.01411388888888889,35.27777777777778
6461,6066,-11966,17,18,35,48.57,-0.0047885714285714285,31.057142857142857
6462,38593,55307,22,17,39,56.41,0.011866666666666666,22.358974358974358
6465,7886,-37986,14,17,31,45.16,-0.009961290322580646,41.516129032258064
6469,27663,123537,17,12,29,58.62,0.025713793103448273,41.758620689655174
6470,10782,12118,23,14,37,62.16,0.007562162162162162,30.324324324324323
6472,49660,171190,25,13,38,65.79,0.030607894736842105,18.026315789473685
6482,5678,20072,13,11,24,54.17,0.02945,56.916666666666664
6485,15813,-64863,19,19,38,50.0,-0.007926315789473684,25.394736842105264
6486,9116,26334,15,10,25,60.0,0.021471999999999998,46.2
6488,102323,485977,30,12,42,71.43,0.041269047619047615,23.452380952380953
6492,21312,-210012,12,22,34,35.29,-0.038411764705882354,25.970588235294116
6494,11845,-41295,16,12,28,57.14,0.0024142857142857134,32.67857142857143
6496,7027,-8977,12,11,23,52.17,0.0006869565217391327,72.95652173913044
6499,14358,-61308,12,18,30,40.0,-0.01273666666666667,38.43333333333333
6506,3415,185,17,13,30,56.67,0.006880000000000001,73.63333333333334
6508,3477,26973,12,6,18,66.67,0.050733333333333325,144.33333333333334
6509,7135,-21585,24,19,43,55.81,-0.003060465116279071,42.97674418604651
6510,173477,131523,22,17,39,56.41,0.007682051282051279,18.28205128205128
6512,3628,-7828,13,16,29,44.83,-0.004541379310344827,48.827586206896555
6514,10131,40969,19,15,34,55.88,0.02758529411764706,32.705882352941174
6516,22476,-207156,14,13,27,51.85,-0.014870370370370374,65.29629629629629
6523,24393,32607,23,14,37,62.16,0.025051351351351357,24.513513513513512
6527,6706,28474,12,9,21,57.14,0.025823809523809523,51.04761904761905
6530,3199,14961,17,11,28,60.71,0.02783214285714286,56.107142857142854
6532,7843,12357,20,11,31,64.52,0.023016129032258067,30.516129032258064
6535,6403,-12903,14,15,29,48.28,-0.007793103448275862,39.93103448275862
6538,19493,137807,16,12,28,57.14,0.04127142857142856,32.214285714285715
6542,11003,6647,15,14,29,51.72,0.017755172413793107,27.06896551724138
6547,18849,-73999,16,17,33,48.48,-0.003645454545454543,31.060606060606062
6548,26078,216972,21,8,29,72.41,0.04449655172413793,35.793103448275865
6556,6662,44538,14,7,21,66.67,0.044557142857142865,72.85714285714286
6560,8459,-23909,13,13,26,50.0,-0.0005038461538461557,19.884615384615383
6561,24342,48158,10,6,16,62.5,0.011625000000000003,69.0625
6568,37402,17098,21,15,36,58.33,0.014655555555555557,21.0
6569,19441,-141,12,10,22,54.55,-0.00031818181818182227,65.72727272727273
6570,6033,15267,15,11,26,57.69,0.01959230769230769,50.26923076923077
6574,6731,-29831,5,7,12,41.67,-0.012975,140.75
6576,16106,13624,18,14,32,56.25,0.007549999999999994,36.5625
6577,6666,-4966,10,7,17,58.82,0.00241764705882353,80.3529411764706
6578,3261,-21871,10,15,25,40.0,-0.025932000000000004,47.64
6588,4400,9400,8,5,13,61.54,0.01737692307692307,31.846153846153847
6589,13564,-123684,10,18,28,35.71,-0.04516428571428571,45.67857142857143
6590,4857,20703,12,6,18,66.67,0.036816666666666664,95.22222222222223
6593,4419,22731,13,9,22,59.09,0.040063636363636364,54.95454545454545
6596,5925,-2845,10,8,18,55.56,0.007833333333333335,71.27777777777777
6603,3040,9460,23,13,36,63.89,0.025861111111111112,53.583333333333336
6609,8088,-12288,22,17,39,56.41,0.005353846153846158,44.23076923076923
6612,10779,-33359,12,12,24,50.0,-0.012170833333333332,29.833333333333332
6613,16637,47263,12,7,19,63.16,0.025236842105263158,65.15789473684211
6615,8285,-13395,10,9,19,52.63,0.006878947368421057,55.05263157894737
6616,2952,20508,15,8,23,65.22,0.027086956521739126,35.52173913043478
6624,2685,6765,6,5,11,54.55,0.020218181818181816,156.72727272727272
6629,4387,11413,7,6,13,53.85,0.01584615384615385,64.92307692307692
6640,7341,17059,10,7,17,58.82,0.03221764705882353,58.76470588235294
6642,4083,21517,9,4,13,69.23,0.03381538461538462,56.53846153846154
6643,48590,242910,15,8,23,65.22,0.03519565217391304,18.17391304347826
6649,3647,14753,10,9,19,52.63,0.03873684210526315,34.78947368421053
6651,6712,-63812,4,8,12,33.33,-0.04266666666666666,29.583333333333332
6654,6908,36392,13,7,20,65.0,0.03439,28.9
6661,854,996,3,3,6,50.0,0.013400000000000004,114.33333333333333
6662,1730,-1030,3,5,8,37.5,0.012662499999999997,143.625
6664,7356,71794,12,4,16,75.0,0.054375,57.8125
6667,8072,35878,13,8,21,61.9,0.03254285714285714,39.666666666666664
6679,45808,120192,18,12,30,60.0,0.020673333333333335,14.433333333333334
6680,5089,27511,8,6,14,57.14,0.025514285714285715,46.142857142857146
6683,36350,148150,17,8,25,68.0,0.03318,12.84
6690,10980,60420,10,4,14,71.43,0.03779285714285714,28.857142857142858
6697,2364,3436,5,4,9,55.56,0.017022222222222223,91.66666666666667
6703,7423,70577,7,4,11,63.64,0.05059090909090909,44.81818181818182
6712,16807,-8307,6,6,12,50.0,-0.0033000000000000004,21.833333333333332
6716,9923,32577,9,6,15,60.0,0.026380000000000004,30.8
6727,4028,10472,5,5,10,50.0,0.022449999999999998,40.3
6728,6593,77207,8,2,10,80.0,0.08881,26.1
6732,56224,-413724,7,11,18,38.89,-0.02734444444444444,18.61111111111111
6733,1761,10239,8,3,11,72.73,0.03413636363636364,29.272727272727273
6747,16105,-36605,5,6,11,45.45,0.002627272727272728,28.181818181818183
6751,3789,-37339,4,7,11,36.36,-0.03312727272727273,25.09090909090909
6752,4018,34682,6,2,8,75.0,0.04335,55.25
6762,15692,110808,7,3,10,70.0,0.04391,53.8
6767,1528,7622,5,3,8,62.5,0.03626250000000001,59.75
6803,16287,181713,10,2,12,83.33,0.07025,243.66666666666666
7402,11361,6499,19,14,33,57.58,0.016630303030303033,40.15151515151515
7556,7249,751,5,5,10,50.0,0.006419999999999998,47.2
8024,3743,23547,27,10,37,72.97,0.04044324324324324,45.13513513513514
8027,11762,-5212,22,22,44,50.0,-0.0008000000000000005,24.772727272727273
8032,3748,15502,13,8,21,61.9,0.031171428571428565,130.14285714285714
8034,4242,15878,30,21,51,58.82,0.029194117647058822,21.666666666666668
8038,14495,-119495,17,38,55,30.91,-0.03515999999999999,26.87272727272727
8040,7589,-35759,28,24,52,53.85,0.0057711538461538425,22.46153846153846
8042,8784,-2934,17,15,32,53.12,0.005875000000000002,66.15625
8043,6061,29089,25,13,38,65.79,0.034507894736842105,47.89473684210526
8044,58024,218276,30,24,54,55.56,0.008614814814814813,24.38888888888889
8047,2188,2,16,13,29,55.17,0.005334482758620692,81.75862068965517
8048,7559,19891,23,17,40,57.5,0.01781,39.425
8049,3859,29441,24,12,36,66.67,0.03168611111111111,50.27777777777778
8050,10710,46490,22,12,34,64.71,0.029341176470588235,60.794117647058826
8054,7213,10837,24,20,44,54.55,0.0005181818181818173,36.43181818181818
8059,3690,3450,26,21,47,55.32,0.018678723404255318,27.02127659574468
8064,4630,1920,26,20,46,56.52,0.008873913043478258,33.130434782608695
8066,15647,25253,21,15,36,58.33,0.023880555555555558,48.611111111111114
8067,3272,-2672,21,30,51,41.18,-0.004990196078431374,31.07843137254902
8068,6900,1290,27,28,55,49.09,-0.0013163636363636346,20.036363636363635
8069,20725,-22725,28,25,53,52.83,0.00220377358490566,24.30188679245283
8071,3909,-3959,21,19,40,52.5,0.0033900000000000015,47.175
8074,4946,-18246,16,19,35,45.71,-0.010060000000000001,60.285714285714285
8076,16772,18528,26,21,47,55.32,0.001525531914893616,29.97872340425532
8077,5937,-37267,14,27,41,34.15,-0.044560975609756096,37.73170731707317
8080,4166,-26126,18,33,51,35.29,-0.02204901960784314,19.980392156862745
8083,20197,-33197,11,12,23,47.83,-0.00039565217391304453,109.82608695652173
8084,12740,-790,22,19,41,53.66,0.006658536585365857,37.68292682926829
8085,3332,6378,26,19,45,57.78,0.01352666666666667,31.31111111111111
8086,25890,45860,35,26,61,57.38,0.014354098360655739,16.868852459016395
8087,3652,16128,21,16,37,56.76,0.028248648648648653,50.351351351351354
8088,6973,1577,26,24,50,52.0,0.0014160000000000008,31.08
8089,2089,7561,6,6,12,50.0,0.0067,36.25
8091,17898,71102,26,15,41,63.41,0.02727073170731707,45.8780487804878
8092,3252,14228,27,16,43,62.79,0.04011162790697675,36.58139534883721
8093,2771,2879,19,23,42,45.24,0.010480952380952382,32.476190476190474
8096,3835,1435,24,20,44,54.55,0.008538636363636365,41.5
8097,6847,2393,24,32,56,42.86,0.00020714285714285713,20.660714285714285
8099,5240,-1740,18,17,35,51.43,0.004537142857142858,55.48571428571429
8107,5341,-521,23,20,43,53.49,0.00805813953488372,40.348837209302324
8109,9888,69512,17,7,24,70.83,0.04503749999999999,96.66666666666667
8111,3953,-9223,24,25,49,48.98,0.001473469387755098,26.979591836734695
8121,6935,8685,29,21,50,58.0,0.011238,20.04
8147,9365,33635,22,16,38,57.89,0.025263157894736838,44.526315789473685
8155,25945,23955,27,25,52,51.92,0.0030923076923076898,21.23076923076923
8171,7922,10508,30,19,49,61.22,0.017675510204081635,24.346938775510203
8176,3075,-4235,23,20,43,53.49,-0.00015348837209302023,37.06976744186046
8182,5685,-2985,22,17,39,56.41,0.017023076923076925,43.743589743589745
8183,6410,-11310,23,19,42,54.76,0.01583809523809524,38.333333333333336
8234,7691,22709,25,17,42,59.52,0.024561904761904757,43.23809523809524
8240,5710,16190,22,16,38,57.89,0.023078947368421046,46.28947368421053
8255,31348,-65048,19,21,40,47.5,-0.003524999999999999,45.925
8277,3264,-1084,23,22,45,51.11,0.0036200000000000017,30.933333333333334
8279,23037,106663,20,10,30,66.67,0.03144333333333334,32.766666666666666
8284,5899,24591,8,12,20,40.0,0.055404999999999996,137.6
8289,4452,21228,24,13,37,64.86,0.0315972972972973,56.4054054054054
8291,2603,-933,22,24,46,47.83,0.008058695652173915,28.456521739130434
8299,78525,21475,26,18,44,59.09,0.004159090909090909,36.29545454545455
8342,2941,5869,6,4,10,60.0,0.012339999999999993,188.7
8349,18373,42027,23,16,39,58.97,0.015302564102564106,44.35897435897436
8354,1947,8403,12,7,19,63.16,0.028510526315789472,145.94736842105263
8358,11691,-16371,25,22,47,53.19,0.0019468085106382972,33.59574468085106
8383,8672,-11922,19,18,37,51.35,0.00273243243243243,56.5945945945946
8390,5964,-64,23,20,43,53.49,0.009627906976744182,41.093023255813954
8401,3181,-8531,16,19,35,45.71,-0.013522857142857142,57.08571428571429
8403,8134,-19034,19,19,38,50.0,-0.00624473684210526,56.55263157894737
8409,6708,-26908,19,23,42,45.24,0.00769047619047619,34.73809523809524
8410,7986,12514,27,14,41,65.85,0.02120487804878049,34.63414634146341
8415,3899,6851,12,9,21,57.14,0.022114285714285715,77.52380952380952
8416,24106,-49006,17,16,33,51.52,-0.0032484848484848512,68.51515151515152
8418,3306,-19606,10,23,33,30.3,-0.032790909090909086,75.03030303030303
8420,6050,43800,18,10,28,64.29,0.040871428571428566,69.85714285714286
8421,4115,-8825,22,23,45,48.89,-0.004099999999999999,38.24444444444445
8423,4201,3499,15,17,32,46.88,0.008984375000000003,75.125
8424,6887,5263,12,12,24,50.0,0.006875000000000002,111.20833333333333
8426,8173,-19873,20,20,40,50.0,0.00032749999999999446,43.125
8431,14654,-154,21,20,41,51.22,0.0066097560975609745,24.878048780487806
8432,14660,-107960,12,26,38,31.58,-0.04050263157894736,53.13157894736842
8433,17871,4429,24,19,43,55.81,0.010813953488372092,38.883720930232556
8435,2776,26674,6,3,9,66.67,0.05973333333333334,344.6666666666667
8436,58082,-71182,26,18,44,59.09,0.01709545454545455,27.068181818181817
8437,29083,-98383,13,17,30,43.33,-0.015476666666666665,61.4
8440,4337,9043,19,14,33,57.58,0.02867272727272727,51.18181818181818
8444,16732,-109532,11,17,28,39.29,-0.023703571428571428,51.75
8446,20201,102699,20,11,31,64.52,0.04302903225806451,60.774193548387096
8450,9880,-9680,15,15,30,50.0,-0.002673333333333334,48.43333333333333
8455,3971,-14321,13,12,25,52.0,-0.004763999999999999,53.68
8472,7850,-66450,11,20,31,35.48,-0.029587096774193546,47.32258064516129
8476,4914,-864,13,10,23,56.52,0.013478260869565217,43.65217391304348
8477,6306,-26656,10,17,27,37.04,-0.020937037037037035,43.7037037037037
8489,24237,-101767,15,21,36,41.67,-0.012491666666666665,28.25
8905,3527,6073,16,14,30,53.33,0.01496,75.16666666666667
8906,2388,-9778,11,19,30,36.67,-0.028373333333333337,79.66666666666667
8908,5452,23698,12,7,19,63.16,0.028478947368421048,144.1578947368421
8916,9314,-6264,18,16,34,52.94,0.0021323529411764698,66.79411764705883
8917,5319,29931,10,4,14,71.43,0.039957142857142865,215.78571428571428
8921,2073,327,11,11,22,50.0,0.007199999999999999,108.04545454545455
8923,1559,-4159,9,6,15,60.0,-0.010780000000000001,202.6
8924,16637,-73237,25,23,48,52.08,0.005572916666666664,31.583333333333332
8927,4334,-7924,15,16,31,48.39,-0.0005096774193548409,79.19354838709677
8928,7942,1858,25,17,42,59.52,0.015876190476190474,39.666666666666664
8929,7157,-2957,22,17,39,56.41,0.005235897435897439,48.1025641025641
8930,2594,10506,18,11,29,62.07,0.03262068965517242,74.37931034482759
8931,3189,7411,12,7,19,63.16,0.02358421052631579,116.36842105263158
8932,4325,19995,22,19,41,53.66,0.014846341463414637,39.146341463414636
8933,3710,-18470,19,28,47,40.43,-0.02122340425531915,35.702127659574465
8935,2847,893,21,22,43,48.84,0.0037488372093023264,36.27906976744186
8936,7102,17748,24,19,43,55.81,0.011897674418604653,35.7906976744186
8937,2891,6959,21,13,34,61.76,0.019220588235294118,60.529411764705884
8938,10553,37147,24,17,41,58.54,0.022199999999999998,41.78048780487805
8941,12589,-25209,17,21,38,44.74,1.842105263157619e-05,53.21052631578947
8942,13565,835,18,14,32,56.25,0.006034374999999998,68.84375
9949,2431,-641,14,14,28,50.0,-0.004225000000000001,76.64285714285714
9950,3151,2179,16,15,31,51.61,0.005358064516129033,77.16129032258064
9951,29673,-20573,24,20,44,54.55,0.002486363636363637,36.11363636363637
9960,4519,10581,16,13,29,55.17,0.0209551724137931,77.86206896551724
9962,2422,3808,19,10,29,65.52,0.02439999999999999,72.37931034482759
4148,9205,-29905,13,12,25,52.0,0.0035359999999999975,28.64
6781,47015,-55015,5,4,9,55.56,0.01883333333333333,21.77777777777778
6776,1677,15473,4,2,6,66.67,0.05899999999999999,87.16666666666667
2211,2292,15708,5,2,7,71.43,0.046285714285714284,61.0
6768,2958,4442,4,3,7,57.14,0.013157142857142857,76.85714285714286
3357,8562,107518,9,11,20,45.0,0.280715,134.1
6741,9851,2349,5,5,10,50.0,0.0018000000000000017,16.3
2250,5756,-24356,5,4,9,55.56,-0.008666666666666666,44.888888888888886
5236,6927,-44127,5,6,11,45.45,-0.02112727272727272,16.09090909090909
1522A,259,541,1,0,1,100.0,0.0124,688.0
6684,4823,-28173,3,6,9,33.33,-0.030711111111111116,19.88888888888889
2753,8174,100326,7,1,8,87.5,0.071925,27.375
2348A,205,-4105,0,1,1,0.0,-0.1079,582.0
6790,1154,-9454,2,3,5,40.0,-0.036759999999999994,97.6
6788,6898,18102,6,3,9,66.67,0.027611111111111114,13.222222222222221
2947,3767,-16767,2,4,6,33.33,-0.02435,72.66666666666667
4440,434,-8584,0,2,2,0.0,-0.10694999999999999,230.5
5222,13944,59246,16,10,26,61.54,0.028200000000000003,30.846153846153847
2881C,648,-6048,1,1,2,50.0,-0.05,274.5
6761,4608,-12908,4,4,8,50.0,0.0007374999999999916,30.0
6806,3975,26125,4,3,7,57.14,0.04245714285714286,35.857142857142854
2945,1338,-23338,1,4,5,20.0,-0.08020000000000001,64.6
6770,1257,-17407,1,5,6,16.67,-0.06924999999999999,58.166666666666664
6792,3876,28324,6,1,7,85.71,0.05324285714285714,26.142857142857142
4770,14113,20387,5,3,8,62.5,0.015612500000000001,20.625
2883B,189,-2629,0,3,3,0.0,-0.10243333333333333,149.33333333333334
6691,6316,57684,4,1,5,80.0,0.05182,48.2
3592,20919,282511,9,9,18,50.0,0.3529611111111111,142.05555555555554
6719,17288,24212,5,3,8,62.5,0.021975,15.875
2756,4473,-23573,3,4,7,42.86,-0.020157142857142856,20.714285714285715
5244,2201,-7011,9,10,19,47.37,0.010852631578947365,54.26315789473684
6693,2884,-11184,3,4,7,42.86,-0.021100000000000004,33.42857142857143
8112A,243,-843,0,1,1,0.0,-0.0202,482.0
8438,2177,-23997,4,9,13,30.77,-0.05256923076923078,104.92307692307692
6829,3101,15699,4,2,6,66.67,0.04506666666666667,33.166666666666664
4923,2567,-14187,4,8,12,33.33,-0.022391666666666667,103.75
6763,17190,100810,4,2,6,66.67,0.047633333333333326,18.666666666666668
4558,1135,26925,4,4,8,50.0,0.21296250000000003,330.75
3349,1999,851,9,7,16,56.25,0.02606875000000001,56.875
6804,2406,1494,4,3,7,57.14,0.011414285714285714,27.428571428571427
4768,9012,59988,6,3,9,66.67,0.04546666666666666,11.444444444444445
6807,644,-4344,2,2,4,50.0,-0.036175000000000006,75.0
6721,1370,-970,2,3,5,40.0,0.003419999999999998,55.6
6735,1532,-10032,1,3,4,25.0,-0.027000000000000003,66.0
4583,4754,-11754,2,2,4,50.0,-0.009149999999999998,54.25
6799,5615,7485,4,3,7,57.14,0.020685714285714286,13.857142857142858
6585,2904,-9004,4,4,8,50.0,-0.011387500000000002,37.75
5228,2077,-7047,7,7,14,50.0,-0.009964285714285714,40.5
6546,4220,120280,6,6,12,50.0,0.5593083333333334,190.75
6796,2329,54771,4,0,4,100.0,0.153875,19.0
6550,5544,21866,6,6,12,50.0,-0.003124999999999998,24.833333333333332
4577,555,-1605,1,2,3,33.33,-0.013866666666666668,104.66666666666667
6789,6877,6623,3,2,5,60.0,0.012939999999999998,15.4
6823,1559,-13259,1,2,3,33.33,-0.04239999999999999,56.666666666666664
2887Z1,99,51,1,0,1,100.0,0.0031,272.0
6811,4119,40381,3,1,4,75.0,0.06775,14.75
6854,3114,22186,3,2,5,60.0,0.04684,27.4
3715,466,6584,3,0,3,100.0,0.09406666666666667,53.666666666666664
6830,4057,58743,5,0,5,100.0,0.08722,11.6
6834,630,970,2,2,4,50.0,0.015875,42.25
3430,3254,33726,12,4,16,75.0,0.06168124999999999,38.4375
6689,3606,32794,4,1,5,80.0,0.06662,11.2
6592A,557,2243,1,0,1,100.0,0.0241,258.0
4584,842,758,2,1,3,66.67,0.008833333333333337,51.0
6855,975,12325,1,1,2,50.0,0.08675,106.0
4951,2603,38107,15,4,19,78.95,0.06799473684210526,38.68421052631579
6695,800,9750,3,0,3,100.0,0.07603333333333334,9.0
6835,784,9866,2,1,3,66.67,0.07966666666666668,32.0
6791,2101,6999,2,2,4,50.0,0.034074999999999994,11.0
6843,737,-637,1,1,2,50.0,0.0116,53.0
6782,4935,11565,2,1,3,66.67,0.0010666666666666695,21.666666666666668
6859,3552,1948,2,2,4,50.0,0.007475,29.75
6874,3413,46887,3,1,4,75.0,0.10055000000000001,6.5
3447,1197,15453,3,1,4,75.0,0.08082500000000001,12.75
6517,3100,-14960,6,7,13,46.15,-0.007615384615384619,16.153846153846153
8227,3936,-9436,2,2,4,50.0,0.011399999999999993,10.0
6708,962,-20162,0,3,3,0.0,-0.1123,9.333333333333334
6865,1086,2514,1,1,2,50.0,0.002350000000000005,22.0
6841,626,9274,1,0,1,100.0,0.0931,27.0
6873,1437,-14437,0,2,2,0.0,-0.0537,32.5
6753,1318,1682,1,1,2,50.0,0.01659999999999999,12.5
2645,682,9318,1,0,1,100.0,0.0855,25.0
6869,1160,4040,1,1,2,50.0,0.021899999999999996,19.5
6863,973,-18973,0,1,1,0.0,-0.1054,46.0
6606,159,-3209,0,1,1,0.0,-0.1088,42.0
6840,388,-4388,0,1,1,0.0,-0.0633,55.0
6861,1366,-8866,1,1,2,50.0,-0.038849999999999996,11.5
2432,270,-3420,0,1,1,0.0,-0.0705,14.0
6584,1501,-44791,1,2,3,33.33,-0.13783333333333334,817.3333333333334
6821,268,-1768,0,1,1,0.0,-0.0376,19.0
6846,521,1779,1,0,1,100.0,0.0204,28.0
6657,0,0,0,0,0,0.0,,
6877,265,-6415,0,1,1,0.0,-0.1283,4.0
2073,0,0,0,0,0,0.0,,
6902,0,0,0,0,0,0.0,,
4569,0,0,0,0,0,0.0,,
