代號,總成本,總損益(淨),獲利次數,損失次數,總交易次數,勝率%,平均報酬,平均持倉時間(日)
1101,6459,-6209,14,14,28,50.0,0.0011999999999999962,89.89285714285714
1102,4750,7400,13,9,22,59.09,0.015127272727272724,113.68181818181819
1103,2500,6530,16,11,27,59.26,0.02297777777777778,84.14814814814815
1104,2869,6431,14,8,22,63.64,0.02299545454545455,117.77272727272727
1108,1454,3256,13,8,21,61.9,0.02451904761904762,122.38095238095238
1109,2528,9642,17,9,26,65.38,0.028703846153846153,96.6923076923077
1110,2294,5306,14,10,24,58.33,0.0195,108.16666666666667
1201,4510,17590,18,9,27,66.67,0.02745555555555556,84.74074074074075
1203,2494,13206,11,5,16,68.75,0.03818749999999999,182.625
1210,6167,14133,18,12,30,60.0,0.020983333333333336,75.76666666666667
1213,2702,-3392,13,17,30,43.33,-0.017539999999999993,76.13333333333334
1215,8188,-8888,16,13,29,55.17,0.009096551724137935,83.37931034482759
1216,8676,-25026,11,13,24,45.83,-0.010195833333333336,117.75
1217,1735,2995,15,11,26,57.69,0.019284615384615386,97.3076923076923
1218,2951,13749,17,9,26,65.38,0.02850769230769231,91.42307692307692
1219,1844,10906,11,6,17,64.71,0.04162941176470587,163.64705882352942
1220,1036,1494,7,6,13,53.85,0.013823076923076926,229.07692307692307
1225,8322,11028,21,13,34,61.76,0.023852941176470584,54.05882352941177
1227,8764,-69014,8,14,22,36.36,-0.04015454545454545,129.86363636363637
1229,5083,38417,18,5,23,78.26,0.04699565217391304,110.08695652173913
1231,6845,23955,18,9,27,66.67,0.02734074074074074,83.29629629629629
1232,9969,56731,12,5,17,70.59,0.042594117647058824,163.23529411764707
1233,2397,-15397,3,7,10,30.0,-0.032729999999999995,324.7
1234,3395,-1245,9,8,17,52.94,0.002941176470588231,172.7058823529412
1235,5024,28576,21,8,29,72.41,0.04181379310344828,77.41379310344827
1236,2204,-3904,9,10,19,47.37,-0.003926315789473682,148.52631578947367
1256,49528,-11928,24,16,40,60.0,0.02122,35.075
1301,10911,36589,14,7,21,66.67,0.021280952380952383,135.47619047619048
1303,9728,16172,15,10,25,60.0,0.015324000000000004,101.04
1304,3556,-13856,16,16,32,50.0,-0.014540625000000001,65.875
1305,6116,7984,27,19,46,58.7,0.012723913043478263,35.02173913043478
1307,4638,-11638,12,15,27,44.44,-0.006848148148148148,89.03703703703704
1308,4472,-13372,18,17,35,51.43,-0.01241142857142857,58.4
1309,4852,7628,25,19,44,56.82,0.013886363636363634,38.63636363636363
1310,4031,4759,23,17,40,57.5,0.0113225,47.4
1312,5822,-14022,24,24,48,50.0,-0.006364583333333332,36.791666666666664
1313,3442,-16522,18,20,38,47.37,-0.013794736842105257,54.473684210526315
1314,3188,-6178,21,20,41,51.22,-0.01024390243902439,47.26829268292683
1315,4936,61664,14,4,18,77.78,0.08009444444444444,150.55555555555554
1316,2808,3192,17,14,31,54.84,0.01701290322580645,67.48387096774194
1319,8071,9329,19,14,33,57.58,0.015260606060606058,54.72727272727273
1321,4812,24288,17,8,25,68.0,0.038524,95.24
1323,5208,-2508,15,13,28,53.57,0.003907142857142857,86.14285714285714
1324,2001,10959,15,10,25,60.0,0.04048,101.84
1325,7621,-9871,18,11,29,62.07,0.0302551724137931,73.3103448275862
1326,11515,-2015,12,12,24,50.0,0.0010124999999999971,111.5
1337,7446,-70686,15,30,45,33.33,-0.04694444444444444,41.644444444444446
1338,17525,-22575,17,17,34,50.0,0.0013529411764705874,57.6764705882353
1339,8105,33745,17,10,27,62.96,0.034081481481481476,86.11111111111111
1340,10442,-91842,15,22,37,40.54,-0.0285972972972973,40.86486486486486
1341,3380,19520,7,2,9,77.78,0.04365555555555555,88.22222222222223
1342,1058,942,2,1,3,66.67,0.006066666666666669,129.33333333333334
1402,4349,1,14,11,25,56.0,0.006575999999999998,108.24
1409,2106,4784,18,9,27,66.67,0.028455555555555553,85.4074074074074
1410,2960,8390,12,7,19,63.16,0.020321052631578948,149.8421052631579
1413,2550,-110,22,18,40,55.0,0.014849999999999999,50.175
1414,2081,4659,19,10,29,65.52,0.02874827586206896,79.96551724137932
1416,2798,-6798,14,15,29,48.28,-0.012620689655172415,86.58620689655173
1417,2008,-5228,16,15,31,51.61,-0.006109677419354838,68.6774193548387
1418,2184,7806,25,10,35,71.43,0.03574285714285714,43.542857142857144
1419,5025,-1025,12,9,21,57.14,0.003157142857142856,131.61904761904762
1423,1879,7281,16,8,24,66.67,0.03532916666666667,108.45833333333333
1432,4232,17908,26,16,42,61.9,0.030545238095238098,30.071428571428573
1434,3766,1534,11,9,20,55.0,0.004434999999999996,137.95
1435,3158,-8678,18,17,35,51.43,0.00718857142857143,49.02857142857143
1436,4886,9864,9,9,18,50.0,0.012844444444444445,164.27777777777777
1437,3749,12251,21,11,32,65.62,0.025259375,71.5
1438,2892,35758,26,12,38,68.42,0.08340263157894738,48.86842105263158
1439,4424,-9074,17,14,31,54.84,0.009122580645161292,70.58064516129032
1440,3320,-13750,18,15,33,54.55,-0.01407878787878788,62.42424242424242
1441,2671,-971,19,19,38,50.0,0.006273684210526316,51.31578947368421
1442,3307,7993,17,8,25,68.0,0.026579999999999996,80.92
1443,2288,7542,22,13,35,62.86,0.026808571428571428,59.628571428571426
1444,2332,-2162,16,17,33,48.48,-0.0019818181818181827,70.33333333333333
1445,1962,1938,18,10,28,64.29,0.009089285714285715,85.21428571428571
1446,5314,11036,21,14,35,60.0,0.020597142857142852,61.31428571428572
1447,2656,-166,21,18,39,53.85,0.013035897435897437,47.333333333333336
1449,2910,6310,21,22,43,48.84,0.029355813953488366,34.81395348837209
1451,3568,14232,17,9,26,65.38,0.031419230769230776,92.73076923076923
1452,3451,-601,18,10,28,64.29,0.012635714285714288,78.28571428571429
1453,1911,3929,16,12,28,57.14,0.02185714285714286,83.39285714285714
1454,1651,5349,17,7,24,70.83,0.026545833333333328,106.875
1455,2663,-11973,19,17,36,52.78,-0.008397222222222217,51.94444444444444
1456,3946,4064,28,24,53,52.83,0.04995283018867924,24.754716981132077
1457,2584,12346,23,9,32,71.88,0.0381125,69.9375
1459,2464,-6344,18,17,35,51.43,-0.0067800000000000004,61.82857142857143
1460,2924,-7174,17,20,37,45.95,-0.011659459459459459,54.16216216216216
1463,3578,10172,25,11,36,69.44,0.03022222222222222,52.388888888888886
1464,4600,-5410,19,18,37,51.35,0.0024891891891891866,56.972972972972975
1465,2014,5986,12,10,22,54.55,0.023827272727272728,122.5909090909091
1466,3787,-2327,17,22,39,43.59,-0.007838461538461535,49.38461538461539
1467,3573,1567,25,18,43,58.14,0.012658139534883721,35.604651162790695
1468,2181,11579,17,12,29,58.62,0.04217586206896552,82.72413793103448
1470,3783,-9933,17,18,35,48.57,-0.009351428571428571,69.14285714285714
1471,3187,-6217,23,30,53,43.4,-0.0006679245283018892,25.49056603773585
1472,5903,-25693,19,29,48,39.58,-0.012670833333333334,25.020833333333332
1473,4247,-25297,11,16,27,40.74,-0.029459259259259254,87.74074074074075
1474,2195,-2875,17,13,30,56.67,0.00029333333333333246,79.46666666666667
1475,6678,21512,25,32,57,43.86,0.01301578947368421,15.929824561403509
1476,93881,85519,27,16,43,62.79,0.018081395348837213,35.116279069767444
1477,43125,-19525,23,18,41,56.1,0.004939024390243901,45.53658536585366
1503,2922,36278,9,2,11,81.82,0.07713636363636363,292.90909090909093
1504,4856,-756,16,14,30,53.33,0.0037400000000000007,76.96666666666667
1506,3606,14934,23,13,36,63.89,0.034341666666666666,42.138888888888886
1512,2522,-2022,18,24,42,42.86,-0.009392857142857142,35.523809523809526
1513,4519,3231,16,10,26,61.54,0.020761538461538456,96.0
1514,3307,20503,25,9,34,73.53,0.04149117647058823,56.205882352941174
1515,11186,-6276,28,17,45,62.22,0.029388888888888888,28.88888888888889
1516,4819,21671,26,19,45,57.78,0.031817777777777785,33.4
1517,3422,-9822,19,18,37,51.35,-0.004864864864864863,58.027027027027025
1519,5278,32072,24,10,34,70.59,0.03468235294117647,58.5
1521,10673,-55923,12,16,28,42.86,-0.02454642857142857,87.42857142857143
1522,5212,-13662,22,17,39,56.41,-0.004433333333333335,50.0
1524,2040,6340,20,11,31,64.52,0.020203225806451612,73.7741935483871
1525,16920,-19270,20,17,37,54.05,0.005578378378378377,45.4054054054054
1526,7711,-17171,31,17,48,64.58,0.016504166666666667,28.166666666666668
1527,12482,-20432,22,18,40,55.0,0.0025925,46.775
1528,2648,2082,21,14,35,60.0,0.013942857142857146,56.65714285714286
1529,4144,3896,29,31,60,48.33,0.004883333333333335,16.016666666666666
1530,5299,8351,15,11,26,57.69,0.01713076923076923,89.53846153846153
1531,3469,-469,17,14,31,54.84,0.0028064516129032266,68.45161290322581
1532,6888,-9038,20,17,37,54.05,-0.002316216216216216,56.75675675675676
1533,10893,32707,28,15,43,65.12,0.03546744186046512,35.02325581395349
1535,8366,-29666,13,16,29,44.83,-0.009910344827586211,85.34482758620689
1536,23421,38129,24,18,42,57.14,0.018714285714285715,35.857142857142854
1537,14978,32322,14,7,21,66.67,0.02433333333333333,125.71428571428571
1538,3332,1078,27,26,53,50.94,0.0028773584905660383,22.962264150943398
1539,5393,38897,30,12,42,71.43,0.04801904761904763,32.476190476190474
1540,2430,9120,14,9,23,60.87,0.025756521739130435,105.65217391304348
1541,8342,13658,27,15,42,64.29,0.02510238095238096,36.45238095238095
1558,21271,-64771,11,14,25,44.0,-0.010684,106.2
1560,16147,38003,24,15,39,61.54,0.020292307692307693,48.15384615384615
1568,6220,-7220,21,20,41,51.22,-0.0004902439024390286,27.78048780487805
1582,10433,8567,15,13,28,53.57,0.008185714285714286,89.39285714285714
1583,13587,-40037,16,20,36,44.44,-0.012633333333333337,62.30555555555556
1587,4495,-2455,18,16,34,52.94,0.003058823529411765,53.23529411764706
1589,28284,-62484,26,22,48,54.17,-0.0022187500000000015,31.291666666666668
1590,120253,452247,29,22,51,56.86,0.011349019607843135,24.41176470588235
1597,16372,65178,28,13,41,68.29,0.033063414634146346,26.73170731707317
1598,6705,39595,12,8,20,60.0,0.016705000000000005,45.15
1603,3927,2493,17,13,30,56.67,0.019823333333333328,75.4
1604,2662,16878,19,7,26,73.08,0.03996923076923077,90.26923076923077
1605,4090,5430,24,18,42,57.14,0.01046666666666667,43.38095238095238
1608,3059,-9669,20,16,36,55.56,0.006311111111111109,54.666666666666664
1609,2651,-11791,14,16,30,46.67,-0.010530000000000003,74.73333333333333
1611,2621,2109,20,14,34,58.82,0.01720294117647059,62.411764705882355
1612,3219,11731,22,13,35,62.86,0.02336571428571429,66.94285714285714
1614,4055,21195,15,7,22,68.18,0.032013636363636355,116.0909090909091
1615,3406,11254,21,11,32,65.62,0.034171875,67.78125
1616,2176,2834,23,14,37,62.16,0.02056756756756757,49.432432432432435
1617,2291,8669,19,10,29,65.52,0.029775862068965514,82.03448275862068
1618,2107,16653,24,5,29,82.76,0.06148965517241379,68.79310344827586
1626,8496,-42296,20,25,45,44.44,-0.01685777777777778,33.0
1701,3006,14244,16,8,24,66.67,0.03313750000000001,110.25
1702,10008,-35408,15,17,32,46.88,-0.01248125,71.71875
1707,32868,43732,20,13,33,60.61,0.01933939393939394,66.12121212121212
1708,4990,-6740,14,13,27,51.85,-0.0019333333333333331,94.88888888888889
1709,2997,5853,15,14,29,51.72,0.016289655172413795,87.6896551724138
1710,5471,-11071,20,18,38,52.63,-0.0052184210526315805,52.473684210526315
1711,4048,13552,21,11,32,65.62,0.026237500000000004,66.03125
1712,2578,16572,16,6,22,72.73,0.038668181818181824,114.81818181818181
1713,2210,13890,14,7,21,66.67,0.04243333333333334,127.71428571428571
1714,2706,-4856,19,20,39,48.72,-0.005587179487179487,53.48717948717949
1717,4945,19055,17,10,27,62.96,0.02808148148148148,97.0
1718,3121,-861,24,21,45,53.33,-0.0001466666666666639,38.53333333333333
1720,5821,13679,17,10,27,62.96,0.020407407407407405,93.81481481481481
1721,3101,-481,23,16,39,58.97,0.016784615384615384,50.46153846153846
1722,8001,-4851,13,11,24,54.17,0.0038583333333333312,114.625
1723,17339,36861,15,8,23,65.22,0.01954347826086956,111.73913043478261
1725,2969,5481,18,11,29,62.07,0.020341379310344822,75.86206896551724
1726,4769,8031,7,4,11,63.64,0.015363636363636364,278.72727272727275
1727,3212,-1762,15,12,27,55.56,0.006622222222222223,90.77777777777777
1730,6827,53573,21,6,27,77.78,0.05131111111111112,84.51851851851852
1731,2508,6792,17,10,27,62.96,0.02347777777777778,99.85185185185185
1732,3182,18628,16,9,25,64.0,0.0475,87.44
1733,6752,-37952,13,18,31,41.94,-0.018370967741935487,78.0
1734,6308,12792,21,12,33,63.64,0.017621212121212124,62.84848484848485
1735,2009,-659,12,11,23,52.17,0.007334782608695649,116.3913043478261
1736,15490,-9540,23,19,42,54.76,-0.0018595238095238077,40.666666666666664
1737,3725,4675,13,10,23,56.52,0.01253913043478261,116.0
1760,41698,-53448,22,29,51,43.14,-0.02073921568627451,26.54901960784314
1762,10041,22009,25,15,40,62.5,0.0217725,43.75
1773,17812,102138,24,10,34,70.59,0.036208823529411766,64.73529411764706
1776,1220,-6570,4,7,11,36.36,-0.020000000000000004,158.63636363636363
1783,5845,-145,19,13,32,59.38,0.0017062499999999977,37.375
1786,16243,-30443,20,23,43,46.51,-0.0070441860465116305,28.813953488372093
1789,8844,-44544,15,21,36,41.67,-0.022791666666666665,59.97222222222222
1795,24847,46703,30,21,51,58.82,0.021086274509803916,27.137254901960784
1802,4039,-9699,17,17,34,50.0,-0.0034852941176470595,61.205882352941174
1805,2790,1000,19,18,37,51.35,0.012124324324324321,45.0
1806,2417,-5527,17,19,36,47.22,-0.00498333333333333,59.638888888888886
1808,7063,7137,16,11,27,59.26,0.012366666666666666,86.22222222222223
1809,2864,1766,21,15,36,58.33,0.008275,54.05555555555556
1810,1633,10037,17,6,23,73.91,0.04324782608695653,108.3913043478261
1817,4742,11308,14,8,22,63.64,0.021486363636363633,94.63636363636364
1903,8790,1510,18,14,32,56.25,0.0072593749999999985,68.21875
1904,3182,3868,14,10,24,58.33,0.020966666666666665,98.625
1905,3044,-924,20,15,35,57.14,0.00610285714285714,62.142857142857146
1906,4298,14962,29,15,44,65.91,0.040631818181818186,34.59090909090909
1907,3415,-4185,15,16,31,48.39,0.001583870967741934,74.0
1909,4707,-12737,18,21,39,46.15,-0.0020948717948717963,45.05128205128205
2002,2552,548,9,7,16,56.25,0.009568749999999997,181.9375
2006,4710,23940,15,9,24,62.5,0.023379166666666663,103.79166666666667
2007,2690,-1680,21,19,40,52.5,0.009615,46.225
2008,2718,13342,22,10,32,68.75,0.04592812500000001,69.875
2009,4297,-13077,19,17,36,52.78,0.012250000000000004,55.22222222222222
2010,1922,-4632,10,11,21,47.62,-0.006004761904761906,131.33333333333334
2012,2376,-1376,12,8,20,60.0,0.015445000000000004,128.8
2013,5759,19391,17,12,29,58.62,0.030727586206896557,77.10344827586206
2014,3899,5881,22,15,37,59.46,0.022602702702702704,46.270270270270274
2015,5889,14711,11,7,18,61.11,0.01416666666666667,154.83333333333334
2017,2305,9085,19,12,31,61.29,0.019009677419354838,62.354838709677416
2020,2604,2396,13,11,24,54.17,0.020158333333333334,107.66666666666667
2022,2283,-63,19,18,37,51.35,0.010351351351351349,50.78378378378378
2023,2999,-15749,15,21,36,41.67,-0.01948333333333333,57.416666666666664
2024,3106,14014,24,13,37,64.86,0.036699999999999997,50.91891891891892
2025,2181,-621,21,23,44,47.73,-0.004597727272727276,34.36363636363637
2027,6588,-988,22,18,40,55.0,0.009412499999999997,49.05
2028,3888,17062,29,15,44,65.91,0.035256818181818174,30.477272727272727
2029,4208,-2358,15,14,29,51.72,0.005644827586206898,76.37931034482759
2030,3676,10214,24,14,38,63.16,0.03341578947368421,45.28947368421053
2031,6713,-2913,19,17,36,52.78,0.011916666666666667,52.416666666666664
2032,3116,-1266,18,19,37,48.65,0.004770270270270269,55.4054054054054
2033,2453,4547,17,13,30,56.67,0.028793333333333334,73.2
2034,4657,10943,18,13,31,58.06,0.02330645161290322,70.93548387096774
2038,3255,7005,19,16,35,54.29,0.008508571428571428,56.02857142857143
2049,73674,-154174,25,24,49,51.02,-0.0076448979591836755,28.816326530612244
2059,78657,-42157,21,16,37,56.76,0.0050378378378378415,54.513513513513516
2062,9422,-11322,21,20,41,51.22,-0.00897560975609756,48.853658536585364
2069,2989,-1589,12,9,21,57.14,0.005195238095238095,58.0
2101,5924,-12124,13,15,28,46.43,-0.009146428571428571,92.32142857142857
2102,3594,-20624,14,20,34,41.18,-0.024576470588235293,65.8529411764706
2103,6723,-42423,16,20,36,44.44,-0.020949999999999996,62.0
2104,5384,10016,17,12,29,58.62,0.016848275862068964,82.37931034482759
2105,8793,-44843,11,16,27,40.74,-0.025029629629629627,87.70370370370371
2106,7643,-34843,12,17,29,41.38,-0.020900000000000002,82.10344827586206
2107,3057,743,14,11,25,56.0,0.006056000000000001,101.84
2108,7415,7035,18,16,34,52.94,0.000405882352941182,57.529411764705884
2109,3188,4552,22,15,37,59.46,0.01841081081081081,49.486486486486484
2114,13798,43102,17,8,25,68.0,0.025335999999999997,94.0
2115,8969,6581,17,16,33,51.52,0.006303030303030304,46.57575757575758
2201,5672,-22072,13,17,30,43.33,-0.018973333333333335,82.4
2204,5582,12768,14,12,26,53.85,0.03709615384615384,98.26923076923077
2206,4347,11703,16,11,27,59.26,0.019781481481481483,86.88888888888889
2207,82875,-74375,19,15,34,55.88,0.001064705882352937,57.705882352941174
2208,4135,-29685,11,22,33,33.33,-0.026203030303030304,68.75757575757575
2227,56503,-34003,17,17,34,50.0,-0.001838235294117647,66.26470588235294
2228,26711,-87211,17,20,37,45.95,-0.015251351351351349,40.08108108108108
2231,72574,-40374,28,22,50,56.0,0.011682,26.06
2233,27023,-115423,24,23,47,51.06,-0.011780851063829787,34.765957446808514
2236,6207,21593,19,12,31,61.29,0.027516129032258065,38.12903225806452
2239,19429,10771,15,13,28,53.57,-0.0016142857142857146,35.535714285714285
2241,5011,-41831,5,8,13,38.46,-0.04530000000000001,35.30769230769231
2243,3346,-28676,9,20,29,31.03,-0.02367931034482758,18.82758620689655
2247,3921,-72921,0,3,3,0.0,-0.09910000000000001,170.0
2301,9347,-13597,18,17,35,51.43,-0.0035942857142857126,64.2
2302,2919,11541,27,15,42,64.29,0.03065238095238095,36.285714285714285
2303,5028,32822,22,12,34,64.71,0.03485294117647058,59.411764705882355
2305,2599,3961,26,16,42,61.9,0.028064285714285722,33.857142857142854
2308,39534,-7534,20,19,39,51.28,0.0027743589743589735,49.333333333333336
2312,3080,6220,25,16,41,60.98,0.019941463414634146,45.19512195121951
2313,7500,50,26,18,44,59.09,0.01614090909090909,36.02272727272727
2314,7563,8617,28,22,50,56.0,0.0001260000000000011,24.32
2316,5888,-3838,24,21,45,53.33,0.004417777777777778,37.13333333333333
2317,13825,-26825,14,13,27,51.85,-0.004762962962962961,92.18518518518519
2321,2709,-4589,21,34,55,38.18,-0.021074545454545464,17.854545454545455
2323,2233,5427,23,15,38,60.53,0.032723684210526315,42.10526315789474
2324,3994,-8194,16,16,32,50.0,-0.008087500000000001,74.3125
2327,69694,-81234,30,17,47,63.83,0.02897446808510639,30.106382978723403
2328,4935,-14335,18,16,34,52.94,-0.013923529411764706,61.05882352941177
2329,3743,-8493,26,20,46,56.52,0.008397826086956519,36.47826086956522
2330,41649,131651,21,8,29,72.41,0.0404,78.82758620689656
2331,4963,-23493,20,27,47,42.55,-0.01578297872340426,33.57446808510638
2332,3773,-3993,22,19,41,53.66,0.0013341463414634142,45.292682926829265
2337,6538,37082,26,20,46,56.52,0.031213043478260875,33.130434782608695
2338,8433,-34113,20,21,41,48.78,-0.0031536585365853653,44.146341463414636
2340,5325,5245,27,17,44,61.36,0.016761363636363633,37.45454545454545
2342,6773,-15093,26,29,55,47.27,-6.727272727272618e-05,16.98181818181818
2344,5135,8825,31,20,51,60.78,0.016776470588235295,29.0
2345,34233,72667,30,18,48,62.5,0.017145833333333332,33.416666666666664
2347,6898,-3698,14,12,26,53.85,0.004565384615384618,90.38461538461539
2348,13569,-7019,26,21,47,55.32,0.01027659574468085,37.38297872340426
2349,2966,-2546,24,26,50,48.0,-0.007976000000000002,29.66
2351,19137,93513,35,15,50,70.0,0.033033999999999994,27.34
2352,3383,1747,19,14,33,57.58,0.007154545454545453,56.24242424242424
2353,5465,-19565,20,25,45,44.44,-0.01296222222222222,44.55555555555556
2354,16483,-137083,12,25,37,32.43,-0.0406,62.37837837837838
2355,9640,-14240,21,18,39,53.85,-0.002415384615384615,45.05128205128205
2356,4078,-9818,16,16,32,50.0,-0.0032249999999999983,66.40625
2357,54271,-271271,14,19,33,42.42,-0.021827272727272726,75.87878787878788
2358,4821,-2231,24,28,52,46.15,0.006315384615384613,28.096153846153847
2359,4422,20428,28,12,40,70.0,0.0332975,42.9
2360,29836,91564,28,15,43,65.12,0.02095813953488372,40.906976744186046
2362,5384,166,13,12,25,52.0,0.009488000000000002,94.12
2363,3911,-6831,27,24,51,52.94,-0.0073607843137254905,33.294117647058826
2364,2652,3448,21,28,49,42.86,-0.010624489795918362,25.510204081632654
2365,2733,2017,23,15,38,60.53,0.011676315789473684,55.36842105263158
2367,4646,-15146,23,23,46,50.0,-0.006465217391304351,37.93478260869565
2368,7690,14440,32,17,49,65.31,0.02162448979591837,30.775510204081634
2369,3595,-7045,22,18,40,55.0,0.0006700000000000011,40.4
2371,5129,-9259,26,19,45,57.78,0.009204444444444442,32.044444444444444
2373,4328,43122,6,5,11,54.55,0.06946363636363637,285.8181818181818
2374,4126,10824,23,15,38,60.53,0.02336052631578947,50.3421052631579
2375,9271,-6971,26,17,43,60.47,0.02645813953488373,27.25581395348837
2376,13908,992,24,17,41,58.54,0.014151219512195121,36.68292682926829
2377,17637,33763,26,13,39,66.67,0.02452820512820514,37.15384615384615
2379,41959,409541,31,6,37,83.78,0.06387297297297298,42.648648648648646
2380,2520,-6910,18,22,40,45.0,-0.016415,47.325
2382,12754,-6354,17,15,32,53.12,0.002084374999999996,69.40625
2383,31200,-55500,25,21,46,54.35,-0.0018260869565217372,37.06521739130435
2385,10618,19782,14,9,23,60.87,0.016443478260869563,112.34782608695652
2387,7618,-15968,25,23,48,52.08,-0.0016937500000000008,33.0625
2388,8299,-25919,25,27,52,48.08,0.002449999999999999,22.346153846153847
2390,5263,-19493,22,26,48,45.83,-0.009975,31.5625
2392,9826,-15626,19,18,37,51.35,0.00042972972972973454,53.78378378378378
2393,10576,30024,23,15,38,60.53,0.025876315789473678,43.23684210526316
2395,54207,104293,25,13,38,65.79,0.024839473684210526,49.0
2397,9997,84203,24,8,32,75.0,0.055871874999999994,56.5625
2399,4120,4270,25,21,46,54.35,0.0153195652173913,33.23913043478261
2401,4504,8056,28,15,43,65.12,0.02965581395348837,37.604651162790695
2402,4586,3414,25,17,42,59.52,0.01635,38.476190476190474
2404,21042,94258,24,12,36,66.67,0.02808333333333333,56.72222222222222
2405,3465,-4365,27,19,46,58.7,0.005908695652173914,29.434782608695652
2406,6336,-12566,26,27,53,49.06,-0.011956603773584906,22.754716981132077
2408,15548,69192,24,24,48,50.0,0.17803958333333328,28.8125
2409,3375,-1335,23,19,42,54.76,0.006269047619047617,43.285714285714285
2412,4582,35918,6,1,7,85.71,0.05168571428571428,471.57142857142856
2413,5193,18927,31,21,52,59.62,0.03023846153846154,22.71153846153846
2414,2983,19117,17,6,23,73.91,0.04556086956521739,108.69565217391305
2415,6021,-2471,25,21,46,54.35,0.0032043478260869564,32.84782608695652
2417,5403,-16453,24,22,46,52.17,0.004010869565217391,36.80434782608695
2419,4200,-11680,17,20,37,45.95,-0.011999999999999999,55.513513513513516
2420,7143,-11393,18,15,33,54.55,-0.002872727272727275,63.121212121212125
2421,7869,32381,24,12,36,66.67,0.03180555555555555,49.361111111111114
2423,3071,10179,16,7,23,69.57,0.023873913043478263,110.6086956521739
2424,7456,-23706,18,27,45,40.0,-0.010642222222222223,30.555555555555557
2425,5840,22760,22,13,35,62.86,0.03316,44.885714285714286
2426,5013,-16843,28,24,52,53.85,0.00032884615384615607,24.846153846153847
2427,2331,639,18,16,34,52.94,0.00642941176470588,68.58823529411765
2428,19952,-15152,24,17,41,58.54,0.010412195121951219,46.926829268292686
2429,5480,29400,23,30,53,43.4,0.08806415094339622,21.39622641509434
2430,5659,-25209,13,18,31,41.94,-0.006406451612903226,76.29032258064517
2431,4373,-6603,27,23,50,54.0,0.006265999999999999,29.76
2433,4927,8623,11,8,19,57.89,0.014421052631578949,140.31578947368422
2434,4164,9866,24,24,48,50.0,0.061743749999999986,29.5625
2436,9695,19605,31,18,49,63.27,0.03189591836734694,28.836734693877553
2438,3182,5998,25,23,48,52.08,0.02389791666666667,29.3125
2439,33519,-56469,26,20,46,56.52,0.004486956521739131,30.47826086956522
2440,3189,15381,27,17,44,61.36,0.03179545454545454,36.79545454545455
2441,7835,1565,16,12,28,57.14,0.01257857142857143,79.78571428571429
2442,2683,13237,27,12,39,69.23,0.04305641025641026,46.8974358974359
2443,2492,-6062,20,24,44,45.45,-0.01457272727272727,33.04545454545455
2444,4820,-15030,26,25,51,50.98,-0.004819607843137251,27.764705882352942
2449,7376,22574,28,15,43,65.12,0.023823255813953493,42.18604651162791
2450,7713,-25063,13,10,23,56.52,-0.001278260869565218,114.43478260869566
2451,11380,-43880,9,14,23,39.13,-0.015091304347826085,112.69565217391305
2453,3335,16765,23,12,35,65.71,0.03611428571428572,48.371428571428574
2454,109209,79291,22,20,42,52.38,0.005202380952380952,41.976190476190474
2455,21100,53950,30,18,48,62.5,0.012785416666666669,27.354166666666668
2457,4805,-6095,24,21,45,53.33,0.0022733333333333347,28.77777777777778
2458,18692,28408,23,17,40,57.5,0.024782500000000006,40.55
2459,5857,18193,16,9,25,64.0,0.024867999999999998,103.44
2460,3735,11565,24,17,41,58.54,0.024892682926829265,39.41463414634146
2461,4371,-9871,22,22,44,50.0,-0.004811363636363636,43.0
2462,5826,8274,21,16,37,56.76,0.01977027027027027,54.91891891891892
2464,9008,13892,24,17,41,58.54,0.01583658536585366,41.4390243902439
2465,7273,-3353,29,28,57,50.88,0.027705263157894736,21.771929824561404
2466,3745,7655,11,8,19,57.89,0.01994736842105263,137.42105263157896
2467,5912,7788,21,14,35,60.0,0.02072571428571429,56.457142857142856
2468,1792,11508,15,8,23,65.22,0.044673913043478265,111.91304347826087
2471,3674,5076,19,13,32,59.38,0.015143750000000001,68.25
2472,10049,34351,26,15,41,63.41,0.027841463414634147,38.09756097560975
2474,60406,-101406,21,21,42,50.0,-0.0013690476190476187,41.19047619047619
2476,4401,17799,17,8,25,68.0,0.023916000000000007,95.04
2477,5872,22628,31,16,47,65.96,0.039125531914893624,33.787234042553195
2478,9813,28387,23,16,39,58.97,0.035379487179487176,44.56410256410256
2480,4935,22315,13,5,18,72.22,0.036866666666666666,146.16666666666666
2481,10016,-16496,29,22,51,56.86,0.0036450980392156843,27.80392156862745
2482,2826,15684,22,11,33,66.67,0.04322424242424242,55.60606060606061
2483,3931,5629,19,15,34,55.88,0.014720588235294116,67.47058823529412
2484,5405,9905,28,16,44,63.64,0.016281818181818185,37.31818181818182
2485,6739,-16789,21,20,41,51.22,-0.002631707317073173,43.63414634146341
2486,4735,2565,26,17,43,60.47,0.017781395348837215,31.86046511627907
2488,6885,925,22,16,38,57.89,0.009505263157894735,49.578947368421055
2489,2813,-9013,14,14,28,50.0,-0.011678571428571427,80.82142857142857
2491,3917,11433,28,27,55,50.91,0.017776363636363635,19.01818181818182
2492,30690,-117490,28,20,48,58.33,0.01932708333333333,26.375
2493,3753,18997,16,6,22,72.73,0.03507727272727273,114.86363636363636
2495,2933,-2383,16,15,31,51.61,0.0005129032258064522,72.45161290322581
2496,13882,-76482,14,30,44,31.82,-0.030856818181818176,39.72727272727273
2497,12969,-6319,29,24,53,54.72,0.006392452830188679,25.22641509433962
2498,26136,-77386,22,28,50,44.0,-0.014709999999999996,25.34
2501,2308,12592,15,6,21,71.43,0.038466666666666684,116.42857142857143
2504,2889,15581,22,9,31,70.97,0.03570000000000001,65.16129032258064
2505,3982,3068,19,18,37,51.35,0.009394594594594597,53.0
2506,1880,7270,14,11,25,56.0,0.030692,99.04
2509,4129,4821,16,14,30,53.33,0.014753333333333332,76.36666666666666
2511,2047,-5627,12,13,25,48.0,-0.008444,105.44
2514,3467,6533,18,13,31,58.06,0.01609032258064516,72.7741935483871
2515,1976,6474,20,11,31,64.52,0.03307096774193548,66.58064516129032
2516,1371,-791,13,10,23,56.52,-0.00031304347826087355,111.26086956521739
2520,6238,1512,24,15,39,61.54,0.01477179487179487,35.87179487179487
2524,4756,5944,15,13,28,53.57,0.012892857142857145,88.35714285714286
2527,4572,478,20,16,36,55.56,0.007555555555555556,57.583333333333336
2528,3365,18835,22,15,37,59.46,0.049464864864864865,48.21621621621622
2530,2431,8459,17,10,27,62.96,0.02816296296296296,92.0
2534,3199,28351,20,5,25,80.0,0.0661,83.32
2535,2940,2760,12,10,22,54.55,0.013822727272727275,113.04545454545455
2536,2864,-2964,10,10,20,50.0,-0.002749999999999999,140.45
2537,2555,-2525,18,17,35,51.43,0.0030085714285714303,60.57142857142857
2538,2941,-4931,18,15,33,54.55,-0.003893939393939393,66.24242424242425
2539,4206,20194,16,8,24,66.67,0.03153333333333333,106.33333333333333
2540,9137,45653,23,15,38,60.53,0.03378684210526316,38.078947368421055
2542,8070,-27820,13,14,27,48.15,-0.012929629629629631,94.81481481481481
2543,1681,1499,14,12,26,53.85,0.014973076923076922,91.3076923076923
2545,7705,-24705,16,15,31,51.61,-0.006212903225806452,70.45161290322581
2546,4525,24525,21,7,28,75.0,0.04483214285714286,83.96428571428571
2547,3441,-12811,18,20,38,47.37,-0.016968421052631574,52.36842105263158
2548,11604,26496,17,10,27,62.96,0.021107407407407405,93.0
2597,11396,58104,18,10,28,64.29,0.035992857142857146,75.67857142857143
2601,3848,-18228,19,25,44,43.18,-0.017988636363636363,42.15909090909091
2603,8897,-20147,22,18,40,55.0,0.0037274999999999973,47.225
2605,4349,4451,19,15,34,55.88,0.015997058823529413,61.85294117647059
2606,7268,-8568,16,16,32,50.0,0.0009250000000000013,69.6875
2607,2956,6944,14,9,23,60.87,0.026065217391304348,108.95652173913044
2608,5642,-1492,12,11,23,52.17,0.002617391304347827,116.04347826086956
2609,6305,28745,20,23,43,46.51,-0.020346511627906978,38.883720930232556
2610,2570,-530,14,15,29,48.28,-0.006224137931034483,80.86206896551724
2611,2654,-5084,17,15,32,53.12,0.0013249999999999972,65.40625
2612,7889,-14939,20,17,37,54.05,-0.0019540540540540535,56.62162162162162
2613,3707,643,19,15,34,55.88,0.014055882352941177,62.44117647058823
2614,3871,5289,25,21,46,54.35,0.010378260869565215,31.934782608695652
2615,9864,-4564,22,16,38,57.89,0.012181578947368418,50.89473684210526
2616,2737,10963,10,6,16,62.5,0.0268,182.9375
2617,4526,-9576,18,18,36,50.0,-0.003572222222222222,57.52777777777778
2618,3443,-4193,14,17,31,45.16,-0.0014064516129032273,79.64516129032258
2630,2128,-5278,9,9,18,50.0,0.004838888888888891,46.111111111111114
2633,2624,11176,9,6,15,60.0,0.029640000000000007,84.53333333333333
2634,4066,15534,13,7,20,65.0,0.031555,91.2
2636,9439,18561,19,16,35,54.29,0.01526285714285714,52.74285714285714
2637,7009,7991,13,12,25,52.0,-0.0072,103.56
2642,7469,-25419,14,17,31,45.16,-0.016174193548387096,52.516129032258064
2701,641,209,4,4,8,50.0,0.005237499999999995,406.0
2702,3104,10046,17,10,27,62.96,0.026618518518518524,83.66666666666667
2704,2467,-1667,9,6,15,60.0,0.001580000000000001,201.53333333333333
2705,2419,-3779,15,15,30,50.0,-6.0000000000000334e-05,76.76666666666667
2706,1348,-2048,7,7,14,50.0,-0.002942857142857142,221.14285714285714
2707,29796,-23296,14,10,24,58.33,0.0033708333333333355,96.04166666666667
2712,5846,4354,18,10,28,64.29,0.016735714285714284,68.07142857142857
2722,4772,-10922,10,14,24,41.67,-0.005812499999999999,117.04166666666667
2723,63742,-343342,23,28,51,45.1,-0.020054901960784313,26.176470588235293
2727,43183,-313583,16,25,41,39.02,-0.023192682926829265,47.51219512195122
2731,18667,-34467,18,14,32,56.25,0.00043124999999999934,49.4375
2739,3167,-7067,9,10,19,47.37,-0.008621052631578948,78.73684210526316
2748,4155,-7955,7,7,14,50.0,-0.0028857142857142875,97.5
2801,1683,2667,9,7,16,56.25,0.012900000000000002,188.375
2809,4283,14717,15,8,23,65.22,0.02365217391304348,111.21739130434783
2812,979,4081,9,4,13,69.23,0.0324,240.07692307692307
2816,3009,-1909,15,13,28,53.57,0.009260714285714284,82.75
2820,861,5389,7,3,10,70.0,0.043620000000000006,319.3
2832,1615,435,7,6,13,53.85,0.004823076923076925,240.69230769230768
2834,1357,23,10,9,19,52.63,0.004273684210526314,157.0
2836,932,4868,9,4,13,69.23,0.03961538461538462,243.0
2838,1052,4078,9,5,14,64.29,0.027871428571428575,214.14285714285714
2841,1855,-7895,11,17,28,39.29,-0.029017857142857144,82.5
2845,878,-1718,6,6,12,50.0,-0.00755833333333333,264.9166666666667
2849,2369,8431,17,10,27,62.96,0.025885185185185185,93.25925925925925
2850,3776,33374,16,4,20,80.0,0.05373,129.7
2851,2329,16971,14,6,20,70.0,0.04633,139.2
2852,1491,-41,10,7,17,58.82,0.0048,169.35294117647058
2855,2172,-4172,11,11,22,50.0,0.0027545454545454553,118.5909090909091
2867,1943,-1143,10,12,22,45.45,-0.004690909090909094,113.9090909090909
2880,1679,6221,9,6,15,60.0,0.024326666666666667,195.13333333333333
2881,6315,10235,12,9,21,57.14,0.012471428571428573,125.04761904761905
2882,7136,22764,16,10,26,61.54,0.026746153846153843,97.92307692307692
2883,1828,1162,14,11,25,56.0,0.009351999999999997,105.96
2884,2333,9317,11,6,17,64.71,0.026552941176470588,170.94117647058823
2885,2524,14176,18,8,26,69.23,0.041219230769230765,97.57692307692308
2886,3400,13200,13,8,21,61.9,0.02653333333333333,130.57142857142858
2887,1817,7283,14,7,21,66.67,0.029780952380952373,128.0952380952381
2888,1882,-2442,15,13,28,53.57,-0.0020500000000000028,92.39285714285714
2889,1307,1153,11,7,18,61.11,0.010577777777777778,158.72222222222223
2890,1435,4095,12,6,18,66.67,0.023611111111111107,151.38888888888889
2891,2365,6185,12,8,20,60.0,0.021124999999999998,137.6
2892,1837,7963,10,5,15,66.67,0.029493333333333333,197.86666666666667
2897,576,1344,6,3,9,66.67,0.02098888888888888,166.11111111111111
2901,3407,-14207,6,13,19,31.58,-0.015247368421052626,144.94736842105263
2903,3364,-11264,11,14,25,44.0,-0.014932,97.52
2904,3003,-10553,10,11,21,47.62,-0.0161,134.76190476190476
2905,4815,535,22,16,38,57.89,0.007068421052631578,55.21052631578947
2906,1761,10819,14,8,22,63.64,0.03785,122.54545454545455
2908,1672,-6472,6,7,13,46.15,-0.014653846153846154,247.0
2910,5329,31771,21,7,28,75.0,0.04690714285714286,76.10714285714286
2911,3143,-17053,16,20,36,44.44,-0.021808333333333336,60.27777777777778
2912,35594,-69094,12,13,25,48.0,-0.005747999999999995,108.28
2913,2735,7615,18,9,27,66.67,0.020940740740740742,88.92592592592592
2915,15368,6832,22,15,37,59.46,0.014029729729729727,54.432432432432435
2923,5636,20714,24,14,38,63.16,0.024992105263157895,50.28947368421053
2929,22019,-75569,18,22,40,45.0,-0.02617,32.975
2936,3215,-9265,10,10,20,50.0,-0.006870000000000003,60.4
2939,11278,-59528,12,11,23,52.17,-0.013843478260869574,21.217391304347824
3002,2369,11711,21,9,30,70.0,0.03459666666666667,73.96666666666667
3003,14273,12927,28,19,47,59.57,0.021512765957446812,35.93617021276596
3004,14286,264,22,20,42,52.38,0.0016285714285714287,43.69047619047619
3005,7182,33518,24,14,38,63.16,0.02361578947368421,50.078947368421055
3006,14545,105,26,20,46,56.52,0.010210869565217386,30.76086956521739
3008,911432,-1657432,25,26,51,49.02,-0.00026274509803921286,29.529411764705884
3010,8164,38536,14,7,21,66.67,0.04098095238095239,127.52380952380952
3011,3017,4453,26,19,45,57.78,0.020073333333333332,31.155555555555555
3013,5261,12089,27,19,46,58.7,0.01835217391304348,33.71739130434783
3014,12081,10719,26,19,45,57.78,0.0029466666666666686,40.31111111111111
3015,5540,16610,20,13,33,60.61,0.015251515151515148,66.42424242424242
3016,12320,23510,31,22,53,58.49,0.014932075471698116,21.150943396226417
3017,11019,-9769,30,18,48,62.5,0.011868749999999999,31.145833333333332
3018,7208,7342,26,22,48,54.17,0.013954166666666665,28.708333333333332
3019,18503,-29353,27,24,51,52.94,0.00010588235294117699,26.764705882352942
3021,3318,9432,22,14,36,61.11,0.02223888888888889,50.333333333333336
3022,8573,-15223,18,15,33,54.55,-0.003703030303030305,59.03030303030303
3023,23215,120985,26,9,35,74.29,0.04564857142857143,56.714285714285715
3024,2361,7019,23,14,37,62.16,0.023543243243243243,46.37837837837838
3025,4698,24412,24,19,43,55.81,0.036595348837209295,34.906976744186046
3026,18554,91796,23,13,36,63.89,0.04423611111111111,52.94444444444444
3027,4053,-4383,24,20,44,54.55,0.0011772727272727254,32.93181818181818
3028,2719,9981,14,7,21,66.67,0.02149047619047619,126.19047619047619
3029,5901,15199,26,15,41,63.41,0.02655609756097561,43.02439024390244
3030,9379,26671,19,12,31,61.29,0.02075483870967742,67.12903225806451
3031,4600,13180,29,21,50,58.0,0.020345999999999996,28.58
3032,6297,-10807,20,18,38,52.63,0.005597368421052633,52.63157894736842
3033,2935,18165,15,7,22,68.18,0.03832272727272728,119.31818181818181
3034,48295,196005,27,16,43,62.79,0.020876744186046514,38.97674418604651
3035,19220,13230,31,22,53,58.49,0.019128301886792452,24.90566037735849
3036,6594,21256,15,9,24,62.5,0.0253125,106.20833333333333
3037,14649,30401,25,21,46,54.35,0.011286956521739128,36.54347826086956
3038,3489,2201,25,18,43,58.14,0.008267441860465116,40.604651162790695
3040,6732,10068,18,16,34,52.94,0.028038235294117652,57.23529411764706
3041,6757,-31347,23,29,52,44.23,-0.017757692307692304,28.942307692307693
3042,11582,30518,22,15,37,59.46,0.01794054054054054,51.91891891891892
3043,2992,-8632,22,36,58,37.93,-0.017368965517241382,14.10344827586207
3044,20960,71840,27,14,41,65.85,0.025226829268292682,43.41463414634146
3045,6730,16970,7,4,11,63.64,0.017727272727272727,290.1818181818182
3046,4416,3974,28,21,49,57.14,0.016551020408163263,23.53061224489796
3047,3270,640,26,18,44,59.09,0.005504545454545455,40.5
3048,4737,2893,25,14,39,64.1,0.013333333333333334,45.97435897435897
3049,3268,-5008,22,26,48,45.83,-0.008920833333333333,31.0625
3050,2807,9743,27,12,39,69.23,0.03082051282051282,47.794871794871796
3051,3353,-4713,28,27,55,50.91,0.0012472727272727245,18.745454545454546
3052,2417,7203,18,13,31,58.06,0.02397096774193549,70.35483870967742
3054,5106,4504,24,18,42,57.14,0.01752619047619048,41.166666666666664
3055,5032,11218,22,16,38,57.89,0.012784210526315795,47.6578947368421
3056,5240,3010,19,17,36,52.78,0.005222222222222224,50.0
3057,5384,-20094,22,26,48,45.83,-0.005785416666666665,32.458333333333336
3058,3034,-9374,18,21,39,46.15,-0.0089974358974359,51.43589743589744
3059,8229,-13479,23,26,49,46.94,-0.0030530612244897932,33.775510204081634
3060,13565,-4365,23,21,44,52.27,-0.005254545454545457,33.34090909090909
3062,5581,-12081,24,21,45,53.33,-0.001255555555555555,40.577777777777776
3090,8493,18257,23,11,34,67.65,0.024588235294117647,60.14705882352941
3094,7236,4714,27,20,47,57.45,0.010204255319148935,35.46808510638298
3130,20766,108234,18,6,24,75.0,0.039525,102.5
3138,8855,22145,15,14,29,51.72,0.1806241379310345,74.55172413793103
3149,7071,-46271,19,28,47,40.43,-0.006604255319148936,24.680851063829788
3164,7413,3687,22,19,41,53.66,0.014212195121951219,44.707317073170735
3167,10093,18807,21,17,38,55.26,0.02188684210526316,32.81578947368421
3189,27389,-5389,29,21,50,58.0,0.009244,34.3
3209,4662,9288,18,14,32,56.25,0.012665625,68.5
3229,6272,-18842,22,31,53,41.51,-0.006169811320754714,25.471698113207548
3231,6369,2481,21,20,41,51.22,0.008434146341463417,44.951219512195124
3257,15020,-20220,25,18,43,58.14,0.004109302325581397,32.93023255813954
3266,3057,12743,18,12,30,60.0,0.03657333333333333,77.0
3296,4929,-15979,21,27,48,43.75,-0.012777083333333328,32.375
3305,6715,-765,18,16,34,52.94,0.0023147058823529435,60.470588235294116
3308,2773,4087,25,17,42,59.52,0.020749999999999998,35.26190476190476
3311,6868,17432,27,16,43,62.79,0.03561627906976744,37.04651162790697
3312,3419,13141,26,16,42,61.9,0.023811904761904763,42.095238095238095
3321,3348,-10468,17,22,39,43.59,-0.011351282051282054,16.71794871794872
3338,10377,11373,22,17,39,56.41,0.004056410256410258,32.02564102564103
3346,7176,-1126,14,11,25,56.0,0.027331999999999995,27.88
3356,18623,-95923,21,30,51,41.18,-0.029088235294117647,35.98039215686274
3376,24990,-89290,21,23,44,47.73,-0.016172727272727273,41.18181818181818
3380,5455,295,23,18,41,56.1,0.004787804878048779,39.170731707317074
3383,3376,4504,23,28,51,45.1,-0.0049627450980392175,18.647058823529413
3406,86563,211937,32,19,51,62.75,0.03350980392156863,19.176470588235293
3413,38248,34152,26,13,39,66.67,0.01845384615384615,19.333333333333332
3416,9650,-6050,15,13,28,53.57,0.0020214285714285725,87.35714285714286
3419,4564,-6154,25,20,45,55.56,-0.0013844444444444438,34.75555555555555
3432,4111,18449,32,14,46,69.57,0.03957608695652175,31.804347826086957
3437,6828,33722,27,15,42,64.29,0.034673809523809516,21.166666666666668
3443,66401,216699,29,18,47,61.7,0.030431914893617018,30.72340425531915
3450,28876,-51776,29,26,55,52.73,-0.0019509090909090906,25.01818181818182
3454,25643,-39043,22,23,45,48.89,-0.009213333333333332,43.48888888888889
3481,3672,-9162,21,24,45,46.67,-0.010971111111111114,37.577777777777776
3494,3680,760,28,17,45,62.22,0.029393333333333334,24.466666666666665
3501,8118,5082,16,12,28,57.14,0.008714285714285711,85.64285714285714
3504,17694,22206,27,20,47,57.45,0.013,25.19148936170213
3515,21438,55262,23,15,38,60.53,0.02392368421052632,43.18421052631579
3518,9157,2143,25,25,50,50.0,0.0005019999999999971,27.52
3528,6194,35856,22,7,29,75.86,0.036572413793103456,83.27586206896552
3530,22249,43471,26,20,46,56.52,0.026713043478260864,25.08695652173913
3532,31838,27212,29,21,50,58.0,0.015985999999999997,24.1
3533,77676,211924,30,23,53,56.6,0.01389811320754717,32.18867924528302
3535,5435,-3985,29,28,57,50.88,0.004205263157894737,22.210526315789473
3536,3617,-787,23,29,52,44.23,0.005267307692307691,21.28846153846154
3543,2401,2589,15,10,25,60.0,0.017496,54.16
3545,16244,25256,27,23,50,54.0,0.014990000000000003,24.64
3550,3776,5324,24,16,40,60.0,0.011857499999999998,42.775
3557,6258,5422,23,16,39,58.97,0.022061538461538462,37.82051282051282
3563,51756,-114956,22,24,46,47.83,-0.007630434782608695,35.52173913043478
3576,5074,19976,27,19,46,58.7,0.02580652173913043,29.956521739130434
3583,15251,43799,24,16,40,60.0,0.024170000000000004,38.225
3588,16398,-5498,31,25,56,55.36,0.008358928571428573,24.660714285714285
3591,5909,-209,25,23,48,52.08,0.0017208333333333346,30.895833333333332
3593,3604,3056,23,25,48,47.92,0.012504166666666669,22.875
3596,17574,40426,27,19,46,58.7,0.012193478260869566,31.76086956521739
3605,9382,-18382,26,25,51,50.98,-0.008592156862745094,25.45098039215686
3607,9866,-24616,24,23,47,51.06,-0.011376595744680848,34.148936170212764
3617,17047,-2047,20,15,35,57.14,0.009122857142857141,56.51428571428571
3622,7098,-24738,26,24,50,52.0,0.002732000000000002,28.44
3645,13952,20198,31,21,52,59.62,0.018628846153846156,22.923076923076923
3653,42861,-21111,29,22,51,56.86,0.012939215686274508,21.333333333333332
3661,72622,-202872,25,19,44,56.82,0.014784090909090912,13.863636363636363
3665,53634,76066,31,19,50,62.0,0.01359,24.12
3669,8239,-18439,21,20,41,51.22,0.008646341463414637,37.19512195121951
3673,36665,46485,30,20,50,60.0,0.009496,25.42
3679,15857,41243,23,17,40,57.5,0.025824999999999997,44.85
3682,2136,-10916,13,17,30,43.33,-0.02391,61.666666666666664
3686,3521,-7071,23,26,49,46.94,-0.017189795918367348,30.06122448979592
3694,5522,828,28,21,49,57.14,0.0009408163265306144,29.775510204081634
3701,3049,-30699,10,22,32,31.25,-0.045228124999999994,65.15625
3702,7485,27915,20,11,31,64.52,0.02464193548387097,81.09677419354838
3703,2900,8860,20,9,29,68.97,0.02591034482758621,74.72413793103448
3704,5663,-36653,22,29,51,43.14,-0.027780392156862743,33.549019607843135
3705,3836,4664,8,6,14,57.14,0.011678571428571427,208.07142857142858
3706,4543,9507,18,9,27,66.67,0.01868888888888889,70.14814814814815
3708,18850,-24250,18,14,32,56.25,0.006087499999999999,23.0
3711,8948,19052,11,7,18,61.11,0.019933333333333334,38.111111111111114
3712,3186,1214,12,7,19,63.16,0.013821052631578944,30.894736842105264
3714,3540,-21940,3,5,8,37.5,-0.033125,25.25
4104,6885,3965,13,9,22,59.09,0.004518181818181822,125.13636363636364
4106,8446,-21546,21,21,42,50.0,-0.007852380952380956,45.833333333333336
4108,6900,-42650,15,28,43,34.88,-0.027411627906976734,45.23255813953488
4119,19015,10885,24,14,38,63.16,0.017244736842105264,53.13157894736842
4133,8910,9190,19,15,34,55.88,0.016514705882352935,54.705882352941174
4137,46162,-235162,16,22,38,42.11,-0.02154473684210526,33.76315789473684
4142,8974,-20474,23,20,43,53.49,-0.0023441860465116295,41.604651162790695
4155,8012,-26262,19,20,39,48.72,-0.014517948717948719,48.02564102564103
4164,11600,-52550,16,19,35,45.71,-0.012417142857142857,55.51428571428571
4190,16017,-143417,11,19,30,36.67,-0.03894666666666667,35.13333333333333
4306,3064,-6324,18,15,33,54.55,-0.0024212121212121205,65.27272727272727
4414,4765,-9695,26,28,54,48.15,-0.012514814814814812,28.833333333333332
4426,14767,-18667,24,22,46,52.17,-0.007076086956521742,25.02173913043478
4438,15589,-74589,8,12,20,40.0,-0.022154999999999998,48.4
4439,9058,-19558,6,5,11,54.55,-0.0054363636363636385,39.54545454545455
4526,4551,4349,20,17,37,54.05,0.01684054054054054,58.432432432432435
4532,5040,10460,19,14,33,57.58,0.015512121212121217,72.21212121212122
4536,23619,-66319,14,17,31,45.16,-0.009319354838709677,56.12903225806452
4540,7053,89607,13,12,25,52.0,0.12296000000000001,66.04
4545,5477,35773,16,10,26,61.54,0.04417692307692308,33.30769230769231
4551,30798,64702,24,13,37,64.86,0.02137837837837838,19.62162162162162
4552,8511,-87011,8,17,25,32.0,-0.05256399999999999,47.12
4555,6361,29289,11,7,18,61.11,0.03326111111111111,89.38888888888889
4557,6835,12465,10,6,16,62.5,0.015293749999999998,104.1875
4560,5994,-46034,8,13,21,38.1,-0.0364,59.0
4562,3684,-23084,7,14,21,33.33,-0.021490476190476192,77.23809523809524
4564,4647,-2327,9,10,19,47.37,0.0061684210526315765,24.842105263157894
4566,5628,-27288,9,11,20,45.0,-0.019815,46.85
4571,6648,-34448,5,8,13,38.46,-0.013538461538461546,34.53846153846154
4572,6391,50409,8,3,11,72.73,0.05738181818181817,30.181818181818183
4576,8946,4154,8,7,15,53.33,0.012173333333333335,21.4
4581,1333,2117,3,3,6,50.0,0.010566666666666669,87.33333333333333
4720,1856,5794,12,9,21,57.14,0.023271428571428568,129.76190476190476
4722,5638,10612,18,13,31,58.06,0.010338709677419355,73.70967741935483
4737,14602,62098,23,17,40,57.5,0.030285000000000006,45.95
4739,18448,33802,25,20,45,55.56,0.01346,31.266666666666666
4746,16344,-44244,23,23,46,50.0,-0.009543478260869567,37.0
4755,10423,66027,20,11,31,64.52,0.03181290322580645,54.03225806451613
4763,21683,-11983,16,13,29,55.17,-0.00034482758620689636,38.41379310344828
4764,5968,392,8,7,15,53.33,0.005773333333333333,97.33333333333333
4766,11433,-54933,6,8,14,42.86,-0.02162142857142857,56.642857142857146
4807,4942,-35052,8,12,20,40.0,-0.022405,58.95
4904,5746,-346,8,6,14,57.14,0.004714285714285712,207.28571428571428
4906,6868,2132,27,18,45,60.0,0.008186666666666662,37.0
4912,37524,-5924,31,23,54,57.41,0.010351851851851853,25.296296296296298
4915,12542,53908,29,15,44,65.91,0.025218181818181817,32.18181818181818
4916,7721,-22821,20,20,40,50.0,-0.010925,32.35
4919,16700,54450,31,20,51,60.78,0.020284313725490194,30.176470588235293
4927,12401,25199,28,17,45,62.22,0.01394888888888889,33.48888888888889
4930,3930,8120,21,18,39,53.85,0.019264102564102565,47.94871794871795
4934,5903,8657,31,23,54,57.41,0.009187037037037037,23.5
4935,17521,-110171,18,28,46,39.13,-0.032165217391304346,36.52173913043478
4938,13857,-45807,17,20,37,45.95,-0.009902702702702697,56.13513513513514
4942,6412,3188,17,16,33,51.52,0.004057575757575756,61.696969696969695
4943,28740,-38940,16,20,36,44.44,-0.0050666666666666655,14.527777777777779
4952,9702,10998,25,15,40,62.5,0.020329999999999997,39.325
4956,5625,-10795,22,25,47,46.81,-0.004663829787234044,31.361702127659573
4958,22548,-17848,24,19,43,55.81,0.00483953488372093,39.55813953488372
4960,4987,-9857,24,24,48,50.0,-0.0007729166666666671,32.208333333333336
4961,17524,-128084,18,20,38,47.37,-0.01269473684210526,51.55263157894737
4967,6506,4254,21,21,42,50.0,0.010214285714285712,30.166666666666668
4968,32471,-68671,21,14,35,60.0,0.00809142857142857,17.257142857142856
4976,10846,4554,27,21,48,56.25,0.006952083333333337,24.1875
4977,21735,-29735,22,20,42,52.38,-0.0060833333333333295,30.452380952380953
4989,4167,10443,14,15,29,48.28,0.0007103448275862062,27.655172413793103
4994,28954,-229554,26,21,47,55.32,-0.0006574468085106332,27.29787234042553
4999,7274,-4274,14,11,25,56.0,0.0034080000000000017,81.52
5007,7097,-17497,10,10,20,50.0,0.0007900000000000002,144.1
5203,15672,30528,17,13,30,56.67,0.015719999999999998,83.3
5215,13081,29519,23,20,43,53.49,0.009662790697674417,38.906976744186046
5225,10608,-18158,20,23,43,46.51,-0.003320930232558138,39.674418604651166
5234,15529,17321,23,15,38,60.53,0.015457894736842106,42.71052631578947
5243,10443,-4993,22,19,41,53.66,-0.0013243902439024394,32.0
5258,4543,6907,15,13,28,53.57,0.018092857142857143,27.785714285714285
5269,174226,1591674,35,16,51,68.63,0.03220196078431373,15.431372549019608
5283,7397,66353,14,5,19,73.68,0.06879473684210526,133.0
5284,5976,-26426,8,11,19,42.11,-0.015978947368421054,105.42105263157895
5285,11637,-14687,16,14,30,53.33,-0.0030299999999999997,45.666666666666664
5288,19191,42709,19,11,30,63.33,0.01581333333333333,46.53333333333333
5388,14432,-33582,19,17,36,52.78,-0.00756111111111111,63.333333333333336
5434,17419,87631,23,12,35,65.71,0.029505714285714284,61.68571428571428
5469,6644,13386,26,18,44,59.09,0.011790909090909086,34.70454545454545
5471,9522,-7972,17,15,32,53.12,0.004940625000000001,65.8125
5484,3104,-1584,21,25,46,45.65,0.0015478260869565203,37.5
5515,1366,-2546,9,9,18,50.0,-0.01158333333333333,165.5
5519,3457,-357,16,14,30,53.33,-0.005573333333333333,77.26666666666667
5521,2508,1522,20,15,35,57.14,0.015594285714285713,55.371428571428574
5522,6645,23755,15,11,26,57.69,0.019284615384615386,93.96153846153847
5525,2779,-2029,12,11,23,52.17,0.0020217391304347826,114.30434782608695
5531,3395,-6125,18,19,37,48.65,0.0005054054054054062,58.729729729729726
5533,1170,980,6,5,11,54.55,0.010154545454545454,291.72727272727275
5534,13661,35939,19,12,31,61.29,0.02112258064516129,71.6774193548387
5538,5638,16412,17,9,26,65.38,0.023619230769230767,71.23076923076923
5546,3666,-15366,3,6,9,33.33,-0.025355555555555555,35.111111111111114
5607,5292,-18542,17,17,34,50.0,-0.009641176470588233,63.5
5608,3621,10299,17,16,33,51.52,0.006887878787878789,65.54545454545455
5706,6873,-4773,13,11,24,54.17,0.007462499999999997,102.875
5871,25458,139192,29,11,40,72.5,0.0410775,45.85
5876,3942,7288,10,6,16,62.5,0.01221875,105.375
5880,1634,8866,9,5,14,64.29,0.034542857142857146,215.0
5906,4910,-8640,26,26,52,50.0,0.02298269230769231,24.923076923076923
5907,8840,-34240,18,21,39,46.15,-0.004500000000000002,49.23076923076923
6005,1853,257,14,11,25,56.0,0.009239999999999998,99.56
6024,4589,-5539,11,9,20,55.0,0.006450000000000003,128.85
6108,4024,-15974,16,15,31,51.61,-0.010645161290322577,68.70967741935483
6112,4597,-24347,11,13,24,45.83,-0.021358333333333337,110.04166666666667
6115,3465,15985,10,4,14,71.43,0.03352142857142858,215.71428571428572
6116,3246,-6646,23,24,47,48.94,-0.0025893617021276604,32.57446808510638
6117,3769,12531,25,15,40,62.5,0.019175000000000005,45.675
6120,4748,-16548,22,29,51,43.14,-0.011282352941176473,28.235294117647058
6128,4313,20787,15,7,22,68.18,0.03487727272727273,115.72727272727273
6133,2007,10803,20,9,29,68.97,0.04274827586206896,73.55172413793103
6136,2229,-6229,7,10,17,41.18,-0.009894117647058824,175.35294117647058
6139,6188,10162,20,16,36,55.56,0.013536111111111117,58.19444444444444
6141,5125,6365,27,19,46,58.7,0.013097826086956522,35.47826086956522
6142,2465,1745,23,15,38,60.53,0.013292105263157897,42.44736842105263
6152,3277,-14437,19,24,43,44.19,-0.008804651162790694,41.46511627906977
6153,9257,-36707,22,28,50,44.0,-0.013212,31.24
6155,4521,26529,24,9,33,72.73,0.04733939393939394,52.666666666666664
6164,3490,-760,25,19,44,56.82,0.004713636363636365,35.18181818181818
6165,5984,14176,34,17,51,66.67,0.029645098039215688,18.92156862745098
6166,16551,-47451,20,27,47,42.55,-0.014106382978723403,39.808510638297875
6168,4737,3703,29,19,48,60.42,0.012068750000000003,28.145833333333332
6172,5085,11015,35,23,58,60.34,0.013989655172413788,18.46551724137931
6176,23004,9046,25,16,41,60.98,0.012275609756097563,48.609756097560975
6177,4919,20931,18,10,28,64.29,0.032075,87.14285714285714
6183,3075,38025,14,2,16,87.5,0.07285,177.9375
6184,3989,5411,9,6,15,60.0,0.017653333333333337,194.66666666666666
6189,3330,18870,12,5,17,70.59,0.040117647058823536,165.58823529411765
6191,5012,-11822,27,22,49,55.1,-0.0019102040816326546,37.204081632653065
6192,8155,13645,12,10,22,54.55,0.014172727272727271,115.04545454545455
6196,14238,69312,31,15,46,67.39,0.036395652173913044,32.23913043478261
6197,7093,29407,25,13,38,65.79,0.029807894736842106,47.1578947368421
6201,3250,12350,9,8,17,52.94,0.02115882352941176,174.23529411764707
6202,15026,79724,23,13,36,63.89,0.03669722222222223,55.138888888888886
6205,7264,-16014,18,19,37,48.65,-0.00031351351351350957,43.21621621621622
6206,16017,-2917,17,13,30,56.67,0.006676666666666664,78.66666666666667
6209,8989,161,29,23,52,55.77,0.00686923076923077,24.807692307692307
6213,18317,-14167,22,21,43,51.16,-0.001309302325581393,39.55813953488372
6214,8346,31104,16,8,24,66.67,0.03065,100.875
6215,5265,-9165,22,27,49,44.9,-0.0011857142857142865,31.897959183673468
6216,3596,24154,16,7,23,69.57,0.0463304347826087,108.0
6224,16892,36358,21,16,37,56.76,0.021151351351351346,58.945945945945944
6225,2869,-5779,21,33,54,38.89,-0.014535185185185187,19.14814814814815
6226,2982,5978,25,19,44,56.82,0.020075000000000003,36.5
6230,29719,-159819,19,22,41,46.34,-0.015158536585365852,35.21951219512195
6235,4878,3922,30,20,50,60.0,0.015408000000000002,31.04
6239,14973,54827,22,12,34,64.71,0.022352941176470593,64.76470588235294
6243,5140,57140,32,16,48,66.67,0.07076458333333334,22.333333333333332
6251,3879,11731,26,17,43,60.47,0.02507209302325582,36.395348837209305
6257,6807,11293,20,13,33,60.61,0.013615151515151514,66.54545454545455
6269,24196,57204,24,17,41,58.54,0.019014634146341466,42.48780487804878
6271,39340,-45140,23,24,47,48.94,0.002829787234042555,33.170212765957444
6277,12170,-16470,14,12,26,53.85,-0.00013076923076923408,97.3076923076923
6278,18178,-35478,23,21,44,52.27,-0.002572727272727272,41.43181818181818
6281,4377,13123,7,4,11,63.64,0.019218181818181822,285.54545454545456
6282,6695,4355,26,18,44,59.09,0.010411363636363637,38.47727272727273
6283,8699,10451,27,26,53,50.94,0.00961509433962264,19.452830188679247
6285,16067,-44717,20,18,38,52.63,-0.00905263157894737,54.68421052631579
6288,4654,-17244,20,22,42,47.62,-0.0033833333333333332,34.88095238095238
6289,2757,-1447,24,35,59,40.68,-0.01314237288135593,14.491525423728813
6405,5760,-14310,19,19,38,50.0,-0.008107894736842106,32.73684210526316
6409,152456,165044,23,12,35,65.71,0.023568571428571432,42.2
6412,9509,27091,17,11,28,60.71,0.018132142857142854,64.42857142857143
6414,84277,6723,27,20,47,57.45,0.010223404255319144,23.425531914893618
6415,389968,-1117968,29,20,49,59.18,0.007863265306122448,23.142857142857142
6416,24737,75893,26,15,41,63.41,0.028431707317073174,35.26829268292683
6431,3779,14261,18,13,31,58.06,0.035977419354838724,38.806451612903224
6438,12380,5620,15,12,27,55.56,0.007970370370370374,24.48148148148148
6442,5819,-69,13,11,24,54.17,0.01295833333333333,59.5
6443,3956,-2896,16,18,34,47.06,-1.764705882352849e-05,24.823529411764707
6449,9475,5075,20,17,37,54.05,0.010651351351351352,29.405405405405407
6451,24165,-19765,19,17,36,52.78,-0.0041722222222222265,19.444444444444443
6456,24121,9979,17,16,33,51.52,0.0067030303030303036,27.90909090909091
6464,6488,-22788,4,6,10,40.0,-0.020470000000000002,195.5
6477,5923,19327,18,11,29,62.07,0.027975862068965515,27.620689655172413
6491,31666,217454,15,8,23,65.22,0.0656608695652174,69.69565217391305
6504,32408,-11508,17,17,34,50.0,0.004767647058823534,52.588235294117645
6505,13721,-4521,13,12,25,52.0,-0.0019759999999999995,107.08
6515,14062,54938,5,2,7,71.43,0.03652857142857143,18.714285714285715
6525,9471,35629,13,9,22,59.09,0.026409090909090917,52.18181818181818
6531,41449,651,19,12,31,61.29,0.023645161290322576,20.516129032258064
6533,39101,-132701,15,16,31,48.39,-0.008264516129032258,19.419354838709676
6541,16764,-40474,16,18,34,47.06,-0.011117647058823529,26.970588235294116
6552,10521,-34871,12,16,28,42.86,-0.00986785714285714,20.678571428571427
6558,4853,24687,17,5,22,77.27,0.04666363636363636,22.40909090909091
6573,4237,-7437,13,12,25,52.0,0.0034919999999999994,20.68
6579,9717,-56267,7,13,20,35.0,-0.026839999999999996,74.1
6581,10197,-16547,11,9,20,55.0,0.007139999999999999,52.0
6582,17111,-72211,11,13,24,45.83,-0.010050000000000002,36.041666666666664
6591,10113,11587,16,10,26,61.54,0.020138461538461536,31.46153846153846
6592,3780,16520,5,2,7,71.43,0.03788571428571429,78.85714285714286
6598,5257,-59797,4,11,15,26.67,-0.057893333333333345,10.0
6605,16099,-22799,15,16,31,48.39,-0.005038709677419358,75.80645161290323
6625,4324,-24074,7,10,17,41.18,-0.016241176470588235,42.76470588235294
6641,3793,1407,6,4,10,60.0,0.006729999999999997,81.3
6655,5023,65527,11,2,13,84.62,0.07786923076923079,45.30769230769231
6666,8418,-11218,6,7,13,46.15,-0.01722307692307692,48.76923076923077
6668,7150,19150,11,8,19,57.89,0.02008947368421053,18.0
6669,58577,-78577,8,6,14,57.14,0.0022142857142857125,33.285714285714285
6670,14666,95334,10,3,13,76.92,0.04736153846153846,47.07692307692308
6671,2216,3184,5,4,9,55.56,0.010655555555555552,77.33333333333333
6672,9819,-90019,5,13,18,27.78,-0.04915,26.72222222222222
6674,2858,-13558,7,9,16,43.75,-0.015037499999999994,38.0625
6698,3646,2054,6,7,13,46.15,0.009338461538461539,21.615384615384617
6706,12982,10718,7,6,13,53.85,0.008046153846153844,19.923076923076923
6715,6014,-27014,4,5,9,44.44,-0.012266666666666667,58.111111111111114
6743,4364,-22814,4,4,8,50.0,-0.024075,17.375
6754,1565,-3965,2,4,6,33.33,-0.010400000000000001,72.16666666666667
6756,17765,-5265,4,4,8,50.0,0.012400000000000005,11.125
8011,6441,9709,25,19,44,56.82,0.013115909090909095,35.97727272727273
8016,28935,-14935,23,18,41,56.1,0.007087804878048781,40.146341463414636
8021,5219,-7819,19,16,35,54.29,-0.0024685714285714276,60.6
8028,8173,12377,19,12,31,61.29,0.03233548387096775,39.61290322580645
8033,3124,11806,25,15,40,62.5,0.0296325,35.875
8039,9800,26750,23,14,37,62.16,0.02024864864864865,53.891891891891895
8046,30667,-112167,29,21,50,58.0,0.010319999999999998,26.32
8070,24127,42823,26,17,43,60.47,0.017523255813953496,40.97674418604651
8072,5573,-57223,12,19,31,38.71,-0.028593548387096778,77.41935483870968
8081,27526,-3926,21,17,38,55.26,0.0023947368421052646,52.421052631578945
8101,2975,-7175,21,26,47,44.68,0.0059000000000000025,32.829787234042556
8103,8246,-28296,19,22,41,46.34,-0.0173390243902439,49.048780487804876
8104,8761,-59681,8,14,22,36.36,-0.026863636363636364,27.863636363636363
8105,3975,-14665,22,26,48,45.83,-0.011341666666666668,33.020833333333336
8110,3485,-35,25,18,43,58.14,0.0075232558139534875,40.04651162790697
8112,5447,9253,23,13,36,63.89,0.016291666666666663,52.94444444444444
8114,24581,25319,20,13,33,60.61,0.01846060606060606,62.06060606060606
8131,4465,29285,20,8,28,71.43,0.038853571428571425,76.82142857142857
8150,7413,16787,22,15,37,59.46,0.016981081081081085,36.13513513513514
8163,8217,2783,27,19,46,58.7,0.01311956521739131,33.630434782608695
8201,3169,-1089,21,19,40,52.5,0.0011225000000000013,42.8
8210,13097,-27447,21,20,41,51.22,-0.005246341463414635,46.926829268292686
8213,8072,12478,21,15,36,58.33,0.01061666666666667,60.77777777777778
8215,7291,509,29,23,52,55.77,0.013203846153846156,24.46153846153846
8222,3373,-10023,13,15,28,46.43,-0.0072749999999999985,49.67857142857143
8249,4214,6786,20,13,33,60.61,0.01910909090909091,65.6969696969697
8261,10114,26116,28,19,47,59.57,0.01787446808510638,25.638297872340427
8271,9090,-33590,21,25,46,45.65,-0.013767391304347829,43.21739130434783
8341,29819,42681,15,12,27,55.56,0.011248148148148148,49.925925925925924
8367,3999,7651,12,8,20,60.0,0.028384999999999994,53.8
8374,5890,17930,28,14,42,66.67,0.025526190476190473,35.69047619047619
8404,7991,-19891,22,19,41,53.66,0.0044853658536585335,44.390243902439025
8411,8119,-34369,25,14,39,64.1,0.014466666666666668,38.717948717948715
8422,18631,-39131,9,9,18,50.0,-0.0025666666666666663,145.22222222222223
8429,9542,-67052,19,26,45,42.22,-0.03062888888888889,30.644444444444446
8442,3917,29483,9,4,13,69.23,0.05446153846153846,90.0
8443,2036,-176,11,9,20,55.0,0.011610000000000002,87.1
8454,112318,341182,17,15,32,53.12,0.011084375,42.09375
8462,20595,-9095,14,9,23,60.87,0.007982608695652172,43.08695652173913
8463,4059,-7509,10,13,23,43.48,-0.0004217391304347832,63.56521739130435
8464,53501,125499,19,11,30,63.33,0.01776666666666667,35.7
8466,6743,-58643,6,11,17,35.29,-0.04714117647058824,81.0
8467,5158,-10408,8,12,20,40.0,-0.0007799999999999983,64.75
8473,4849,-41449,4,13,17,23.53,-0.04792941176470589,85.88235294117646
8478,11964,-28324,14,10,24,58.33,0.0008166666666666669,37.791666666666664
8480,9893,-66193,4,10,14,28.57,-0.03696428571428572,95.5
8481,5494,12756,10,6,16,62.5,0.021443749999999998,80.0625
8482,6018,-7818,4,6,10,40.0,-0.006079999999999998,92.5
8488,2174,-15374,8,10,18,44.44,-0.011999999999999999,68.5
8499,13406,25994,10,11,21,47.62,0.011066666666666657,30.952380952380953
8926,2505,8445,10,6,16,62.5,0.0199125,162.5625
8940,2269,-7689,10,15,25,40.0,-0.011616,98.32
8996,13768,-29818,23,21,44,52.27,0.0016840909090909085,30.886363636363637
9802,17284,79916,25,13,38,65.79,0.02993947368421053,45.5
9902,2463,10577,22,10,32,68.75,0.035928125,65.375
9904,7719,-24069,17,20,37,45.95,-0.011551351351351354,58.24324324324324
9905,2699,-9999,7,9,16,43.75,-0.013287499999999997,183.6875
9906,8258,942,24,21,45,53.33,0.00521777777777778,30.755555555555556
9907,3192,-6872,17,14,31,54.84,-0.006935483870967741,70.41935483870968
9908,1518,10282,7,3,10,70.0,0.04668,308.8
9910,39114,43086,26,17,43,60.47,0.019925581395348835,39.72093023255814
9911,6118,40082,21,8,29,72.41,0.0429206896551724,71.48275862068965
9912,2700,890,22,14,36,61.11,0.019908333333333337,51.52777777777778
9914,54215,47285,28,20,48,58.33,0.01151875,34.6875
9917,6145,44855,9,3,12,75.0,0.050583333333333334,251.66666666666666
9918,2919,22531,12,2,14,85.71,0.04819285714285714,222.85714285714286
9919,3787,363,17,14,31,54.84,0.02159032258064516,71.96774193548387
9921,47357,-75857,18,19,37,48.65,-0.006713513513513518,53.21621621621622
9924,5799,4401,15,11,26,57.69,0.011180769230769234,94.07692307692308
9925,2152,-202,6,4,10,60.0,0.005279999999999999,320.5
9926,3096,6704,8,4,12,66.67,0.015725,258.9166666666667
9927,4092,34258,15,5,20,75.0,0.05481499999999999,128.25
9928,2703,-423,17,23,40,42.5,0.012852499999999994,49.2
9929,2444,806,18,15,33,54.55,0.01577272727272727,62.27272727272727
9930,4634,8766,9,5,14,64.29,0.015014285714285714,210.57142857142858
9931,3492,7658,12,5,17,70.59,0.019964705882352943,178.1764705882353
9933,8514,-24764,15,17,32,46.88,-0.011393749999999998,77.3125
9934,3379,-1329,18,16,34,52.94,-0.0032323529411764675,57.411764705882355
9935,4571,-10321,20,23,43,46.51,-0.0018186046511627905,38.093023255813954
9937,2615,12485,7,4,11,63.64,0.030618181818181822,290.6363636363636
9938,18426,91074,30,15,45,66.67,0.03185777777777778,31.755555555555556
9939,8895,12955,15,10,25,60.0,0.013676000000000004,97.68
9940,5257,5243,15,9,24,62.5,0.013891666666666668,103.29166666666667
9941,17437,133763,19,8,27,70.37,0.04568888888888889,83.77777777777777
9942,12777,-6777,14,11,25,56.0,0.010123999999999998,96.84
9943,5682,-3432,9,9,18,50.0,0.005627777777777779,150.11111111111111
9944,5699,-6899,19,18,37,51.35,0.008397297297297296,54.91891891891892
9945,11395,19455,23,16,39,58.97,0.017128205128205128,54.05128205128205
9946,3427,4423,20,14,34,58.82,0.012364705882352946,51.35294117647059
9955,4501,7899,23,17,40,57.5,0.0177475,41.75
9958,12002,19238,21,17,38,55.26,0.008400000000000001,51.921052631578945
1312A,2249,10551,9,5,14,64.29,0.03477857142857143,206.07142857142858
2002A,1847,1903,4,3,7,57.14,0.013014285714285713,477.7142857142857
2836A,138,1062,1,0,1,100.0,0.0468,459.0
2838A,629,4171,1,1,2,50.0,0.04195,789.5
2881A,747,2853,1,1,2,50.0,0.026099999999999998,1059.5
2881B,360,1040,1,0,1,100.0,0.0172,1425.0
2882A,364,536,1,0,1,100.0,0.0087,1844.0
2882B,362,1538,1,0,1,100.0,0.0254,1366.0
2887E,311,1089,1,0,1,100.0,0.0209,1879.0
2887F,301,-601,0,1,1,0.0,-0.0116,1169.0
2888A,498,-6248,0,2,2,0.0,-0.06905,437.0
2888B,249,-1099,0,1,1,0.0,-0.0254,610.0
2891B,756,2944,1,1,2,50.0,0.0258,730.5
2891C,359,41,1,0,1,100.0,0.0007,1096.0
2897A,139,-879,1,1,2,50.0,-0.0416,564.5
3702A,558,-7058,1,1,2,50.0,-0.06735,433.5
5871A,595,3305,1,0,1,100.0,0.0335,575.0
9941A,304,596,1,0,1,100.0,0.0116,1264.0
1240,3654,31696,9,3,12,75.0,0.05818333333333333,67.0
1258,5799,10071,20,17,37,54.05,0.024862162162162162,47.972972972972975
1259,8323,-57023,7,11,18,38.89,-0.02788888888888889,155.27777777777777
1264,16863,53137,7,5,12,58.33,0.023833333333333328,155.83333333333334
1268,7752,-56332,3,7,10,30.0,-0.03288,183.9
1336,3343,6797,23,14,37,62.16,0.01875135135135135,47.270270270270274
1565,139954,-313454,22,21,43,51.16,-0.00126046511627907,41.51162790697674
1569,7614,-26024,26,27,53,49.06,-0.013098113207547167,26.79245283018868
1570,3458,7672,22,17,39,56.41,0.017710256410256413,45.43589743589744
1580,22233,-74333,14,15,29,48.28,-0.010341379310344826,73.13793103448276
1584,3827,3183,27,20,47,57.45,0.015589361702127658,33.97872340425532
1586,6962,24238,24,12,36,66.67,0.033763888888888885,54.5
1591,6666,8434,23,16,39,58.97,0.014353846153846156,39.43589743589744
1593,10517,-23517,17,17,34,50.0,0.00041470588235294366,61.3235294117647
1595,10908,-23908,16,20,36,44.44,-0.006383333333333334,53.25
1599,9468,-7268,19,18,37,51.35,0.00041081081081080777,50.027027027027025
1742,4788,-738,22,21,43,51.16,0.005895348837209301,33.74418604651163
1752,7932,23318,20,14,34,58.82,0.020879411764705882,56.205882352941174
1777,10475,-125,13,11,24,54.17,0.008058333333333334,106.54166666666667
1781,6262,-19702,18,26,44,40.91,-0.005929545454545459,29.181818181818183
1784,10659,-6159,24,23,47,51.06,0.003972340425531917,36.744680851063826
1785,6596,4054,23,15,38,60.53,0.01021578947368421,44.13157894736842
1788,10798,110202,15,3,18,83.33,0.06383333333333333,153.94444444444446
1796,5297,-287,10,10,20,50.0,0.0026799999999999997,39.75
1799,6547,17713,28,22,50,56.0,0.029258000000000003,25.52
1813,5570,-10920,17,17,34,50.0,-0.0068382352941176484,62.529411764705884
1815,3389,2411,24,16,40,60.0,0.0094875,39.975
2035,5713,-5213,12,13,25,48.0,0.003003999999999999,107.92
2061,4440,-22220,19,28,47,40.43,-0.009629787234042553,29.638297872340427
2063,4297,9803,14,10,24,58.33,0.0217125,97.20833333333333
2064,2230,-2930,9,13,22,40.91,0.0004999999999999973,83.81818181818181
2065,3626,-4376,8,7,15,53.33,-0.005246666666666667,72.86666666666666
2066,15341,52759,16,12,28,57.14,0.021046428571428574,66.78571428571429
2067,2899,3871,15,16,31,48.39,0.02248387096774194,50.0
2070,3974,-7204,9,9,18,50.0,0.01266111111111111,80.0
2221,6325,9975,25,20,45,55.56,0.017460000000000003,37.55555555555556
2230,3678,3392,22,17,39,56.41,0.0076179487179487155,41.256410256410255
2235,12773,-26073,13,14,27,48.15,-0.010218518518518517,52.55555555555556
2596,2563,-9213,11,12,23,47.83,-0.013360869565217393,108.52173913043478
2640,16376,-9176,19,13,32,59.38,0.015,53.09375
2641,2664,1896,18,16,34,52.94,0.0062147058823529425,35.76470588235294
2643,6339,16261,13,10,23,56.52,0.01160869565217391,47.47826086956522
2718,5914,-21364,15,17,32,46.88,-0.015125000000000001,61.5625
2719,4760,-20620,20,30,50,40.0,-0.02369,32.42
2724,5496,-35066,17,29,46,36.96,-0.027552173913043484,25.804347826086957
2726,10366,12984,17,12,29,58.62,0.0198,41.51724137931034
2729,32079,87421,14,8,22,63.64,0.019931818181818182,106.18181818181819
2732,21833,-87333,14,21,35,40.0,-0.022217142857142855,35.2
2734,5426,-5546,18,20,38,47.37,0.010152631578947371,30.57894736842105
2736,2599,-10049,12,12,24,50.0,-0.0013916666666666637,50.0
2740,5350,-26750,12,23,35,34.29,-0.020348571428571424,27.514285714285716
2743,3455,-3455,11,11,22,50.0,0.01166363636363636,26.954545454545453
2745,4103,-6383,13,9,22,59.09,0.025995454545454544,53.68181818181818
2752,5756,-53756,2,5,7,28.57,-0.04507142857142856,101.28571428571429
2754,1643,-19143,1,3,4,25.0,-0.0626,114.5
2755,1308,-2708,2,2,4,50.0,-0.007325000000000005,82.5
2916,1868,6482,11,6,17,64.71,0.022841176470588233,167.88235294117646
2924,5603,-30953,8,13,21,38.1,-0.01901904761904762,124.66666666666667
2926,16343,-82543,8,13,21,38.1,-0.03009523809523809,112.61904761904762
2937,3482,18418,14,7,21,66.67,0.03771904761904761,62.285714285714285
3064,7472,228,22,28,50,44.0,0.024658,26.16
3066,3170,-2670,23,21,44,52.27,0.005604545454545455,35.15909090909091
3067,4275,7315,17,17,34,50.0,0.017417647058823527,60.588235294117645
3071,3888,1122,23,17,40,57.5,0.0049125,37.2
3073,4374,7276,26,27,53,49.06,0.03682641509433962,16.452830188679247
3078,7362,28858,29,16,45,64.44,0.028659999999999998,35.55555555555556
3081,69623,-5623,21,17,38,55.26,0.0001421052631578956,25.68421052631579
3083,13683,58417,26,19,45,57.78,0.03329333333333333,24.88888888888889
3085,4165,-23605,21,32,53,39.62,-0.028156603773584903,12.981132075471699
3086,6902,-77972,21,28,49,42.86,-0.012302040816326531,19.387755102040817
3088,12430,46020,25,13,38,65.79,0.029392105263157896,51.63157894736842
3089,7326,-12536,28,23,51,54.9,0.009258823529411767,13.313725490196079
3092,10486,-13726,25,23,48,52.08,0.006283333333333335,28.708333333333332
3093,7735,41165,21,11,32,65.62,0.026699999999999998,72.46875
3095,2818,422,25,28,53,47.17,0.007164150943396227,20.79245283018868
3105,53486,-3536,32,23,55,58.18,0.013254545454545456,23.545454545454547
3114,4299,18151,25,11,36,69.44,0.039080555555555556,43.361111111111114
3115,3746,-1806,21,21,42,50.0,0.0013571428571428575,42.73809523809524
3118,5173,7827,15,11,26,57.69,0.014303846153846157,99.96153846153847
3122,4530,30260,21,12,33,63.64,0.024624242424242427,27.636363636363637
3128,3793,5047,25,18,43,58.14,0.009353488372093025,35.23255813953488
3131,67482,-16182,29,23,52,55.77,0.010449999999999996,23.78846153846154
3141,13264,-22864,23,18,41,56.1,0.004904878048780485,22.902439024390244
3147,4965,-2435,13,15,28,46.43,0.0010428571428571386,44.357142857142854
3152,72173,58227,26,22,48,54.17,0.004308333333333331,29.5625
3162,5072,9098,26,19,45,57.78,0.014884444444444447,31.0
3163,14186,-31536,24,24,48,50.0,-0.009445833333333334,26.770833333333332
3169,13184,-9834,24,20,44,54.55,-0.001986363636363638,33.15909090909091
3171,2984,-4184,14,14,28,50.0,-0.001442857142857143,77.96428571428571
3176,29762,18138,26,23,49,53.06,0.008461224489795917,24.755102040816325
3178,8196,-3496,20,21,41,48.78,0.01011951219512195,27.682926829268293
3188,3285,-935,19,18,37,51.35,0.007027027027027027,49.83783783783784
3191,5198,24972,27,19,46,58.7,0.03401086956521739,27.41304347826087
3202,4420,-3490,27,24,51,52.94,0.0050078431372549016,24.11764705882353
3205,24920,-136570,22,31,53,41.51,0.00099622641509434,25.39622641509434
3206,5539,10461,23,15,38,60.53,0.01863421052631578,50.026315789473685
3207,3692,9018,23,23,46,50.0,0.02040869565217391,37.32608695652174
3211,12765,-22115,17,14,31,54.84,-0.0017161290322580652,68.03225806451613
3213,8433,-30333,15,18,33,45.45,-0.015451515151515152,64.3030303030303
3217,13522,-10882,26,18,44,59.09,0.012222727272727276,37.13636363636363
3218,22288,48412,26,13,39,66.67,0.030346153846153853,38.333333333333336
3219,10550,-20240,17,33,50,34.0,-0.012865999999999994,20.82
3221,6058,14232,29,17,46,63.04,0.02278913043478261,27.608695652173914
3224,11349,-23039,24,25,49,48.98,0.00553877551020408,33.95918367346939
3226,9236,-15036,14,15,29,48.28,0.003344827586206893,81.48275862068965
3227,29334,52266,27,20,47,57.45,0.015621276595744677,33.170212765957444
3228,23599,-9849,25,22,47,53.19,0.014110638297872336,23.95744680851064
3230,2667,1103,25,16,41,60.98,0.014319512195121956,35.1219512195122
3232,7728,-19528,24,28,52,46.15,-0.0007807692307692302,22.365384615384617
3234,11739,-7989,30,21,51,58.82,0.007300000000000002,24.862745098039216
3236,6833,21267,30,21,51,58.82,0.01586862745098039,26.333333333333332
3252,4494,8056,19,16,35,54.29,0.032588571428571425,52.4
3259,7470,27330,29,16,45,64.44,0.029322222222222225,22.57777777777778
3260,16145,65005,28,18,46,60.87,0.027432608695652175,31.58695652173913
3264,7332,7918,24,16,40,60.0,0.015214999999999998,43.475
3265,7660,12340,26,17,43,60.47,0.016251162790697674,36.18604651162791
3268,4655,-605,20,25,45,44.44,0.004971111111111105,30.533333333333335
3272,11188,-18188,17,18,35,48.57,-0.003997142857142862,31.114285714285714
3276,3516,-16256,18,26,44,40.91,-0.018593181818181825,38.68181818181818
3284,3068,2832,20,16,36,55.56,0.012450000000000003,57.94444444444444
3285,6205,5845,25,22,47,53.19,0.005244680851063828,30.51063829787234
3287,3844,3906,27,22,49,55.1,0.006997959183673464,28.959183673469386
3288,3590,-1760,20,28,48,41.67,0.00949375,17.3125
3289,17936,21514,26,19,45,57.78,0.011657777777777774,33.8
3290,4419,-7569,22,20,42,52.38,-0.0029809523809523806,40.0
3293,90747,16053,28,24,52,53.85,0.004184615384615382,23.365384615384617
3294,5397,-4447,27,25,52,51.92,0.0019211538461538454,29.03846153846154
3297,5629,-13589,21,23,44,47.73,0.0024795454545454535,42.52272727272727
3303,4668,-2918,20,18,38,52.63,0.0019184210526315794,51.921052631578945
3306,6064,36586,25,15,40,62.5,0.034675,38.925
3310,6104,13956,23,17,40,57.5,0.024524999999999998,43.4
3313,4133,26307,27,15,42,64.29,0.04130952380952381,32.26190476190476
3317,9703,6597,33,17,50,66.0,0.024908,21.32
3322,3541,2159,23,23,46,50.0,0.014136956521739128,27.456521739130434
3323,6507,12993,22,15,37,59.46,0.013567567567567574,54.7027027027027
3324,25490,15310,27,22,49,55.1,7.346938775510386e-05,20.06122448979592
3325,4606,-8956,23,19,42,54.76,0.0028119047619047607,31.11904761904762
3332,3503,-1853,8,7,15,53.33,0.0035466666666666676,201.33333333333334
3339,4015,-9725,26,32,58,44.83,-0.016743103448275867,19.275862068965516
3354,3979,15151,28,16,44,63.64,0.03885909090909091,33.13636363636363
3360,4947,-26607,21,28,49,42.86,-0.02240204081632653,32.40816326530612
3362,12596,-57596,21,29,50,42.0,-0.014066,23.18
3363,8676,-6426,27,23,50,54.0,0.001967999999999999,27.36
3372,3148,-2098,21,23,44,47.73,-0.005538636363636363,36.81818181818182
3373,10066,-52316,21,24,45,46.67,-0.008742222222222222,35.44444444444444
3374,20286,-17236,23,18,41,56.1,0.011931707317073175,18.926829268292682
3379,5248,362,29,17,46,63.04,0.02453260869565218,28.108695652173914
3388,6311,20889,9,6,15,60.0,0.025766666666666663,196.13333333333333
3390,5320,3680,24,15,39,61.54,0.019412820512820516,40.43589743589744
3402,4586,8214,20,13,33,60.61,0.01591515151515151,65.87878787878788
3426,4693,-7343,8,7,15,53.33,0.005306666666666663,92.06666666666666
3434,3520,7280,25,15,40,62.5,0.02102,46.275
3438,10178,-23878,25,25,50,50.0,-0.005006,29.1
3441,8870,-5570,28,26,54,51.85,0.008355555555555554,20.11111111111111
3444,6623,4227,22,18,40,55.0,0.011189999999999997,46.525
3455,12905,-11055,28,22,50,56.0,0.004921999999999995,30.04
3465,9212,98368,27,16,43,62.79,0.040855813953488376,29.88372093023256
3466,4853,-21403,15,25,40,37.5,-0.013902499999999998,46.825
3479,10472,-7572,18,15,33,54.55,0.004915151515151517,62.21212121212121
3483,12377,-43127,24,26,50,48.0,-0.019173999999999997,27.22
3484,10944,-46194,20,23,43,46.51,-0.01425813953488372,39.325581395348834
3489,2711,-221,19,14,33,57.58,0.010263636363636365,62.93939393939394
3490,11790,6160,27,22,49,55.1,0.009857142857142861,28.46938775510204
3491,20969,44781,26,19,45,57.78,0.010628888888888887,36.28888888888889
3492,5480,-9880,19,18,37,51.35,0.00020810810810810665,31.16216216216216
3498,15020,-3720,26,22,48,54.17,0.007722916666666667,27.041666666666668
3499,4069,5651,26,19,45,57.78,0.018406666666666665,30.57777777777778
3508,10152,-31102,28,27,55,50.91,-0.004347272727272728,20.09090909090909
3511,8711,-10411,30,26,56,53.57,-0.00436785714285714,21.803571428571427
3512,6775,-3995,23,16,39,58.97,0.012905128205128213,42.69230769230769
3516,2879,5011,21,16,37,56.76,0.014827027027027026,47.810810810810814
3520,13822,-6512,22,29,51,43.14,-0.010429411764705885,19.764705882352942
3521,4306,-14366,23,25,48,47.92,-0.007262499999999998,33.6875
3522,5546,-10766,23,24,47,48.94,0.002602127659574472,30.595744680851062
3523,4574,4186,19,29,48,39.58,-0.0013187500000000029,28.729166666666668
3526,18995,-28695,25,20,45,55.56,0.0014266666666666655,30.844444444444445
3527,28904,-58854,27,25,52,51.92,-0.0027346153846153866,31.173076923076923
3529,126883,385917,25,17,42,59.52,0.019097619047619047,32.61904761904762
3531,4582,7868,21,15,36,58.33,0.014597222222222222,60.52777777777778
3537,7443,-19743,25,20,45,55.56,-0.002795555555555553,38.977777777777774
3540,8464,-42864,26,25,51,50.98,-0.008584313725490197,27.529411764705884
3541,21544,-41194,24,19,43,55.81,-0.00033720930232558475,35.51162790697674
3546,17695,60105,30,14,44,68.18,0.032470454545454545,27.636363636363637
3548,13078,52572,27,16,43,62.79,0.02476976744186047,34.95348837209303
3551,11963,43137,28,16,44,63.64,0.026725,39.61363636363637
3552,46168,69032,35,17,52,67.31,0.032615384615384616,18.21153846153846
3555,8333,27947,24,25,49,48.98,0.020377551020408162,26.53061224489796
3556,15274,29926,23,15,38,60.53,0.01952105263157895,51.36842105263158
3558,32572,-60372,20,18,38,52.63,-0.0018710526315789458,39.44736842105263
3564,8167,3883,20,16,36,55.56,-5.277777777777467e-05,33.30555555555556
3567,4390,37820,25,8,33,75.76,0.05822121212121212,58.03030303030303
3570,17987,10613,22,16,38,57.89,0.016205263157894736,52.39473684210526
3577,8175,44025,23,12,35,65.71,0.03941428571428571,53.77142857142857
3580,8524,-7804,29,22,51,56.86,0.01381176470588235,20.764705882352942
3581,3574,15526,22,9,31,70.97,0.03354193548387097,32.806451612903224
3587,23815,35,27,22,49,55.1,0.011681632653061226,32.6530612244898
3594,6618,-14268,20,15,35,57.14,0.0013942857142857157,41.91428571428571
3597,2233,18147,14,6,20,70.0,0.04889999999999999,130.4
3609,6151,32899,27,17,44,61.36,0.039734090909090906,42.97727272727273
3611,55891,-48391,21,21,42,50.0,0.0026214285714285706,44.69047619047619
3615,7310,-11710,24,26,50,48.0,-0.009159999999999998,27.48
3623,9256,-33196,24,26,50,48.0,-0.0022379999999999995,29.1
3624,8368,11832,25,23,48,52.08,0.007131249999999999,32.020833333333336
3625,4900,14140,27,18,45,60.0,0.025604444444444447,32.62222222222222
3628,9610,1390,20,16,36,55.56,0.005691666666666668,52.861111111111114
3629,8623,32537,29,17,46,63.04,0.03899565217391305,21.391304347826086
3630,16118,-50518,24,28,52,46.15,-0.003278846153846154,23.5
3631,8556,-43606,17,27,44,38.64,-0.02172727272727273,35.68181818181818
3632,4936,-756,19,25,44,43.18,-0.011540909090909091,39.45454545454545
3642,5633,14207,25,21,46,54.35,0.016902173913043484,29.02173913043478
3646,5432,-3582,24,20,44,54.55,0.007522727272727272,32.45454545454545
3652,5543,27357,27,17,44,61.36,0.035606818181818184,35.52272727272727
3663,5679,4321,24,16,40,60.0,0.0181525,42.3
3664,5364,11136,30,23,53,56.6,0.016020754716981132,19.660377358490567
3666,6175,-8125,20,19,39,51.28,0.01038205128205128,21.615384615384617
3672,4668,-7668,16,18,34,47.06,-0.010473529411764708,30.823529411764707
3675,22076,79374,30,23,53,56.6,0.008262264150943398,28.37735849056604
3680,34742,-78342,29,26,55,52.73,-0.004703636363636365,24.636363636363637
3684,7245,12605,16,11,27,59.26,0.021914814814814814,62.44444444444444
3685,10372,-20672,21,26,47,44.68,0.004012765957446807,28.53191489361702
3687,19706,42944,26,22,48,54.17,0.014366666666666665,23.520833333333332
3689,12197,27853,25,15,40,62.5,0.025439999999999997,38.625
3691,95511,-425911,28,27,55,50.91,-0.008221818181818184,24.581818181818182
3693,17036,-71086,19,19,38,50.0,-0.0007526315789473677,22.263157894736842
3707,9286,-20096,23,23,46,50.0,0.010347826086956521,16.91304347826087
3709,2690,4060,12,7,19,63.16,0.026452631578947366,49.21052631578947
3710,1745,6975,15,11,26,57.69,0.031234615384615378,18.46153846153846
3713,2027,11873,5,4,9,55.56,0.0342,29.22222222222222
4102,5519,-17369,19,22,41,46.34,-0.013280487804878048,48.97560975609756
4105,18306,-17406,19,16,35,54.29,-0.00030571428571428346,63.371428571428574
4107,22539,-11189,23,16,39,58.97,0.009712820512820507,46.12820512820513
4109,4280,4720,20,16,36,55.56,0.010930555555555561,51.30555555555556
4111,5080,3620,18,13,31,58.06,0.010783870967741933,72.3225806451613
4113,2416,-2006,15,10,25,60.0,0.004287999999999998,91.72
4114,6954,3846,21,16,37,56.76,0.0040378378378378415,60.08108108108108
4116,4344,-5744,9,10,19,47.37,0.008478947368421051,67.6842105263158
4120,15703,-68953,19,25,44,43.18,-0.01670681818181818,45.38636363636363
4121,3842,8588,24,17,41,58.54,0.019063414634146347,38.36585365853659
4123,15268,26782,23,17,40,57.5,0.014965000000000001,40.9
4126,14792,-15492,16,16,32,50.0,-0.004078124999999998,71.90625
4127,4195,14295,26,16,42,61.9,0.02347142857142857,40.76190476190476
4128,9013,-25863,22,19,41,53.66,0.0008731707317073156,44.46341463414634
4129,9927,1223,19,15,34,55.88,0.0003647058823529414,62.411764705882355
4130,8477,-1077,20,18,38,52.63,0.0036499999999999996,45.86842105263158
4131,3834,-8554,24,28,52,46.15,-0.0005403846153846154,25.173076923076923
4138,10536,30014,17,10,27,62.96,0.020700000000000003,83.29629629629629
4139,12089,-24689,15,18,33,45.45,-0.0042181818181818214,53.303030303030305
4147,30558,-144358,14,21,35,40.0,-0.020151428571428563,24.4
4153,12423,-40473,22,22,44,50.0,-0.0076545454545454555,30.886363636363637
4154,7704,-18154,22,24,46,47.83,-0.008730434782608695,32.69565217391305
4157,5275,-33775,16,22,38,42.11,-0.02419473684210526,39.578947368421055
4160,5804,16846,18,14,32,56.25,0.019996874999999997,59.34375
4161,11761,-66861,14,21,35,40.0,-0.024322857142857146,55.885714285714286
4162,42590,17610,23,24,47,48.94,-0.0030425531914893616,26.4468085106383
4163,30787,-35487,22,19,41,53.66,-4.146341463414753e-05,38.73170731707317
4167,4209,-3309,15,14,29,51.72,0.005341379310344829,39.275862068965516
4168,12865,-77665,18,26,44,40.91,-0.02273636363636364,30.204545454545453
4171,14991,77859,19,17,36,52.78,0.03198611111111111,25.583333333333332
4173,5345,-9395,17,18,35,48.57,-0.005559999999999996,46.74285714285714
4174,51764,-203264,16,23,39,41.03,-0.01317948717948718,26.205128205128204
4175,8219,-5419,10,9,19,52.63,0.0006842105263157882,112.26315789473684
4183,1702,-8102,6,9,15,40.0,-0.018940000000000002,65.46666666666667
4188,3626,-31526,8,16,24,33.33,-0.0286875,59.0
4192,7164,-8814,16,14,30,53.33,0.010326666666666663,39.43333333333333
4198,3408,-14068,14,21,35,40.0,0.04294285714285714,24.8
4205,8972,36078,14,6,20,70.0,0.03468,138.8
4207,2569,4121,19,12,31,61.29,0.015487096774193545,74.25806451612904
4303,7768,135322,23,15,38,60.53,0.09135526315789474,52.578947368421055
4304,3734,-2404,26,31,57,45.61,0.0007157894736842036,19.210526315789473
4305,3065,8285,12,6,18,66.67,0.024000000000000007,164.16666666666666
4401,14319,-40069,19,21,40,47.5,-0.0067424999999999985,40.275
4402,2926,-126,22,25,47,46.81,0.020595744680851062,27.148936170212767
4406,2005,1825,17,12,29,58.62,0.01763793103448276,81.58620689655173
4413,3360,-6890,21,20,41,51.22,0.007587804878048781,37.707317073170735
4416,14697,67703,15,10,25,60.0,0.03560000000000001,91.92
4417,5286,-7586,15,13,28,53.57,0.004228571428571428,82.0
4419,3408,-758,22,31,53,41.51,0.0023339622641509418,16.90566037735849
4420,5564,13636,20,12,32,62.5,0.024309375,66.125
4430,5752,-17552,16,15,31,51.61,-0.011174193548387097,76.54838709677419
4432,11797,-49397,18,24,42,42.86,-0.006814285714285712,37.23809523809524
4433,5935,-8785,14,17,31,45.16,-0.0015645161290322603,43.03225806451613
4502,8612,-38932,14,24,38,36.84,-0.018434210526315786,44.921052631578945
4503,5821,4689,25,20,45,55.56,0.02608666666666667,26.711111111111112
4506,5449,38551,19,6,25,76.0,0.04902,98.56
4510,3292,788,19,16,35,54.29,0.013271428571428573,59.114285714285714
4513,2713,11467,24,11,35,68.57,0.03393714285714285,53.371428571428574
4523,4436,5714,19,13,32,59.38,0.015846874999999996,62.84375
4527,3444,-3144,13,9,22,59.09,0.005754545454545454,122.27272727272727
4528,12831,5069,25,20,45,55.56,0.008355555555555554,35.44444444444444
4529,6617,13303,25,26,51,49.02,0.0263607843137255,22.470588235294116
4530,3649,2191,28,32,60,46.67,0.03279666666666666,19.583333333333332
4533,2398,1302,18,12,30,60.0,0.010443333333333332,72.13333333333334
4534,4466,-6516,27,20,47,57.45,0.01547872340425532,25.659574468085108
4535,5407,9643,14,10,24,58.33,0.015158333333333336,104.625
4538,2171,1469,12,10,22,54.55,0.012590909090909087,128.95454545454547
4541,5487,-9037,17,14,31,54.84,0.003348387096774191,45.354838709677416
4542,4367,-12867,15,13,28,53.57,-0.010189285714285711,51.5
4543,2817,-3717,12,12,24,50.0,0.0018916666666666641,54.708333333333336
4549,13301,3699,15,10,25,60.0,0.005512,64.72
4550,2932,3418,11,12,23,47.83,0.007473913043478263,75.91304347826087
4554,4431,969,16,12,28,57.14,0.006642857142857144,25.285714285714285
4556,2719,2881,8,6,14,57.14,0.008192857142857142,111.14285714285714
4561,2966,4934,9,8,17,52.94,0.015199999999999998,43.294117647058826
4563,5214,-37084,9,10,19,47.37,-0.019600000000000003,52.36842105263158
4568,2638,-8438,4,3,7,57.14,-0.010600000000000002,135.71428571428572
4580,3232,-29232,3,3,6,50.0,-0.042333333333333334,94.83333333333333
4609,2964,13266,24,17,41,58.54,0.04103414634146342,43.19512195121951
4702,4463,-5223,25,23,48,52.08,0.0040374999999999986,32.3125
4706,2163,4637,14,7,21,66.67,0.018952380952380953,133.14285714285714
4707,2418,3072,21,13,34,61.76,0.011776470588235293,64.61764705882354
4711,3024,-15474,13,18,31,41.94,-0.020251612903225805,80.38709677419355
4712,4812,-38212,15,33,48,31.25,-0.03656041666666667,22.354166666666668
4714,3365,16155,29,12,41,70.73,0.03450243902439024,39.41463414634146
4716,3494,9706,22,14,36,61.11,0.026716666666666663,47.583333333333336
4721,17600,-23700,26,21,47,55.32,0.012408510638297869,28.48936170212766
4726,9103,-23603,18,24,42,42.86,-0.009073809523809524,28.0
4728,13032,10018,26,18,44,59.09,0.011831818181818183,32.06818181818182
4729,4263,-4653,22,26,48,45.83,0.0012104166666666635,26.1875
4735,10941,12159,26,22,48,54.17,0.0031958333333333352,31.041666666666668
4736,32336,-90936,22,20,42,52.38,-0.007823809523809521,32.88095238095238
4741,12897,-63927,16,20,36,44.44,-0.013663888888888889,53.333333333333336
4743,27658,-59208,26,24,50,52.0,-0.0004819999999999996,25.12
4744,6666,33354,23,16,39,58.97,0.039425641025641035,32.87179487179487
4745,12261,-24411,18,18,36,50.0,0.001533333333333333,48.888888888888886
4747,6129,-32229,9,13,22,40.91,-0.027231818181818187,90.81818181818181
4754,3980,-13230,6,8,14,42.86,-0.013835714285714285,100.14285714285714
4760,9270,-34060,9,15,24,37.5,-0.02632083333333333,31.291666666666668
4767,1628,10672,8,3,11,72.73,0.04167272727272728,64.45454545454545
4804,6633,-50073,10,19,29,34.48,-0.04802758620689655,24.137931034482758
4806,5901,-39971,13,24,37,35.14,-0.026951351351351356,20.62162162162162
4903,5232,-13832,24,29,53,45.28,-0.010969811320754717,22.81132075471698
4905,6690,1510,16,10,26,61.54,0.01140769230769231,88.84615384615384
4907,4595,-13555,19,23,42,45.24,0.0029285714285714275,42.285714285714285
4908,6856,-4956,27,17,44,61.36,0.006029545454545454,28.795454545454547
4909,6014,-21364,21,22,43,48.84,-0.01656279069767442,41.651162790697676
4911,14716,-76866,15,24,39,38.46,-0.01826666666666666,43.794871794871796
4924,4331,5629,21,18,39,53.85,0.02158974358974359,44.61538461538461
4931,2825,185,11,13,24,45.83,-0.010662499999999997,26.041666666666668
4933,11440,-50490,20,23,43,46.51,-0.007546511627906976,39.604651162790695
4939,5084,8386,29,20,49,59.18,0.022361224489795915,30.816326530612244
4944,6040,18860,31,23,54,57.41,0.017098148148148154,18.01851851851852
4945,3634,11166,6,3,9,66.67,0.026999999999999996,18.666666666666668
4946,12304,-19654,22,24,46,47.83,0.001369565217391302,29.41304347826087
4950,4775,-13055,20,23,43,46.51,-0.002011627906976743,42.04651162790697
4953,13979,4821,23,17,40,57.5,0.019594999999999994,29.675
4966,213610,-46610,30,29,59,50.85,-0.0027796610169491536,24.06779661016949
4971,22638,-67238,26,25,51,50.98,-0.009223529411764707,21.725490196078432
4972,4919,5331,12,13,25,48.0,0.013996,88.96
4973,5745,505,20,18,38,52.63,0.012107894736842102,46.39473684210526
4974,10196,16754,23,15,38,60.53,0.013242105263157894,52.31578947368421
4979,12900,-17500,29,28,57,50.88,-0.008685964912280703,18.842105263157894
4987,10394,-22144,14,13,27,51.85,-0.0031962962962962917,83.74074074074075
4991,15012,-44562,19,22,41,46.34,-0.010141463414634146,32.51219512195122
4995,8612,15088,23,16,39,58.97,0.02306153846153846,47.51282051282051
5009,3837,9163,19,12,31,61.29,0.020880645161290325,68.96774193548387
5011,6289,-12839,21,21,42,50.0,-0.0034000000000000037,45.095238095238095
5013,3947,32103,21,6,27,77.78,0.054122222222222224,85.4074074074074
5014,3674,3586,27,17,44,61.36,0.02201363636363636,35.68181818181818
5015,4958,11392,18,12,30,60.0,0.027036666666666674,73.2
5016,3987,20213,13,10,23,56.52,0.03271739130434783,116.26086956521739
5102,1769,10231,12,6,18,66.67,0.033688888888888886,161.94444444444446
5201,4691,23399,26,11,37,70.27,0.0456,47.108108108108105
5202,4553,16327,31,14,45,68.89,0.027906666666666673,26.68888888888889
5205,3758,-10348,23,24,47,48.94,0.003625531914893616,20.127659574468087
5206,2552,3628,16,14,30,53.33,0.01535333333333333,75.06666666666666
5209,6036,19864,12,7,19,63.16,0.02298421052631579,139.3684210526316
5210,2206,5184,19,12,31,61.29,0.02715483870967743,67.61290322580645
5211,6644,-3194,25,24,49,51.02,0.0063265306122448975,32.95918367346939
5212,6994,39206,24,17,41,58.54,0.030473170731707314,47.58536585365854
5213,3504,10546,19,12,31,61.29,0.022348387096774194,62.67741935483871
5220,4034,-5234,11,12,23,47.83,-0.004191304347826087,51.608695652173914
5223,5608,6392,11,7,18,61.11,0.028283333333333327,29.166666666666668
5227,8260,-30340,20,25,45,44.44,-0.0020511111111111142,22.866666666666667
5230,11335,-24185,19,24,43,44.19,-0.011876744186046508,41.97674418604651
5245,15033,-66283,18,21,39,46.15,-0.02734358974358975,23.28205128205128
5251,8022,-21572,22,19,41,53.66,-0.0027536585365853634,42.36585365853659
5263,53545,-152145,19,23,42,45.24,-0.010297619047619047,32.23809523809524
5272,10997,-11447,25,22,47,53.19,0.004712765957446809,23.29787234042553
5274,268266,479234,28,22,50,56.0,0.007551999999999998,20.34
5276,2801,-7741,13,14,27,48.15,-0.0035148148148148183,61.81481481481482
5278,26986,2714,24,21,45,53.33,0.001713333333333334,27.133333333333333
5281,5830,-13680,15,13,28,53.57,0.005503571428571429,36.75
5287,50074,-196574,15,17,32,46.88,-0.014174999999999998,53.46875
5289,25067,12133,20,15,35,57.14,0.012065714285714289,41.82857142857143
5291,4275,21525,21,12,33,63.64,0.03268484848484848,32.03030303030303
5299,19386,64334,20,19,39,51.28,0.046566666666666666,42.76923076923077
5301,6548,-47568,18,27,45,40.0,-0.017171111111111116,28.288888888888888
5302,2964,8926,27,19,46,58.7,0.030330434782608696,29.934782608695652
5306,27558,-24958,20,15,35,57.14,-0.0020742857142857112,55.114285714285714
5309,5772,-242,27,24,51,52.94,0.008678431372549021,25.03921568627451
5310,7494,2526,22,22,44,50.0,0.01443181818181818,34.65909090909091
5312,10085,16015,13,9,22,59.09,0.013272727272727271,124.72727272727273
5314,3201,-2201,28,26,54,51.85,-0.004033333333333332,23.88888888888889
5315,4266,4184,29,15,44,65.91,0.028647727272727276,31.454545454545453
5321,11539,-30449,20,38,58,34.48,0.004424137931034481,19.93103448275862
5324,3481,-14771,15,17,32,46.88,-0.012206250000000004,69.0
5328,2912,728,22,20,42,52.38,0.01859761904761905,34.57142857142857
5340,5177,-3937,24,19,43,55.81,0.008488372093023258,31.488372093023255
5344,3445,1475,21,24,45,46.67,0.010097777777777778,32.111111111111114
5345,2762,-12812,15,30,45,33.33,-0.033460000000000004,35.06666666666667
5347,19602,24948,30,19,49,61.22,0.017197959183673468,35.48979591836735
5348,3115,-3755,20,27,47,42.55,0.0011659574468085093,34.234042553191486
5351,6144,10946,28,21,49,57.14,0.019622448979591835,28.6734693877551
5353,2885,8085,21,12,33,63.64,0.024251515151515152,68.87878787878788
5355,2433,-3553,21,17,38,55.26,0.00274473684210526,43.6578947368421
5356,7636,22164,20,13,33,60.61,0.020948484848484848,63.0
5364,5737,-18907,18,20,38,47.37,-0.004192105263157897,47.13157894736842
5371,9170,12930,22,16,38,57.89,0.02027105263157895,48.0
5381,2575,-4985,23,27,50,46.0,-0.008983999999999997,25.66
5383,4451,12609,26,20,46,56.52,0.018123913043478258,32.06521739130435
5386,11085,-74185,23,30,53,43.4,-0.010856603773584907,22.60377358490566
5392,10465,-18365,23,16,39,58.97,-0.0024717948717948705,46.51282051282051
5398,6188,-24488,16,24,40,40.0,-0.007635,42.95
5403,4801,42349,16,5,21,76.19,0.05730952380952381,119.38095238095238
5410,2239,6161,14,8,23,60.87,0.02268260869565218,106.6086956521739
5425,13934,13616,32,20,52,61.54,0.007457692307692308,23.807692307692307
5426,2142,11128,19,7,26,73.08,0.03761923076923077,84.53846153846153
5432,5553,35447,27,15,42,64.29,0.04618809523809524,39.714285714285715
5438,2609,-4459,15,16,31,48.39,-0.004283870967741936,67.38709677419355
5439,7939,-4989,20,18,38,52.63,0.0044236842105263175,46.31578947368421
5443,5697,-607,26,18,44,59.09,0.009263636363636361,33.88636363636363
5450,4312,-172,24,24,48,50.0,0.008668749999999998,32.583333333333336
5452,3199,-11269,18,21,39,46.15,-0.013184615384615381,46.30769230769231
5455,4413,-9283,25,33,58,43.1,-0.01445862068965517,18.982758620689655
5457,15505,15535,30,24,54,55.56,0.033609259259259255,23.72222222222222
5460,1846,-3896,12,11,23,52.17,-0.00548695652173913,118.17391304347827
5464,3665,11435,20,13,33,60.61,0.024057575757575764,56.57575757575758
5465,3515,-3825,20,17,37,54.05,0.00668108108108108,45.08108108108108
5468,4573,-9043,26,38,64,40.62,-0.0215453125,15.703125
5474,24533,-202403,20,31,51,39.22,-0.023401960784313725,23.313725490196077
5475,3168,-17788,19,27,46,41.3,-0.012045652173913039,24.76086956521739
5478,19667,50783,27,16,43,62.79,0.021320930232558138,30.325581395348838
5481,3900,-8890,20,20,40,50.0,-0.0055375,46.075
5483,20687,63963,28,18,46,60.87,0.018139130434782606,26.391304347826086
5487,5514,8236,21,13,34,61.76,0.015952941176470586,58.0
5488,2550,510,22,19,41,53.66,0.005680487804878046,43.48780487804878
5489,7885,-16185,14,14,28,50.0,-0.0028107142857142853,87.60714285714286
5490,10436,2514,23,19,42,54.76,0.004433333333333335,37.833333333333336
5493,5663,15387,17,12,29,58.62,0.01792068965517242,79.6896551724138
5498,2874,4406,22,17,39,56.41,0.017912820512820515,40.94871794871795
5508,8174,3726,17,12,29,58.62,0.015148275862068962,82.17241379310344
5511,3153,2897,13,7,20,65.0,0.010325,131.9
5512,1862,608,14,11,25,56.0,0.009996,105.04
5514,3450,-6340,16,16,32,50.0,0.00391875,76.125
5516,3249,-249,19,22,41,46.34,0.0009975609756097546,49.78048780487805
5520,4483,21817,13,8,21,61.9,0.03292857142857143,137.0
5523,3346,10304,24,14,38,63.16,0.03129736842105263,39.8421052631579
5529,5143,-41333,24,28,52,46.15,-0.00042500000000000285,23.692307692307693
5530,8891,-36791,9,13,22,40.91,-0.021304545454545454,125.5
5536,28098,33402,17,16,33,51.52,0.013245454545454543,72.12121212121212
5543,4362,9138,10,9,19,52.63,0.013747368421052628,70.21052631578948
5601,3778,19072,16,7,23,69.57,0.0329,115.91304347826087
5603,3108,3802,17,13,30,56.67,0.012993333333333332,70.16666666666667
5604,5583,21467,12,8,20,60.0,0.02956499999999999,135.8
5609,8004,-4154,17,15,32,53.12,0.011228125,70.15625
5701,1973,-4113,19,21,40,47.5,-0.024857499999999998,44.525
5703,3030,3720,11,11,22,50.0,0.01132727272727273,123.63636363636364
5704,5126,11174,16,14,30,53.33,0.015803333333333336,78.4
5820,1212,38,9,9,18,50.0,0.006305555555555554,161.33333333333334
5864,2155,-3875,16,13,29,55.17,0.011813793103448277,70.82758620689656
5878,2787,-9537,5,5,10,50.0,-0.010899999999999998,234.2
5902,3642,10008,21,17,38,55.26,0.02488421052631579,51.21052631578947
5903,22065,36435,10,8,18,55.56,0.018261111111111117,154.77777777777777
5904,69182,3918,22,14,36,61.11,0.019772222222222222,48.30555555555556
5905,2743,-693,21,16,37,56.76,0.0028081081081081085,54.027027027027025
6015,2733,-4903,19,19,38,50.0,0.004471052631578946,47.81578947368421
6016,2314,-4944,18,16,34,52.94,0.003535294117647059,60.970588235294116
6020,2210,8540,13,9,22,59.09,0.03724090909090909,120.9090909090909
6021,3155,-115,20,19,39,51.28,0.0030333333333333345,53.743589743589745
6023,3902,3048,9,6,15,60.0,0.013806666666666663,192.06666666666666
6026,1750,490,13,9,22,59.09,0.012522727272727269,56.0
6101,8025,5765,25,25,50,50.0,0.007045999999999999,25.6
6103,3662,-4382,27,30,57,47.37,0.010347368421052635,17.280701754385966
6104,17823,34177,29,22,51,56.86,0.01562549019607843,25.45098039215686
6109,2820,3640,19,18,37,51.35,0.014783783783783784,49.37837837837838
6111,23732,166758,31,18,49,63.27,0.03785918367346938,26.653061224489797
6113,3494,-9884,21,29,50,42.0,-0.013527999999999998,30.96
6114,9705,-28165,24,18,42,57.14,0.03299047619047618,30.142857142857142
6118,3441,4569,28,15,43,65.12,0.022697674418604652,34.44186046511628
6121,46016,-100616,18,21,39,46.15,-0.0007615384615384613,52.205128205128204
6122,2440,2070,20,13,33,60.61,0.00851818181818182,65.45454545454545
6123,8143,16507,21,16,37,56.76,0.022162162162162165,53.945945945945944
6124,7192,13908,26,20,46,56.52,0.014043478260869565,32.108695652173914
6125,4633,3547,29,19,48,60.42,0.013018749999999997,33.291666666666664
6126,4824,5796,28,20,48,58.33,0.015241666666666667,32.8125
6127,4873,24607,30,19,49,61.22,0.04024897959183673,25.040816326530614
6129,4385,-105,29,20,49,59.18,0.01092244897959184,27.775510204081634
6130,10960,-13260,22,22,44,50.0,0.006002272727272726,28.568181818181817
6134,3474,7846,23,21,44,52.27,0.02184318181818182,29.75
6138,18516,18134,34,15,49,69.39,0.04756734693877552,28.346938775510203
6140,3557,2783,23,19,42,54.76,0.010945238095238098,38.61904761904762
6143,16307,-55407,27,25,52,51.92,-0.011648076923076926,28.28846153846154
6144,3613,-9263,19,29,48,39.58,-0.014087500000000001,33.479166666666664
6146,36920,24880,22,14,36,61.11,0.015149999999999997,57.611111111111114
6147,16102,21398,27,18,45,60.0,0.015577777777777777,38.733333333333334
6148,2952,9098,29,13,42,69.05,0.03247380952380953,31.80952380952381
6150,18845,-37875,28,27,55,50.91,0.006927272727272726,17.836363636363636
6151,4197,403,17,13,30,56.67,0.005313333333333332,73.76666666666667
6154,1625,-6875,5,10,15,33.33,-0.016346666666666662,208.2
6156,4749,13401,29,21,50,58.0,0.029804,27.22
6158,7263,14607,31,20,51,60.78,0.016611764705882357,29.705882352941178
6160,5085,17065,23,17,40,57.5,0.0286775,35.85
6161,4580,-6660,24,23,47,51.06,-0.010846808510638298,34.361702127659576
6163,3914,-7404,22,19,41,53.66,-0.003519512195121951,44.90243902439025
6167,2775,5375,29,19,48,60.42,0.018516666666666667,27.0625
6169,7660,28690,25,24,49,51.02,0.028191836734693877,24.142857142857142
6170,4820,-2690,26,22,48,54.17,0.015087499999999998,33.020833333333336
6171,4259,-2759,21,22,43,48.84,-0.005904651162790698,47.0
6173,10327,17993,28,21,49,57.14,0.018208163265306117,28.163265306122447
6174,3939,17881,26,12,38,68.42,0.03708421052631579,49.60526315789474
6175,6708,8142,26,22,48,54.17,0.011879166666666668,30.083333333333332
6179,6774,14996,21,17,38,55.26,0.01827894736842105,49.28947368421053
6180,13715,-64865,21,25,46,45.65,-0.013404347826086958,38.15217391304348
6182,9136,-17826,25,24,49,51.02,0.0009040816326530628,27.591836734693878
6185,5114,-16064,21,20,41,51.22,-0.011829268292682927,45.170731707317074
6186,4901,16099,19,13,32,59.38,0.027128125000000003,66.65625
6187,18464,-3264,28,22,50,56.0,0.009212000000000001,24.88
6188,8320,15430,25,17,42,59.52,0.015685714285714285,35.42857142857143
6190,4085,-6265,23,21,44,52.27,-0.006599999999999998,41.02272727272727
6194,2938,-6738,11,11,22,50.0,-0.0013772727272727296,114.86363636363636
6195,11296,-34246,16,18,34,47.06,-0.007841176470588233,64.41176470588235
6198,4939,-199,17,25,42,40.48,0.0227452380952381,38.142857142857146
6199,4669,5291,26,20,46,56.52,0.02138695652173913,35.45652173913044
6203,10648,38552,23,13,36,63.89,0.029555555555555557,49.361111111111114
6204,6684,-30784,15,13,28,53.57,0.013650000000000004,81.89285714285714
6207,6937,-2637,22,22,44,50.0,0.0023863636363636353,37.15909090909091
6208,5701,25569,25,13,38,65.79,0.02834736842105263,47.68421052631579
6210,7668,25832,19,10,29,65.52,0.029910344827586206,78.6896551724138
6212,5297,4553,15,12,27,55.56,0.021381481481481477,89.4074074074074
6217,11823,25727,32,20,52,61.54,0.012296153846153849,28.403846153846153
6218,3599,8101,17,13,30,56.67,0.017333333333333333,84.8
6219,3698,10852,24,14,38,63.16,0.02306578947368421,49.76315789473684
6220,7941,33259,32,17,49,65.31,0.026712244897959186,28.93877551020408
6221,6664,32836,24,8,32,75.0,0.042021875,66.65625
6222,3105,5795,22,22,44,50.0,0.016220454545454552,26.75
6223,25071,65479,32,19,51,62.75,0.023949019607843142,22.705882352941178
6227,5202,6548,24,15,39,61.54,0.015079487179487181,42.743589743589745
6228,3676,17974,26,21,47,55.32,0.048548936170212754,25.872340425531913
6229,5264,19736,28,18,46,60.87,0.03262826086956521,36.04347826086956
6231,17625,-1325,31,21,52,59.62,0.01676730769230769,24.096153846153847
6233,5467,19713,26,24,50,52.0,0.02544,27.6
6234,5234,-16584,22,19,41,53.66,-0.003690243902439028,46.09756097560975
6236,5678,2802,17,22,39,43.59,0.015451282051282048,27.897435897435898
6237,9371,-12371,24,21,45,53.33,0.009257777777777781,31.57777777777778
6240,5289,-18279,19,20,39,48.72,0.027558974358974357,30.641025641025642
6241,5230,18160,24,20,44,54.55,0.02425454545454546,37.06818181818182
6242,6816,-4306,14,19,33,42.42,-0.014748484848484848,55.54545454545455
6244,8913,-19983,25,28,53,47.17,-0.004456603773584909,25.30188679245283
6245,12570,22480,27,17,44,61.36,0.014297727272727273,38.36363636363637
6246,4576,-18286,21,39,60,35.0,-0.028876666666666665,17.566666666666666
6247,2210,4230,16,13,29,55.17,0.01822413793103449,79.34482758620689
6248,4936,-3486,20,25,45,44.44,-0.008984444444444442,32.22222222222222
6259,4199,-3689,23,34,57,40.35,-0.012740350877192986,17.42105263157895
6261,10994,-41844,13,18,31,41.94,-0.01653225806451613,72.2258064516129
6263,7291,33109,18,7,25,72.0,0.029967999999999998,95.04
6264,2513,1547,20,17,37,54.05,0.008594594594594598,52.486486486486484
6265,2400,6870,24,13,37,64.86,0.031224324324324326,43.351351351351354
6266,3449,5151,19,14,33,57.58,0.02353939393939394,65.39393939393939
6270,2739,13731,18,12,30,60.0,0.02925333333333334,79.03333333333333
6274,21454,-66254,27,25,52,51.92,-0.008386538461538464,30.96153846153846
6275,4369,10731,21,17,39,53.85,0.020058974358974357,41.12820512820513
6276,5512,-14352,22,24,46,47.83,0.00406086956521739,26.891304347826086
6279,28463,-23913,26,18,44,59.09,0.005863636363636363,35.95454545454545
6284,10829,24221,31,19,50,62.0,0.023172,27.6
6287,3281,2799,29,31,60,48.33,0.027303333333333332,13.466666666666667
6290,11285,-21385,23,24,47,48.94,-0.009885106382978723,30.170212765957448
6291,4877,713,24,42,66,36.36,-0.025884848484848486,10.863636363636363
6292,4955,49195,18,7,25,72.0,0.062752,101.84
6294,20413,-119463,16,22,38,42.11,-0.02394473684210527,54.026315789473685
6404,7168,-32258,27,22,49,55.1,0.0023979591836734686,19.448979591836736
6411,22579,-46629,22,21,43,51.16,-0.00335813953488372,24.674418604651162
6417,5702,7548,12,8,20,60.0,0.009355000000000002,70.8
6418,3181,-20811,10,20,30,33.33,-0.03181666666666667,48.7
6419,4291,-22961,12,24,36,33.33,0.0017722222222222297,32.44444444444444
6425,6999,-9389,15,16,31,48.39,0.0006516129032258081,35.064516129032256
6426,18822,-34872,20,19,39,51.28,-0.0004435897435897429,21.58974358974359
6432,5410,45940,22,8,30,73.33,0.05472999999999998,34.733333333333334
6435,19736,-5486,18,15,33,54.55,0.007724242424242422,27.242424242424242
6441,16514,-60094,17,23,40,42.5,-0.009975000000000005,27.5
6446,23810,20390,13,12,25,52.0,0.0065200000000000015,40.24
6457,12619,-78269,15,15,30,50.0,-0.0028033333333333356,35.06666666666667
6461,4667,6333,15,13,28,53.57,0.010967857142857144,33.07142857142857
6462,36298,44702,19,15,34,55.88,0.008567647058823529,20.735294117647058
6465,7187,-42087,9,16,25,36.0,-0.022455999999999997,45.96
6469,18715,184485,15,9,24,62.5,0.0393625,44.291666666666664
6470,8850,-16650,18,14,32,56.25,-0.0058875,32.375
6472,29201,62649,20,11,31,64.52,0.028803225806451605,18.677419354838708
6482,4640,17760,11,9,20,55.0,0.032105,53.75
6485,12328,-53578,15,16,31,48.39,-0.00838709677419355,27.258064516129032
6486,8333,24817,14,9,23,60.87,0.021900000000000006,39.43478260869565
6488,88643,468157,27,10,37,72.97,0.04372972972972973,22.486486486486488
6492,19685,-191685,10,19,29,34.48,-0.03441379310344828,25.82758620689655
6494,9432,23318,15,7,22,68.18,0.03485454545454546,34.90909090909091
6496,6618,-15968,10,11,21,47.62,-0.011090476190476189,65.04761904761905
6499,13333,-56883,11,16,27,40.74,-0.011818518518518522,33.81481481481482
6506,3315,3035,17,13,30,56.67,0.011573333333333333,74.93333333333334
6508,3303,31397,13,5,18,72.22,0.06161666666666667,146.72222222222223
6509,6727,-15977,26,19,45,57.78,0.0004222222222222257,39.62222222222222
6510,153010,187490,18,14,32,56.25,0.010187499999999995,18.8125
6512,2857,-11857,10,13,23,43.48,-0.016152173913043476,56.78260869565217
6514,8488,49312,17,12,29,58.62,0.035979310344827584,31.620689655172413
6516,20442,-223222,10,13,23,43.48,-0.026056521739130433,68.69565217391305
6523,21013,87,19,13,32,59.38,0.017778125,22.65625
6527,4006,-2876,7,7,14,50.0,0.0028499999999999992,67.07142857142857
6530,2465,7095,14,9,23,60.87,0.020417391304347828,60.0
6532,5894,5256,17,8,25,68.0,0.022724,31.76
6535,5522,-25272,11,15,26,42.31,-0.020992307692307692,36.26923076923077
6538,15834,98166,11,10,21,52.38,0.03212380952380952,35.904761904761905
6542,10141,309,13,13,26,50.0,0.013634615384615387,24.76923076923077
6547,15661,9489,13,14,27,48.15,0.009474074074074076,32.55555555555556
6548,24342,224058,17,6,23,73.91,0.05303913043478261,38.82608695652174
6556,4769,23831,11,7,18,61.11,0.03404444444444445,78.55555555555556
6560,7434,-25884,10,11,21,47.62,-0.006519047619047616,18.952380952380953
6561,21971,25029,9,6,15,60.0,0.007166666666666667,53.4
6568,32117,14383,18,12,30,60.0,0.01591,21.3
6569,16644,-37644,9,9,18,50.0,-0.016616666666666672,65.61111111111111
6570,4221,5729,12,9,21,57.14,0.0131,53.0
6574,6371,-32871,4,7,11,36.36,-0.020163636363636363,120.9090909090909
6576,13346,38684,16,11,27,59.26,0.016477777777777772,39.592592592592595
6577,5701,3699,9,6,15,60.0,0.008053333333333332,73.53333333333333
6578,2648,-23858,6,13,19,31.58,-0.04262105263157895,55.578947368421055
6588,3590,-2840,4,5,9,44.44,-0.01947777777777778,29.333333333333332
6589,8948,-98868,7,14,21,33.33,-0.05191904761904762,55.333333333333336
6590,3506,17754,10,5,15,66.67,0.03954666666666667,99.4
6593,2939,20811,9,7,16,56.25,0.052931250000000006,70.9375
6594,4517,-20017,11,12,23,47.83,-0.01868695652173913,32.69565217391305
6596,5418,-5738,8,8,16,50.0,0.0035874999999999987,65.5625
6603,3184,6816,23,15,38,60.53,0.02062368421052631,47.578947368421055
6609,7659,-5809,22,16,38,57.89,0.011321052631578949,49.3421052631579
6612,7060,-17240,9,9,18,50.0,-0.013083333333333334,33.333333333333336
6613,14029,27471,8,7,15,53.33,0.015073333333333334,65.6
6615,8043,-18853,9,9,18,50.0,-0.0019111111111111065,46.55555555555556
6616,2599,22861,13,6,19,68.42,0.04062105263157895,30.05263157894737
6624,2418,3232,5,5,10,50.0,0.01353,142.1
6629,3846,22504,7,4,11,63.64,0.03777272727272728,45.54545454545455
6640,6233,12267,9,6,15,60.0,0.03236000000000001,42.6
6642,2970,26580,7,2,9,77.78,0.05293333333333334,55.22222222222222
6643,35927,53073,10,8,18,55.56,0.016505555555555558,20.72222222222222
6649,2303,14647,7,6,13,53.85,0.046076923076923085,37.69230769230769
6651,4592,-43792,2,5,7,28.57,-0.043742857142857146,28.285714285714285
6654,5196,39354,11,3,14,78.57,0.05206428571428571,31.214285714285715
6661,545,-8345,0,4,4,0.0,-0.082625,95.75
6662,1717,-3867,3,5,8,37.5,0.0008499999999999966,94.125
6664,4252,17598,7,4,11,63.64,0.029536363636363635,72.27272727272727
6667,6409,32541,10,7,17,58.82,0.03467058823529411,36.411764705882355
6679,33125,99375,13,9,22,59.09,0.023559090909090908,14.409090909090908
6680,3750,450,5,6,11,45.45,0.0004545454545454562,48.18181818181818
6683,29250,109750,12,7,19,63.16,0.030836842105263152,12.210526315789474
6690,6645,16855,5,4,9,55.56,0.02076666666666667,35.111111111111114
6697,1430,-3280,3,3,6,50.0,-0.009866666666666664,92.66666666666667
6703,3521,4979,3,3,6,50.0,0.009616666666666664,67.5
6712,8569,-16069,2,3,5,40.0,-0.018600000000000002,15.4
6716,7778,46922,7,4,11,63.64,0.03633636363636364,23.90909090909091
6727,2442,5558,3,3,6,50.0,0.02428333333333334,30.5
6728,4012,44788,5,2,7,71.43,0.08928571428571429,23.0
6732,47457,-447457,3,10,13,23.08,-0.05506153846153846,17.076923076923077
6733,926,2724,4,2,6,66.67,0.01951666666666667,33.333333333333336
6747,10029,-26529,3,3,6,50.0,0.0031833333333333353,22.833333333333332
6751,2432,-31482,2,5,7,28.57,-0.06665714285714286,26.857142857142858
6752,1746,1854,3,2,5,60.0,0.009780000000000002,63.2
6762,8871,89629,3,2,5,60.0,0.063,66.2
6767,917,-8467,1,4,5,20.0,-0.046799999999999994,64.2
6803,13861,147139,10,2,12,83.33,0.067075,245.0
7402,10233,10477,17,12,29,58.62,0.021989655172413795,41.310344827586206
7556,5974,2026,4,4,8,50.0,0.0066374999999999984,26.0
8024,3370,14870,26,10,36,72.22,0.034408333333333325,49.52777777777778
8027,10027,-28777,17,22,39,43.59,-0.012333333333333335,24.358974358974358
8032,3623,18027,14,7,21,66.67,0.03695238095238095,125.42857142857143
8034,4094,10526,31,20,51,60.78,0.025899999999999996,22.50980392156863
8038,13214,-112364,15,35,50,30.0,-0.035802,26.08
8040,5848,-24028,29,20,49,59.18,0.012363265306122445,26.142857142857142
8042,9066,4634,18,15,33,54.55,0.011069696969696974,65.39393939393939
8043,5865,26085,26,13,39,66.67,0.03106410256410257,46.333333333333336
8044,60869,254831,33,20,53,62.26,0.019213207547169812,24.79245283018868
8047,2335,7095,20,11,31,64.52,0.026106451612903224,73.54838709677419
8048,7566,16134,24,19,43,55.81,0.016655813953488374,34.83720930232558
8049,3580,15450,25,14,39,64.1,0.02161025641025641,46.43589743589744
8050,9898,11952,20,14,34,58.82,0.013776470588235293,65.08823529411765
8054,6702,22548,24,17,41,58.54,0.008304878048780492,38.707317073170735
8059,3738,2482,27,22,49,55.1,0.01753673469387755,27.428571428571427
8064,4579,4161,27,20,47,57.45,0.011908510638297867,30.5531914893617
8066,16101,21229,21,19,40,52.5,0.1721275,43.25
8067,3051,-3761,21,28,49,42.86,-0.00643673469387755,31.571428571428573
8068,6668,-8148,25,33,58,43.1,-0.011770689655172415,17.551724137931036
8069,12487,17513,26,26,52,50.0,-0.0042557692307692305,26.846153846153847
8071,4126,674,21,19,40,52.5,0.006249999999999997,44.825
8074,5115,-11115,20,17,37,54.05,0.0014891891891891875,52.891891891891895
8076,17818,28432,27,22,49,55.1,0.0011122448979591821,30.489795918367346
8077,5182,-22962,16,24,40,40.0,-0.021327500000000006,35.175
8080,4493,-26963,21,31,52,40.38,-0.014498076923076926,18.576923076923077
8083,20018,17582,15,10,25,60.0,0.015495999999999996,93.8
8084,9534,12126,23,18,41,56.1,0.013458536585365855,39.51219512195122
8085,2879,-5789,23,23,46,50.0,0.00011956521739130264,29.47826086956522
8086,23191,16759,31,28,59,52.54,0.004415254237288135,19.372881355932204
8087,3081,18339,22,14,36,61.11,0.032947222222222225,56.833333333333336
8088,6375,6375,25,22,47,53.19,0.006672340425531915,31.95744680851064
8089,1414,11686,5,2,7,71.43,0.03685714285714286,24.857142857142858
8091,17299,40201,24,17,41,58.54,0.015921951219512193,46.390243902439025
8092,3216,11414,27,16,43,62.79,0.03493023255813953,35.74418604651163
8093,2580,-4500,19,22,41,46.34,-0.0048000000000000004,33.65853658536585
8096,4160,-3540,24,21,45,53.33,0.0033977777777777756,39.955555555555556
8097,5376,-10956,23,36,59,38.98,-0.014383050847457626,18.8135593220339
8099,4869,-7669,17,19,36,47.22,-0.004652777777777776,54.69444444444444
8107,5500,3790,26,20,46,56.52,0.01675217391304348,35.71739130434783
8109,9164,46486,16,8,24,66.67,0.03697916666666665,96.45833333333333
8111,3649,-3489,26,23,49,53.06,0.010014285714285712,25.448979591836736
8121,7071,27999,31,18,49,63.27,0.02179591836734694,20.79591836734694
8147,7991,17909,20,15,35,57.14,0.02093714285714286,43.114285714285714
8155,20873,3977,23,24,47,48.94,-0.004421276595744682,22.914893617021278
8171,6634,20646,29,19,48,60.42,0.015610416666666668,25.166666666666668
8176,2635,-6105,19,18,37,51.35,-0.005935135135135132,38.16216216216216
8182,5449,4201,24,16,40,60.0,0.02239,45.25
8183,5477,20373,27,17,44,61.36,0.025265909090909092,33.63636363636363
8234,7061,-7511,22,19,41,53.66,0.005263414634146336,49.80487804878049
8240,6204,12346,22,17,39,56.41,0.01907948717948718,41.743589743589745
8255,28102,-86402,19,20,39,48.72,-0.004892307692307693,47.48717948717949
8277,3689,-5389,24,24,48,50.0,-0.005377083333333334,26.75
8279,16330,78870,16,7,23,69.57,0.03174782608695652,36.56521739130435
8284,4568,23232,6,10,16,37.5,0.066875,173.125
8289,3658,13052,24,13,37,64.86,0.030332432432432433,58.75675675675676
8291,2596,1414,24,22,46,52.17,0.01743695652173913,26.717391304347824
8299,72586,-87586,24,19,43,55.81,-0.003700000000000002,38.41860465116279
8342,2584,2726,5,4,9,55.56,0.00695555555555555,169.22222222222223
8349,17210,62290,24,14,38,63.16,0.025576315789473683,47.3421052631579
8354,2423,15877,16,8,24,66.67,0.041416666666666664,106.54166666666667
8358,9630,-13320,22,19,41,53.66,0.004924390243902438,43.1219512195122
8383,8446,-10246,20,19,39,51.28,0.0014461538461538477,52.35897435897436
8390,5751,-16401,21,22,43,48.84,-0.001032558139534887,42.51162790697674
8401,3016,-15216,15,20,35,42.86,-0.025437142857142856,59.22857142857143
8403,7368,-15668,18,17,35,51.43,-0.003822857142857144,61.714285714285715
8409,6033,-35583,15,22,37,40.54,-0.0023513513513513523,34.108108108108105
8410,8094,8556,27,14,41,65.85,0.017770731707317078,32.34146341463415
8415,3678,7672,11,9,20,55.0,0.023950000000000006,63.7
8416,23658,20742,19,13,32,59.38,0.013018749999999997,63.78125
8418,4382,-21632,13,26,39,33.33,-0.025238461538461536,57.717948717948715
8420,3583,20267,14,9,23,60.87,0.036460869565217394,78.69565217391305
8421,3751,-11611,18,23,41,43.9,-0.008753658536585364,46.0
8423,4768,-11068,14,21,35,40.0,-0.007425714285714283,67.77142857142857
8424,7018,23082,14,11,25,56.0,0.02215200000000001,94.96
8426,7832,-15832,19,19,38,50.0,-0.004557894736842109,50.36842105263158
8431,13653,2047,20,18,38,52.63,0.007660526315789477,19.94736842105263
8432,15924,-101774,12,26,38,31.58,-0.03741052631578947,53.078947368421055
8433,16512,-13412,22,19,41,53.66,0.006560975609756098,39.36585365853659
8435,3091,32859,8,2,10,80.0,0.06572,286.7
8436,54279,-91379,24,16,40,60.0,0.015484999999999999,27.075
8437,26088,-88588,11,14,25,44.0,-0.017107999999999998,67.56
8440,3359,7361,17,14,31,54.84,0.026996774193548387,57.38709677419355
8444,15869,-115069,9,16,25,36.0,-0.03204,51.2
8446,18983,68217,17,12,29,58.62,0.031962068965517246,56.44827586206897
8450,9220,-15770,12,14,26,46.15,-0.012376923076923079,50.23076923076923
8455,3606,-12856,11,11,22,50.0,-0.003963636363636363,48.04545454545455
8472,6600,-67400,8,18,26,30.77,-0.03622307692307692,46.19230769230769
8476,4218,-4668,11,10,21,52.38,0.01116190476190476,40.714285714285715
8477,5762,-24662,8,14,22,36.36,-0.020118181818181823,46.09090909090909
8489,23800,-100830,14,19,33,42.42,-0.013606060606060604,22.78787878787879
8905,3934,10616,18,15,33,54.55,0.019818181818181818,66.36363636363636
8906,2544,-4714,14,20,34,41.18,-0.0158,69.05882352941177
8908,4820,22180,12,7,19,63.16,0.02758421052631579,136.0
8916,8435,-4935,18,15,33,54.55,0.008772727272727274,68.6969696969697
8917,5536,44314,11,4,15,73.33,0.048646666666666664,195.73333333333332
8921,2106,-3556,11,11,22,50.0,-0.0010499999999999995,104.81818181818181
8923,1500,-2350,9,6,15,60.0,-0.006459999999999997,205.06666666666666
8924,13554,-70304,23,22,45,51.11,0.003195555555555555,37.044444444444444
8927,3215,-11055,13,14,27,48.15,-0.0052962962962962955,97.22222222222223
8928,6970,7530,25,15,40,62.5,0.021650000000000003,44.725
8929,7604,3696,23,17,40,57.5,0.011352500000000001,44.225
8930,2398,9902,18,10,28,64.29,0.03476785714285715,75.96428571428571
8931,2650,10650,13,6,19,68.42,0.03204210526315789,119.57894736842105
8932,3206,2644,21,18,39,53.85,0.01103846153846154,42.743589743589745
8933,3482,-2242,23,22,45,51.11,0.002017777777777777,36.577777777777776
8935,2862,-672,22,23,45,48.89,0.001679999999999999,34.06666666666667
8936,6886,14514,24,18,42,57.14,0.008983333333333334,38.714285714285715
8937,2963,7537,22,13,35,62.86,0.022182857142857143,57.77142857142857
8938,8954,14546,23,18,41,56.1,0.014253658536585367,43.24390243902439
8941,11474,-29064,17,25,42,40.48,-0.0103952380952381,47.61904761904762
8942,12990,1210,17,14,31,54.84,0.0068161290322580614,70.74193548387096
9949,2401,-4411,13,15,28,46.43,-0.01064642857142857,80.60714285714286
9950,3253,8077,17,13,30,56.67,0.013783333333333333,81.43333333333334
9951,29247,-21497,24,20,44,54.55,0.004677272727272728,33.93181818181818
9960,4393,8157,16,13,29,55.17,0.015141379310344828,78.34482758620689
9962,2126,8054,19,8,27,70.37,0.03484444444444444,80.33333333333333
8916A,586,-5986,0,2,2,0.0,-0.057300000000000004,537.0
4148,7501,-25801,11,9,20,55.0,0.006819999999999998,30.75
6781,23103,25897,3,1,4,75.0,0.0215,21.0
6776,766,8484,2,1,3,66.67,0.0727,81.66666666666667
2211,1686,13464,3,2,5,60.0,0.05154000000000001,31.0
6768,1696,12404,3,1,4,75.0,0.04865,69.5
3357,6400,126970,10,10,20,50.0,0.30354000000000003,132.05
6741,6561,-4561,2,3,5,40.0,-0.014139999999999996,17.2
2250,4391,-31991,2,4,6,33.33,-0.02845,18.833333333333332
5236,3988,-44988,1,4,5,20.0,-0.054959999999999995,13.8
1522A,260,590,1,0,1,100.0,0.0135,270.0
6684,3373,-15873,1,3,4,25.0,-0.035699999999999996,22.0
2753,2362,12638,2,1,3,66.67,0.0336,45.666666666666664
2348A,219,-1019,0,1,1,0.0,-0.0268,178.0
6790,508,-7758,0,2,2,0.0,-0.0804,96.5
6788,1922,3578,1,1,2,50.0,0.0249,10.0
2947,2135,7865,2,1,3,66.67,0.033499999999999995,38.666666666666664
4440,252,-4802,0,1,1,0.0,-0.103,156.0
5222,8284,6066,13,10,23,56.52,0.020173913043478264,31.17391304347826
2881C,351,-551,0,1,1,0.0,-0.0092,147.0
6761,2018,-22518,1,2,3,33.33,-0.04866666666666667,15.0
6806,1872,18828,2,1,3,66.67,0.06816666666666667,25.333333333333332
2945,651,-8651,1,1,2,50.0,-0.0679,27.5
6770,324,1176,1,0,1,100.0,0.0217,79.0
6792,1418,82,1,1,2,50.0,-0.00485,7.5
4770,1586,26414,1,0,1,100.0,0.1057,53.0
2883B,65,-985,0,1,1,0.0,-0.1048,91.0
6691,1082,-9082,0,1,1,0.0,-0.0475,79.0
3592,9781,465199,10,4,14,71.43,0.5016999999999999,189.35714285714286
6719,6615,-30615,1,1,2,50.0,-0.0114,12.0
2756,1284,-8784,1,1,2,50.0,-0.0378,8.0
5244,1843,-7633,8,10,18,44.44,0.00484444444444444,60.388888888888886
6693,526,7274,1,0,1,100.0,0.0866,14.0
8112A,242,-892,0,1,1,0.0,-0.0213,64.0
8438,2450,-36400,3,11,14,21.43,-0.0750714285714286,100.71428571428571
6829,461,539,1,0,1,100.0,0.0069,25.0
4923,1469,1251,4,5,9,44.44,0.019588888888888892,140.11111111111111
6763,3308,-22308,0,1,1,0.0,-0.0385,22.0
4558,833,28977,4,2,6,66.67,0.27668333333333334,403.3333333333333
3349,1851,-7211,7,8,15,46.67,-0.006526666666666668,67.73333333333333
6804,644,-944,1,1,2,50.0,-0.007649999999999999,1.5
4768,718,16782,1,0,1,100.0,0.1533,9.0
6807,189,2511,1,0,1,100.0,0.0826,1.0
6721,318,-718,0,1,1,0.0,-0.0132,4.0
6735,507,-2607,0,1,1,0.0,-0.0296,10.0
4583,0,0,0,0,0,0.0,,
6799,0,0,0,0,0,0.0,,
6585,1097,-11347,1,2,3,33.33,-0.056133333333333334,39.0
5228,1536,-13956,3,7,10,30.0,-0.0463,34.3
6546,1212,100488,3,4,7,42.86,0.9242142857142858,300.85714285714283
6796,0,0,0,0,0,0.0,,
6550,2381,-17571,2,5,7,28.57,-0.059271428571428565,25.857142857142858
