代號,總成本,總損益(淨),獲利次數,損失次數,總交易次數,勝率%,平均報酬,平均持倉時間(日)
1101,9173,1907,22,28,50,44.0,0.002217999999999999,19.52
1102,7084,7406,17,18,35,48.57,0.017420000000000005,30.142857142857142
1103,3623,6917,17,18,35,48.57,0.005120000000000002,31.2
1104,3255,5605,16,19,35,45.71,0.006662857142857141,25.457142857142856
1108,2395,-2955,13,22,35,37.14,-0.00908,27.82857142857143
1109,1599,6951,12,9,21,57.14,0.025285714285714293,30.047619047619047
1110,2694,-9624,11,25,36,30.56,-0.020872222222222223,36.083333333333336
1201,6469,-18629,20,31,51,39.22,-0.01240588235294118,25.529411764705884
1203,3591,-10591,12,21,33,36.36,-0.02411212121212121,34.18181818181818
1210,6628,-10378,16,21,37,43.24,-0.0073297297297297325,42.45945945945946
1213,3864,-20114,11,31,42,26.19,-0.03136428571428572,27.357142857142858
1215,3791,-1441,13,19,32,40.62,-0.0045625,27.28125
1216,6703,-21003,12,22,34,35.29,-0.0172764705882353,31.764705882352942
1217,2771,-4691,16,23,39,41.03,-0.00424102564102564,27.153846153846153
1218,3495,-585,21,21,42,50.0,0.004214285714285714,30.666666666666668
1219,3302,-2792,16,26,42,38.1,-0.015319047619047621,19.61904761904762
1220,2238,-3928,12,22,34,35.29,-0.02150294117647059,22.441176470588236
1225,4465,-5915,20,27,47,42.55,-0.0076255319148936145,34.276595744680854
1227,3021,33099,5,5,10,50.0,0.030539999999999994,60.9
1229,3233,-5883,15,19,34,44.12,-0.002279411764705883,19.735294117647058
1231,4035,-4465,11,15,26,42.31,-0.0029576923076923074,51.84615384615385
1232,3470,-14930,5,10,15,33.33,-0.01330666666666667,44.53333333333333
1233,794,-2374,2,3,5,40.0,0.006539999999999999,40.8
1234,2130,3280,11,10,21,52.38,0.01081904761904762,24.142857142857142
1235,4213,-6253,7,14,21,33.33,-0.02371428571428571,19.666666666666668
1236,1829,8271,10,6,16,62.5,0.023481249999999995,50.5
1256,24470,-117960,8,16,24,33.33,-0.0189875,23.125
1301,9370,-23240,9,11,20,45.0,-0.007085000000000001,39.85
1303,7464,-32524,7,16,23,30.43,-0.018786956521739128,17.52173913043478
1304,6538,6192,25,31,56,44.64,0.00034821428571428476,20.285714285714285
1305,6410,-10960,28,36,64,43.75,-0.0080953125,29.234375
1307,3561,-14131,8,15,23,34.78,-0.02032608695652174,22.304347826086957
1308,7144,27856,29,24,53,54.72,0.017732075471698108,20.433962264150942
1309,5110,14620,30,27,57,52.63,0.015680701754385965,31.982456140350877
1310,4878,-4128,17,28,45,37.78,-0.0033688888888888865,25.288888888888888
1312,5449,-3549,26,31,57,45.61,0.0002491228070175476,19.912280701754387
1313,4300,-3930,18,27,45,40.0,-0.007073333333333329,26.066666666666666
1314,5576,5054,30,34,64,46.88,0.008367187499999998,24.171875
1315,4681,2699,16,18,34,47.06,0.003535294117647058,26.0
1316,3386,-3106,20,25,45,44.44,-0.00011555555555555578,22.488888888888887
1319,12631,-94391,13,40,53,24.53,-0.04137735849056605,25.58490566037736
1321,4763,-17003,12,26,38,31.58,-0.02038684210526316,37.421052631578945
1323,2513,1337,10,12,22,45.45,3.636363636363678e-05,21.0
1324,2346,2294,13,13,26,50.0,0.0085,36.61538461538461
1325,9492,-3142,13,18,31,41.94,-0.0013612903225806456,38.806451612903224
1326,6828,-6108,7,11,18,38.89,-0.004994444444444445,30.555555555555557
1337,4233,-12343,8,17,25,32.0,-0.027416,16.2
1338,11181,-63921,6,16,22,27.27,-0.02881363636363636,22.727272727272727
1339,3631,-28161,3,9,12,25.0,-0.041875,25.5
1340,4648,-18098,3,12,15,20.0,-0.037373333333333335,37.4
1341,359,3741,1,0,1,100.0,0.0644,57.0
1342,928,3052,1,1,2,50.0,0.008800000000000002,41.0
1402,10096,-17486,19,36,55,34.55,-0.009743636363636371,24.727272727272727
1409,3654,4736,25,27,52,48.08,0.01253076923076923,24.75
1410,3543,-10773,16,21,37,43.24,-0.008897297297297298,33.08108108108108
1413,2818,-10798,16,34,50,32.0,-0.03178,22.02
1414,4332,-1772,32,33,65,49.23,0.0027676923076923095,18.323076923076922
1416,3621,-5861,23,30,53,43.4,-0.006373584905660375,38.094339622641506
1417,3328,-5218,23,30,53,43.4,-0.0073037735849056625,19.245283018867923
1418,3720,-4330,28,36,64,43.75,-0.008087500000000001,22.375
1419,7349,7581,21,21,42,50.0,0.011730952380952384,23.19047619047619
1423,1488,292,13,10,23,56.52,0.005926086956521735,36.869565217391305
1432,3828,-5818,20,30,50,40.0,-0.010069999999999997,23.22
1434,2713,-12723,6,13,19,31.58,-0.026278947368421054,41.578947368421055
1435,5540,-34570,26,39,65,40.0,-0.021530769230769235,25.43076923076923
1436,987,-5097,5,6,11,45.45,-0.01334545454545455,38.09090909090909
1437,5412,-9892,20,29,49,40.82,-0.005240816326530615,32.183673469387756
1438,2904,-2724,14,36,50,28.0,-0.052834000000000006,19.84
1439,4779,-7259,17,22,39,43.59,-0.005787179487179488,14.564102564102564
1440,5092,-13122,23,34,57,40.35,-0.012257894736842107,19.50877192982456
1441,3298,10482,32,23,55,58.18,0.024285454545454544,16.672727272727272
1442,2076,5494,15,11,26,57.69,0.024984615384615386,16.23076923076923
1443,2595,1845,25,23,48,52.08,0.0049916666666666686,15.270833333333334
1444,3756,-4126,27,30,57,47.37,-0.0005631578947368404,24.228070175438596
1445,2004,-1904,15,18,33,45.45,-0.0034636363636363645,26.03030303030303
1446,0,0,0,0,0,0.0,,
1447,4222,-82,28,35,63,44.44,0.0005761904761904769,15.476190476190476
1449,4075,-5555,34,39,73,46.58,-0.013121917808219176,22.328767123287673
1451,2043,-5743,5,11,16,31.25,-0.020556249999999998,19.0625
1452,2824,14446,19,15,34,55.88,0.026661764705882354,30.352941176470587
1453,3321,-1711,19,37,56,33.93,-0.020849999999999997,28.428571428571427
1454,1618,-3948,9,17,26,34.62,-0.023611538461538465,31.307692307692307
1455,4336,-8596,23,34,57,40.35,-0.007771929824561403,24.157894736842106
1456,4976,-9206,34,53,87,39.08,-0.02675057471264368,17.448275862068964
1457,2962,238,21,24,45,46.67,0.0037199999999999998,27.866666666666667
1459,2386,824,16,17,33,48.48,0.0019333333333333327,25.363636363636363
1460,3042,-8712,17,26,43,39.53,-0.021069767441860465,38.23255813953488
1463,2714,-4134,16,22,38,42.11,-0.008249999999999999,19.789473684210527
1464,2961,-2901,15,16,31,48.39,0.0014870967741935474,37.903225806451616
1465,1646,1544,10,11,21,47.62,0.0034428571428571425,45.857142857142854
1466,6782,-24402,28,45,73,38.36,-0.01673972602739726,16.575342465753426
1467,2873,-12023,11,23,34,32.35,-0.023200000000000002,37.029411764705884
1468,2330,-10450,9,21,30,30.0,-0.030166666666666668,48.63333333333333
1470,5474,-17504,22,45,67,32.84,-0.023999999999999997,16.791044776119403
1471,8088,-10628,33,46,79,41.77,-0.01440379746835443,17.556962025316455
1472,5695,6105,28,33,61,45.9,-0.001573770491803277,18.868852459016395
1473,2658,1902,6,7,13,46.15,0.013607692307692305,37.23076923076923
1474,2092,-14312,7,21,28,25.0,-0.044564285714285716,45.92857142857143
1475,6695,-9795,26,40,66,39.39,-0.005174242424242424,19.681818181818183
1476,83766,-512446,20,36,56,35.71,-0.0175625,22.142857142857142
1477,24882,81378,15,11,26,57.69,0.02305,25.0
1503,3214,-21854,5,11,16,31.25,-0.033212500000000006,47.0625
1504,3377,-967,12,20,32,37.5,-0.010478124999999998,28.96875
1506,0,0,0,0,0,0.0,,
1512,3887,1853,31,31,62,50.0,-0.006208064516129033,21.56451612903226
1513,4332,-3702,10,19,29,34.48,-0.008279310344827583,31.103448275862068
1514,4293,-2213,21,25,46,45.65,0.00526086956521739,20.043478260869566
1515,9633,3247,22,24,46,47.83,0.0005739130434782598,22.804347826086957
1516,5670,-13500,26,43,69,37.68,-0.01637971014492753,18.971014492753625
1517,5731,-12131,24,36,60,40.0,-0.01146333333333333,23.95
1519,7582,14308,25,19,44,56.82,0.012634090909090906,20.363636363636363
1521,12387,-307,17,22,39,43.59,-0.0027461538461538426,18.76923076923077
1522,5962,-1242,19,19,38,50.0,0.007034210526315789,21.57894736842105
1524,2871,2449,14,22,36,38.89,-0.009080555555555555,19.97222222222222
1525,18061,43559,24,25,49,48.98,0.009310204081632656,17.612244897959183
1526,6940,35140,30,33,63,47.62,0.01724285714285714,24.746031746031747
1527,9924,-5714,15,18,33,45.45,-0.0021090909090909107,23.484848484848484
1528,3052,-11862,15,21,36,41.67,-0.01828333333333333,33.861111111111114
1529,5446,-2726,36,45,81,44.44,-0.007980246913580248,20.432098765432098
1530,6561,-12721,10,17,27,37.04,-0.008125925925925927,26.962962962962962
1531,6148,-18568,15,28,43,34.88,-0.015616279069767439,22.069767441860463
1532,7429,23531,18,18,36,50.0,0.02056111111111111,44.25
1533,11201,8419,28,23,51,54.9,0.014592156862745098,22.352941176470587
1535,3610,-3660,6,11,17,35.29,-0.010735294117647056,55.23529411764706
1536,19195,-30245,20,30,50,40.0,-0.00923,24.8
1537,7347,-10667,9,14,23,39.13,-0.013173913043478258,32.130434782608695
1538,5882,788,19,32,51,37.25,-0.013915686274509804,17.980392156862745
1539,5807,15603,26,33,59,44.07,0.0064474576271186445,17.491525423728813
1540,2306,3164,8,11,19,42.11,0.004426315789473684,30.263157894736842
1541,7993,-9783,21,33,54,38.89,-0.006612962962962966,26.59259259259259
1558,10688,-19958,8,10,18,44.44,-0.003644444444444444,17.61111111111111
1560,18094,28986,20,23,43,46.51,0.004962790697674416,23.74418604651163
1568,4692,-5052,14,17,31,45.16,-0.007864516129032259,27.193548387096776
1582,9258,7352,8,14,22,36.36,-0.007427272727272729,19.227272727272727
1583,6943,-14533,10,14,24,41.67,-0.002908333333333332,21.875
1587,4683,-3713,12,23,35,34.29,-0.004497142857142857,26.285714285714285
1589,14946,59034,16,13,29,55.17,0.02231034482758621,25.310344827586206
1590,153598,30432,28,43,71,39.44,-0.00654788732394366,21.014084507042252
1597,15995,73995,16,15,31,51.61,0.018570967741935486,29.903225806451612
1598,4626,31044,7,5,12,58.33,0.038049999999999994,36.75
1603,3911,-1891,22,31,53,41.51,-0.008707547169811322,27.71698113207547
1604,1434,-2424,9,14,23,39.13,-0.012978260869565222,49.26086956521739
1605,5266,-926,27,30,57,47.37,0.007703508771929826,27.31578947368421
1608,3938,-15168,16,33,49,32.65,-0.02134489795918367,26.102040816326532
1609,3714,2906,20,22,42,47.62,0.0007261904761904762,23.928571428571427
1611,4437,653,20,27,47,42.55,0.00285957446808511,22.893617021276597
1612,4219,1301,19,23,42,45.24,-0.0024833333333333313,20.952380952380953
1614,3500,-170,9,12,21,42.86,0.0014380952380952394,28.095238095238095
1615,3642,-7002,14,26,40,35.0,-0.014029999999999997,27.7
1616,2504,4296,21,17,38,55.26,0.017249999999999998,34.44736842105263
1617,1653,-8693,6,15,21,28.57,-0.04306666666666666,39.666666666666664
1618,3140,14170,17,18,35,48.57,0.012197142857142861,32.0
1626,4450,-36140,5,18,23,21.74,-0.03801739130434783,36.34782608695652
1701,4046,-4346,16,22,38,42.11,-0.0068868421052631565,31.263157894736842
1702,8909,-7689,28,28,56,50.0,0.0026321428571428576,18.517857142857142
1707,20121,-10231,16,20,36,44.44,0.003513888888888892,25.694444444444443
1708,6543,-32663,12,21,33,36.36,-0.018469696969696976,36.39393939393939
1709,1995,3035,10,11,21,47.62,0.008733333333333333,23.857142857142858
1710,9739,361,21,37,58,36.21,-0.005362068965517242,17.75862068965517
1711,6568,12282,28,26,54,51.85,0.011035185185185188,23.685185185185187
1712,2225,-9345,7,16,23,30.43,-0.018778260869565216,56.17391304347826
1713,2145,-115,12,15,27,44.44,-0.006314814814814816,34.666666666666664
1714,2428,1862,14,19,33,42.42,0.0007424242424242435,39.27272727272727
1717,5768,-39128,9,20,29,31.03,-0.027789655172413788,23.93103448275862
1718,4414,-16144,17,42,59,28.81,-0.029788135593220338,22.45762711864407
1720,5989,20281,16,16,32,50.0,0.017259375,29.21875
1721,3669,431,21,30,51,41.18,-0.010470588235294113,30.666666666666668
1722,14301,-35221,9,29,38,23.68,-0.03215789473684211,23.894736842105264
1723,11349,-27839,8,12,20,40.0,-0.007440000000000004,37.15
1725,4044,116,11,21,32,34.38,-0.0044031250000000025,47.25
1726,2076,5154,4,3,7,57.14,0.014728571428571424,64.85714285714286
1727,5310,4160,17,26,43,39.53,-0.010688372093023256,24.11627906976744
1730,1913,-5063,6,10,16,37.5,-0.018674999999999997,56.1875
1731,4661,169,22,30,52,42.31,0.000771153846153845,17.71153846153846
1732,5511,-1821,21,25,46,45.65,0.002639130434782608,23.869565217391305
1733,7369,-2919,14,16,30,46.67,-0.006886666666666667,21.833333333333332
1734,6805,26925,21,19,40,52.5,0.017595,30.825
1735,1552,-1622,8,10,18,44.44,-0.0034888888888888895,34.5
1736,30594,-15214,30,38,68,44.12,-0.0014308823529411725,21.352941176470587
1737,3511,10549,13,11,24,54.17,0.0168625,22.0
1760,0,0,0,0,0,0.0,,
1762,7599,-20389,9,18,27,33.33,-0.020662962962962966,27.85185185185185
1773,7177,-44017,5,12,17,29.41,-0.027964705882352944,21.88235294117647
1776,611,-1791,2,3,5,40.0,-0.022920000000000003,11.0
1783,6479,-3399,16,16,32,50.0,0.005896874999999999,24.8125
1786,8207,-86247,4,16,20,20.0,-0.05857499999999999,18.4
1789,6770,-20130,10,17,27,37.04,-0.013981481481481484,19.074074074074073
1795,26856,3284,22,35,57,38.6,-0.00555614035087719,21.68421052631579
1802,7039,-26989,16,31,47,34.04,-0.021236170212765956,27.97872340425532
1805,3390,-700,22,30,52,42.31,-0.014055769230769236,18.192307692307693
1806,4756,-4046,28,30,58,48.28,0.002617241379310347,21.482758620689655
1808,3816,4264,13,11,24,54.17,0.019987500000000002,34.0
1809,4574,-12724,20,34,54,37.04,-0.021583333333333333,26.01851851851852
1810,3536,-1436,21,28,49,42.86,-0.0061673469387755085,24.040816326530614
1817,212,-2442,0,1,1,0.0,-0.0685,28.0
1903,16292,-17912,27,28,55,49.09,0.005818181818181823,21.927272727272726
1904,2572,-8242,10,18,28,35.71,-0.018160714285714287,21.928571428571427
1905,4418,-10358,19,26,45,42.22,-0.011342222222222219,21.955555555555556
1906,4025,-18785,16,37,53,30.19,-0.0371377358490566,27.0188679245283
1907,3450,-4290,10,23,33,30.3,-0.024133333333333333,29.060606060606062
1909,5527,13843,26,28,54,48.15,0.007207407407407406,25.98148148148148
2002,3466,-14366,6,12,18,33.33,-0.015594444444444442,24.666666666666668
2006,7943,20777,24,19,43,55.81,0.01723720930232558,17.186046511627907
2007,4406,14984,32,33,65,49.23,0.013456923076923076,17.46153846153846
2008,4513,6537,35,30,65,53.85,0.013346153846153843,17.353846153846153
2009,5149,-34269,17,36,53,32.08,-0.034137735849056605,21.962264150943398
2010,2199,-7349,8,13,21,38.1,-0.016204761904761902,26.666666666666668
2012,3734,-17544,14,23,37,37.84,-0.026632432432432435,22.864864864864863
2013,4303,-20693,8,16,24,33.33,-0.015245833333333333,34.541666666666664
2014,7499,-1939,30,46,76,39.47,-0.01663421052631579,20.69736842105263
2015,9747,-22827,14,25,39,35.9,-0.026635897435897442,19.05128205128205
2017,4172,1598,24,32,56,42.86,-0.005292857142857143,23.017857142857142
2020,2731,17879,10,8,18,55.56,0.022266666666666667,39.22222222222222
2022,3943,5227,35,25,60,58.33,0.009234999999999998,19.75
2023,4302,2548,21,23,44,47.73,0.0035272727272727287,24.931818181818183
2024,4542,-2092,28,40,68,41.18,-0.009557352941176472,20.58823529411765
2025,4597,-5707,30,42,72,41.67,-0.018204166666666667,19.86111111111111
2027,6832,29408,23,23,46,50.0,0.010939130434782608,24.76086956521739
2028,5170,12030,31,28,59,52.54,0.01688305084745763,21.64406779661017
2029,5542,-4932,10,18,28,35.71,-0.008378571428571428,21.464285714285715
2030,5187,-14817,19,31,50,38.0,-0.012216000000000003,22.66
2031,10068,11522,25,28,53,47.17,0.0016358490566037733,20.547169811320753
2032,6412,21788,29,27,56,51.79,0.018582142857142856,26.946428571428573
2033,4604,21946,24,23,47,51.06,0.0274531914893617,40.06382978723404
2034,6612,18118,22,19,41,53.66,0.008160975609756097,23.804878048780488
2038,3113,5387,10,12,22,45.45,0.007804545454545453,34.72727272727273
2049,78062,115038,25,26,51,49.02,0.010676470588235294,23.372549019607842
2059,56626,-10806,16,21,37,43.24,0.0037432432432432435,17.783783783783782
2062,8606,-9186,12,21,33,36.36,-0.011672727272727276,28.0
2069,2027,293,5,7,12,41.67,0.0002500000000000002,19.333333333333332
2101,0,0,0,0,0,0.0,,
2102,5891,-4741,18,31,49,36.73,0.001659183673469389,25.510204081632654
2103,9934,-1934,26,27,53,49.06,0.001975471698113207,24.58490566037736
2104,5996,-21126,15,23,38,39.47,-0.017776315789473685,28.55263157894737
2105,7963,-3913,12,17,29,41.38,-0.01003103448275862,31.79310344827586
2106,6787,-37207,13,25,38,34.21,-0.029405263157894736,27.263157894736842
2107,5266,-14716,18,34,52,34.62,-0.01944807692307693,26.326923076923077
2108,7348,31282,15,23,38,39.47,-0.006986842105263155,21.394736842105264
2109,2603,-14083,11,23,34,32.35,-0.029973529411764708,23.558823529411764
2114,5772,4288,7,11,18,38.89,-0.01333888888888889,32.5
2115,4340,9960,8,6,14,57.14,0.021228571428571427,21.928571428571427
2201,9208,30132,21,21,42,50.0,0.007823809523809525,27.928571428571427
2204,6641,-43561,7,22,29,24.14,-0.04165172413793104,26.586206896551722
2206,5473,-7403,19,27,46,41.3,-0.004263043478260869,21.065217391304348
2207,57063,134497,14,16,30,46.67,0.005403333333333329,31.0
2208,3036,-7646,9,12,21,42.86,-0.012395238095238096,21.285714285714285
2227,28954,-78314,11,17,28,39.29,-0.005057142857142857,24.857142857142858
2228,21905,-57975,9,18,27,33.33,-0.02424814814814815,23.62962962962963
2231,66108,-38488,26,28,54,48.15,0.007555555555555555,17.185185185185187
2233,26436,-18476,20,25,45,44.44,0.001468888888888889,22.666666666666668
2236,3833,-41713,2,19,21,9.52,-0.07115714285714286,23.61904761904762
2239,10486,62664,9,8,17,52.94,0.027252941176470584,25.058823529411764
2241,1252,-10442,1,3,4,25.0,-0.043875,43.25
2243,2714,4416,13,15,28,46.43,0.004485714285714287,17.607142857142858
2247,0,0,0,0,0,0.0,,
2301,8613,3457,17,20,37,45.95,0.0070810810810810814,32.78378378378378
2302,4863,-10563,30,45,75,40.0,-0.013232,23.68
2303,7198,-7968,22,32,54,40.74,-0.005807407407407406,21.11111111111111
2305,4042,-32,30,34,64,46.88,0.002193749999999998,21.421875
2308,31775,-59865,19,28,47,40.43,-0.009472340425531918,26.106382978723403
2312,3559,-19479,14,33,47,29.79,-0.032402127659574474,34.808510638297875
2313,10747,-11497,36,52,88,40.91,-0.007345454545454545,23.579545454545453
2314,12048,-11288,37,53,90,41.11,-0.003602222222222219,19.877777777777776
2316,6719,-5709,26,43,69,37.68,-0.006911594202898552,18.956521739130434
2317,24778,-88348,12,18,30,40.0,-0.01762,33.36666666666667
2321,5031,12629,37,39,76,48.68,0.006022368421052631,28.513157894736842
2323,4298,-3528,23,34,57,40.35,-0.006215789473684212,22.80701754385965
2324,7994,4636,21,26,47,44.68,0.004346808510638298,33.297872340425535
2327,66955,598315,36,32,68,52.94,0.019357352941176475,17.220588235294116
2328,16200,900,27,44,71,38.03,-0.003938028169014085,18.802816901408452
2329,5409,4351,36,44,80,45.0,0.001793749999999998,23.85
2330,9192,-12872,9,7,16,56.25,0.02410625,28.625
2331,6631,-1041,26,39,65,40.0,-0.003180000000000002,23.49230769230769
2332,8394,-17324,21,29,50,42.0,-0.008824,28.54
2337,8854,-42814,26,53,79,32.91,-0.016981012658227847,18.10126582278481
2338,11331,43329,21,35,56,37.5,-0.0023535714285714293,19.035714285714285
2340,8669,14861,30,42,72,41.67,-0.006236111111111112,20.958333333333332
2342,11160,2080,41,53,94,43.62,-0.008048936170212767,22.670212765957448
2344,7563,-8783,42,48,90,46.67,0.004009999999999998,21.944444444444443
2345,38002,-1632,33,42,75,44.0,0.00260666666666667,19.613333333333333
2347,10927,43743,17,17,34,50.0,0.018352941176470593,20.852941176470587
2348,7726,8944,36,39,75,48.0,0.006894666666666668,18.133333333333333
2349,4156,-20616,18,43,61,29.51,-0.03649016393442623,19.295081967213115
2351,25595,10635,36,44,80,45.0,0.0034349999999999984,13.6625
2352,7267,-9657,24,35,59,40.68,-0.009116949152542374,15.711864406779661
2353,10410,11420,19,23,42,45.24,0.0014095238095238076,28.642857142857142
2354,44556,138974,25,27,52,48.08,-0.0006076923076923043,29.365384615384617
2355,6854,-25544,13,27,40,32.5,-0.0213075,34.5
2356,4713,-12653,14,27,41,34.15,-0.01482682926829268,27.829268292682926
2357,34116,-203096,13,24,37,35.14,-0.025740540540540542,38.37837837837838
2358,5785,-19575,25,43,68,36.76,-0.016763235294117648,16.485294117647058
2359,5319,-10229,23,30,53,43.4,-0.002013207547169812,18.88679245283019
2360,38096,-282556,19,55,74,25.68,-0.02930135135135135,17.175675675675677
2362,9851,-34201,18,32,50,36.0,-0.015873999999999996,29.64
2363,7488,32,37,43,80,46.25,0.0033149999999999985,22.475
2364,6576,-22646,33,49,82,40.24,-0.011899999999999997,24.158536585365855
2365,6026,-9886,20,24,44,45.45,-0.004534090909090907,26.795454545454547
2367,7494,-13244,31,42,73,42.47,-0.0023684931506849313,21.972602739726028
2368,12399,-54639,33,47,80,41.25,-0.003507499999999999,20.175
2369,6990,-5880,35,45,80,43.75,-0.006242499999999999,23.8
2371,6708,-32648,19,53,72,26.39,-0.03474166666666667,22.15277777777778
2373,3964,5796,9,10,19,47.37,0.0072421052631578935,18.894736842105264
2374,7804,-16284,17,28,45,37.78,-0.011179999999999999,24.044444444444444
2375,13063,40967,33,39,72,45.83,0.0027944444444444436,18.583333333333332
2376,19276,20384,28,34,62,45.16,0.006185483870967741,26.403225806451612
2377,18391,67009,31,34,65,47.69,0.007830769230769231,19.6
2379,53122,-167452,28,47,75,37.33,-0.009885333333333336,24.466666666666665
2380,4519,5741,22,26,48,45.83,0.0067104166666666675,22.9375
2382,18154,-55674,17,34,51,33.33,-0.017456862745098042,28.19607843137255
2383,33113,-186343,29,53,82,35.37,-0.018906097560975606,20.414634146341463
2385,11900,-10390,14,21,35,40.0,-0.007060000000000001,29.485714285714284
2387,7430,-17590,18,23,41,43.9,-0.002499999999999998,26.146341463414632
2388,17012,15038,46,57,103,44.66,0.002723300970873788,18.805825242718445
2390,5680,17540,32,28,60,53.33,0.015235000000000002,26.683333333333334
2392,17772,-24582,21,30,51,41.18,-0.011778431372549022,18.627450980392158
2393,25126,34784,28,34,62,45.16,0.008012903225806452,27.403225806451612
2395,28424,-94714,10,23,33,30.3,-0.024836363636363636,36.18181818181818
2397,6471,60339,16,9,25,64.0,0.037988,40.6
2399,6483,16057,30,34,64,46.88,0.014043749999999997,20.90625
2401,12576,63294,41,33,74,55.41,0.01995675675675676,16.824324324324323
2402,10224,38416,36,33,69,52.17,0.014940579710144926,21.014492753623188
2404,11741,65719,14,18,32,43.75,-0.005171875,23.15625
2405,8218,13622,42,47,89,47.19,0.006577528089887641,19.1123595505618
2406,11026,6864,49,48,97,50.52,0.02155360824742268,21.24742268041237
2408,16420,-11640,35,44,79,44.3,-0.006762025316455696,25.88607594936709
2409,9699,16211,28,32,60,46.67,0.015648333333333334,33.05
2412,0,0,0,0,0,0.0,,
2413,6441,-17241,25,42,67,37.31,-0.017813432835820892,35.701492537313435
2414,2478,-9168,9,16,25,36.0,-0.0148,17.8
2415,6477,31193,26,24,50,52.0,0.01808,16.82
2417,11364,-20584,26,39,65,40.0,-0.007012307692307692,22.892307692307693
2419,6030,-10270,27,37,64,42.19,-0.0007906250000000005,26.8125
2420,7661,8439,21,23,44,47.73,0.004593181818181819,25.0
2421,7637,-35437,15,32,47,31.91,-0.026074468085106384,22.127659574468087
2423,2911,-11431,8,15,23,34.78,-0.0241304347826087,25.695652173913043
2424,4690,-9090,24,32,56,42.86,-0.015825000000000002,62.17857142857143
2425,7492,3238,33,47,80,41.25,-0.01264375,18.725
2426,10334,-11744,37,56,93,39.78,-0.005411827956989248,17.50537634408602
2427,3121,-2781,17,24,41,41.46,-0.00902439024390244,35.4390243902439
2428,17674,-28834,22,25,47,46.81,-0.0036085106382978717,24.04255319148936
2429,4095,-10865,15,38,53,28.3,-0.04248679245283019,17.264150943396228
2430,7360,-2340,17,17,34,50.0,-0.0036323529411764746,28.941176470588236
2431,6014,-18624,24,48,72,33.33,-0.023005555555555557,18.38888888888889
2433,2723,3767,11,14,25,44.0,-0.0010959999999999987,24.04
2434,7332,68,28,37,65,43.08,-0.001050769230769236,23.2
2436,17753,-43483,33,60,93,35.48,-0.011926881720430105,19.806451612903224
2438,4840,-21070,26,55,81,32.1,-0.05406172839506172,16.666666666666668
2439,46822,-124592,29,53,82,35.37,-0.018639024390243904,23.23170731707317
2440,4570,8260,36,29,65,55.38,0.015941538461538462,19.153846153846153
2441,7005,-5365,13,19,32,40.62,-0.009100000000000004,26.03125
2442,4401,5299,27,32,59,45.76,0.005303389830508476,22.305084745762713
2443,4461,-8381,30,44,74,40.54,-0.01060945945945946,15.824324324324325
2444,6871,1469,34,49,83,40.96,-0.0036746987951807213,21.80722891566265
2449,8261,8079,28,33,61,45.9,0.0034327868852459032,22.78688524590164
2450,12617,9423,14,19,33,42.42,-0.008381818181818181,27.151515151515152
2451,21163,-2263,20,25,45,44.44,-0.0006022222222222192,20.288888888888888
2453,3864,516,24,20,44,54.55,0.006859090909090911,18.772727272727273
2454,159979,-103129,31,36,67,46.27,-0.003916417910447764,23.65671641791045
2455,26644,-50034,32,51,83,38.55,-0.008730120481927707,17.93975903614458
2457,11723,-843,42,46,88,47.73,0.008621590909090909,17.795454545454547
2458,25373,42207,46,40,86,53.49,0.01742441860465116,21.25581395348837
2459,7181,-1381,19,17,36,52.78,0.0018916666666666674,21.25
2460,8475,-15475,23,38,61,37.7,-0.010868852459016391,21.868852459016395
2461,6116,-12946,20,31,51,39.22,-0.011839215686274508,22.607843137254903
2462,4707,-4787,12,20,32,37.5,-0.009762500000000002,18.3125
2464,6536,-16686,13,22,35,37.14,-0.0146,36.31428571428572
2465,7466,33714,47,34,81,58.02,0.02831358024691358,23.22222222222222
2466,2578,-9268,6,15,21,28.57,-0.026514285714285712,72.57142857142857
2467,5341,9009,21,19,40,52.5,0.008332499999999998,25.55
2468,3482,-9282,16,27,43,37.21,-0.021774418604651163,40.76744186046512
2471,4503,7,22,20,42,52.38,0.01572142857142857,35.0
2472,12142,-25122,29,43,72,40.28,-0.012383333333333336,23.98611111111111
2474,78704,-310854,25,44,69,36.23,-0.023833333333333335,25.391304347826086
2476,9373,15697,25,21,46,54.35,0.009793478260869565,20.17391304347826
2477,7884,4666,24,33,57,42.11,-0.008461403508771927,21.333333333333332
2478,14544,99346,34,34,68,50.0,0.01759705882352941,20.25
2480,4198,-4468,13,17,30,43.33,0.002703333333333334,26.966666666666665
2481,18004,-6844,46,52,98,46.94,0.008034693877551019,18.785714285714285
2482,7641,-10331,22,36,58,37.93,-0.010974137931034482,25.551724137931036
2483,2983,-9313,10,16,26,38.46,-0.012153846153846156,22.384615384615383
2484,8954,11986,38,39,77,49.35,0.006548051948051946,25.0
2485,17740,65040,32,38,70,45.71,0.005820000000000001,22.7
2486,10745,5835,32,36,68,47.06,0.002724999999999999,24.91176470588235
2488,5519,13211,19,17,36,52.78,0.010408333333333332,29.944444444444443
2489,7021,15269,28,25,53,52.83,0.017692452830188683,21.849056603773583
2491,5709,13871,38,46,84,45.24,0.0009940476190476162,20.011904761904763
2492,36002,209578,47,44,91,51.65,0.016831868131868134,23.439560439560438
2493,3206,-9856,15,17,32,46.88,-0.0021468749999999986,41.21875
2495,15860,15700,24,33,57,42.11,-0.001036842105263157,19.017543859649123
2496,947,-39267,8,6,14,57.14,-0.7219142857142857,456.07142857142856
2497,13544,-23804,25,30,55,45.45,0.00361818181818182,23.581818181818182
2498,194445,121805,46,58,104,44.23,0.0021355769230769223,19.221153846153847
2501,6226,-2506,26,39,65,40.0,-0.007323076923076924,20.16923076923077
2504,4722,4508,24,26,50,48.0,-0.0011420000000000002,24.2
2505,6913,3557,33,38,71,46.48,0.0029225352112676045,26.098591549295776
2506,1803,-3523,13,21,34,38.24,-0.01981764705882353,30.08823529411765
2509,6564,11716,28,28,56,50.0,0.016389285714285714,21.75
2511,3882,12908,20,23,43,46.51,0.010458139534883719,43.81395348837209
2514,3889,2511,20,24,44,45.45,0.0008068181818181805,34.09090909090909
2515,2343,-2373,14,25,39,35.9,-0.012620512820512816,35.05128205128205
2516,2029,8261,20,15,35,57.14,0.03405714285714285,31.142857142857142
2520,8849,8301,35,40,75,46.67,0.0017439999999999982,23.826666666666668
2524,10360,-28940,22,37,59,37.29,-0.012186440677966105,19.135593220338983
2527,4850,12540,30,30,60,50.0,0.016309999999999998,21.966666666666665
2528,3709,-7349,23,40,63,36.51,-0.03494920634920634,12.555555555555555
2530,2994,7216,27,20,47,57.45,0.025402127659574468,22.19148936170213
2534,4944,-26504,14,31,45,31.11,-0.027302222222222224,38.666666666666664
2535,3904,-10824,17,29,46,36.96,-0.02038695652173913,19.630434782608695
2536,8999,-3779,23,33,56,41.07,-0.0033821428571428553,19.589285714285715
2537,2584,-84,19,22,41,46.34,-0.005812195121951216,20.853658536585368
2538,4852,20538,30,25,55,54.55,0.017196363636363635,20.30909090909091
2539,2569,-14659,5,15,20,25.0,-0.037145,18.25
2540,6686,-32206,20,36,56,35.71,-0.039625,17.107142857142858
2542,8403,16667,21,24,45,46.67,-0.0005511111111111126,27.755555555555556
2543,2191,-5001,12,20,32,37.5,-0.013787500000000003,24.0625
2545,15886,106254,37,24,61,60.66,0.03638688524590163,20.934426229508198
2546,3582,17178,27,20,47,57.45,0.02346595744680851,18.872340425531913
2547,7706,10934,26,33,59,44.07,0.003479661016949155,32.67796610169491
2548,13087,28423,23,20,43,53.49,0.006069767441860465,33.651162790697676
2597,7465,36295,9,6,15,60.0,0.02582,38.266666666666666
2601,0,0,0,0,0,0.0,,
2603,12526,-33406,24,40,64,37.5,-0.011106249999999998,29.5
2605,8971,-17861,19,29,48,39.58,-0.014856250000000001,23.604166666666668
2606,14611,-34141,18,35,53,33.96,-0.02542452830188679,26.22641509433962
2607,6591,6569,27,28,55,49.09,0.01583454545454546,20.09090909090909
2608,5250,-8800,17,24,41,41.46,0.004751219512195119,31.341463414634145
2609,7071,73589,19,33,52,36.54,-0.004013461538461539,31.903846153846153
2610,3937,18563,21,23,44,47.73,0.019263636363636368,60.86363636363637
2611,3262,-3622,14,20,34,41.18,-0.012308823529411764,43.705882352941174
2612,14916,9104,25,28,53,47.17,0.0014188679245283014,25.37735849056604
2613,6991,-7661,26,42,68,38.24,-0.008139705882352941,25.33823529411765
2614,5396,3344,29,36,65,44.62,-0.0038384615384615384,27.369230769230768
2615,18705,-9975,23,35,58,39.66,-0.004722413793103447,19.189655172413794
2616,820,3100,4,5,9,44.44,0.015022222222222222,55.111111111111114
2617,8541,27959,18,24,42,42.86,0.008730952380952381,23.976190476190474
2618,5798,-24848,18,32,50,36.0,-0.019011999999999994,51.42
2630,709,-10549,0,6,6,0.0,-0.08946666666666668,20.5
2633,193,2517,1,0,1,100.0,0.0815,127.0
2634,800,4840,3,1,4,75.0,0.031424999999999995,35.25
2636,6037,45813,10,9,19,52.63,0.03007894736842106,38.526315789473685
2637,6234,-24454,4,11,15,26.67,-0.026733333333333335,18.733333333333334
2642,4580,5500,8,7,15,53.33,0.01092666666666667,24.466666666666665
2701,2599,-3519,12,17,29,41.38,-0.002296551724137932,30.93103448275862
2702,7368,-1388,21,31,52,40.38,-0.0024230769230769206,22.634615384615383
2704,7125,40935,21,15,36,58.33,0.03244444444444444,17.13888888888889
2705,4827,-597,19,27,46,41.3,0.003006521739130433,37.97826086956522
2706,3789,-10229,8,16,24,33.33,-0.013995833333333334,17.708333333333332
2707,0,0,0,0,0,0.0,,
2712,2029,531,4,6,10,40.0,-0.00655,27.4
2722,2455,-21565,3,10,13,23.08,-0.04627692307692308,23.0
2723,56749,-174499,18,30,48,37.5,-0.00998958333333333,22.0625
2727,22092,-78302,8,17,25,32.0,-0.021647999999999997,28.2
2731,10074,-73484,4,12,16,25.0,-0.04094999999999999,16.125
2739,279,3671,2,0,2,100.0,0.0758,2.5
2748,910,-11890,0,3,3,0.0,-0.07386666666666666,33.0
2801,3093,-8583,11,19,30,36.67,-0.015216666666666673,33.333333333333336
2809,2623,8567,14,12,26,53.85,0.011842307692307695,38.76923076923077
2812,1627,-2047,10,15,25,40.0,-0.008947999999999998,38.4
2816,3760,-1190,19,22,41,46.34,0.0005804878048780495,20.414634146341463
2820,584,-2444,3,6,9,33.33,-0.021444444444444447,35.22222222222222
2832,1785,-4925,6,8,14,42.86,-0.01837857142857143,47.42857142857143
2834,1706,1464,12,13,25,48.0,0.006979999999999999,17.52
2836,2353,-16713,8,17,25,32.0,-0.032279999999999996,27.48
2838,967,-3267,5,10,15,33.33,-0.019693333333333334,41.4
2845,1707,1843,10,12,22,45.45,0.0036090909090909077,34.86363636363637
2849,2907,-19107,9,31,40,22.5,-0.042027499999999995,22.4
2850,1825,-5435,6,12,18,33.33,-0.02616666666666667,15.333333333333334
2851,1140,1240,5,7,12,41.67,0.004608333333333336,93.5
2852,2072,668,8,16,24,33.33,-0.016570833333333333,38.083333333333336
2855,2242,3258,10,13,23,43.48,0.0005304347826087006,39.69565217391305
2867,528,-2118,2,5,7,28.57,-0.03495714285714286,15.0
2880,3206,-1426,10,15,25,40.0,-0.004912000000000001,35.56
2881,6107,29723,18,12,30,60.0,0.03549666666666666,42.3
2882,7389,-24949,7,18,25,28.0,-0.01774,32.56
2883,1696,-1906,7,16,23,30.43,-0.013256521739130434,42.43478260869565
2884,2796,-14906,7,22,29,24.14,-0.03363793103448277,20.448275862068964
2885,4220,-31470,9,32,41,21.95,-0.046209756097560964,29.390243902439025
2886,3249,5451,13,14,27,48.15,0.00895185185185185,26.51851851851852
2887,2881,-17581,8,21,29,27.59,-0.03783793103448276,37.93103448275862
2888,3996,16394,21,17,38,55.26,0.024665789473684214,20.55263157894737
2889,1021,-3011,5,10,15,33.33,-0.024059999999999995,28.8
2890,2933,-3953,15,23,38,39.47,-0.009784210526315793,40.71052631578947
2891,3354,-10144,9,17,26,34.62,-0.012903846153846155,35.19230769230769
2892,2682,-6562,6,14,20,30.0,-0.015684999999999998,26.6
2897,137,1523,2,0,2,100.0,0.0837,85.0
2901,3264,-10174,7,16,23,30.43,-0.02175217391304348,23.26086956521739
2903,8851,-9131,21,31,52,40.38,-0.007761538461538463,16.846153846153847
2904,1481,-2681,10,15,25,40.0,-0.025476000000000002,18.16
2905,4628,-10768,18,25,43,41.86,-0.009704651162790701,23.88372093023256
2906,1498,-3848,8,10,18,44.44,-0.009233333333333336,20.22222222222222
2908,1302,-1312,5,7,12,41.67,-0.009099999999999997,24.583333333333332
2910,8230,-47030,16,34,50,32.0,-0.031377999999999996,45.56
2911,7274,-12444,22,37,59,37.29,-0.010894915254237287,20.35593220338983
2912,22774,-158934,6,24,30,20.0,-0.042403333333333335,41.96666666666667
2913,4466,-1576,22,30,52,42.31,-0.00019230769230769196,16.423076923076923
2915,11182,22238,19,27,46,41.3,0.00254782608695652,33.391304347826086
2923,3930,4860,10,16,26,38.46,-0.00029230769230769376,31.807692307692307
2929,13877,6133,11,17,28,39.29,-0.010592857142857142,20.0
2939,9166,-53336,5,13,18,27.78,-0.04091666666666666,27.38888888888889
3002,2855,5715,12,14,26,46.15,-0.0001807692307692322,44.42307692307692
3003,12253,-42903,16,30,46,34.78,-0.019800000000000005,32.369565217391305
3004,15081,-13861,27,44,71,38.03,-0.024980281690140847,17.95774647887324
3005,7737,-3427,22,30,52,42.31,0.004492307692307691,27.78846153846154
3006,28136,33654,38,44,82,46.34,0.009319512195121955,25.70731707317073
3008,960234,-71674,39,56,95,41.05,-0.0008284210526315779,19.53684210526316
3010,4269,-9779,5,10,15,33.33,-0.011720000000000001,39.266666666666666
3011,6236,-676,32,43,75,42.67,-0.004923999999999999,21.426666666666666
3013,6158,31252,23,26,49,46.94,0.01315306122448979,35.06122448979592
3014,23359,-8099,33,41,74,44.59,-0.007554054054054052,15.567567567567568
3015,6537,16363,17,15,32,53.12,0.012109375,27.5
3016,18784,32476,40,49,89,44.94,0.0005449438202247202,21.719101123595507
3017,17577,-27127,33,49,82,40.24,-0.008607317073170737,17.158536585365855
3018,6588,-34038,24,37,61,39.34,-0.01734426229508197,27.262295081967213
3019,38657,-146587,29,54,83,34.94,-0.020008433734939757,25.63855421686747
3021,1092,24878,8,9,17,47.06,0.8756588235294118,363.7647058823529
3022,12193,3957,22,29,51,43.14,-0.002692156862745099,33.94117647058823
3023,17314,56436,18,18,36,50.0,0.010291666666666666,25.555555555555557
3024,3676,-5736,18,22,40,45.0,-0.007055000000000003,42.65
3025,6992,-8572,32,36,68,47.06,-0.003442647058823532,23.38235294117647
3026,20928,156702,25,18,43,58.14,0.028688372093023263,19.651162790697676
3027,6340,-34190,19,43,62,30.65,-0.03106129032258064,32.75806451612903
3028,2027,-12797,3,14,17,17.65,-0.040247058823529414,16.352941176470587
3029,6902,1878,28,34,62,45.16,0.003414516129032256,23.193548387096776
3030,12338,41322,29,22,51,56.86,0.02323529411764706,18.92156862745098
3031,12392,978,28,40,68,41.18,0.0002632352941176448,22.470588235294116
3032,4929,23281,19,18,37,51.35,0.026043243243243242,25.72972972972973
3033,2461,-7061,7,13,20,35.0,-0.021095,40.85
3034,65521,-30911,33,48,81,40.74,-0.005892592592592591,21.45679012345679
3035,44801,1239,44,56,100,44.0,0.002465,19.22
3036,7047,-2747,14,22,36,38.89,-0.00665,23.72222222222222
3037,27430,33330,39,47,86,45.35,0.006572093023255814,18.023255813953487
3038,6845,3075,34,32,66,51.52,0.0126530303030303,27.96969696969697
3040,4637,-29067,10,27,37,27.03,-0.030656756756756758,25.37837837837838
3041,19600,79610,50,43,93,53.76,0.020775268817204304,22.086021505376344
3042,17650,-47470,27,39,66,40.91,-0.012722727272727274,15.787878787878787
3043,10209,50761,42,44,86,48.84,0.003241860465116275,14.825581395348838
3044,32604,31366,32,33,65,49.23,0.008426153846153845,21.43076923076923
3045,3174,-22004,2,8,10,20.0,-0.028170000000000008,40.2
3046,7471,15679,35,39,74,47.3,0.007659459459459459,19.45945945945946
3047,4822,19848,29,26,55,52.73,0.024036363636363637,23.0
3048,4243,-5443,12,15,27,44.44,-0.003511111111111109,23.37037037037037
3049,8200,28220,50,43,93,53.76,0.022488172043010745,18.913978494623656
3050,5479,3941,28,35,63,44.44,-0.002806349206349204,20.03174603174603
3051,13697,19063,41,50,91,45.05,0.0015956043956043974,15.098901098901099
3052,2257,-1657,17,17,34,50.0,0.004588235294117645,19.58823529411765
3054,7260,15770,26,32,58,44.83,0.006498275862068968,24.637931034482758
3055,5810,-2180,17,22,39,43.59,-0.0011923076923076926,42.87179487179487
3056,3418,1882,14,19,33,42.42,-0.012366666666666666,20.09090909090909
3057,9819,11931,35,35,70,50.0,0.016740000000000005,26.428571428571427
3058,3781,16369,23,20,43,53.49,0.02208837209302325,30.651162790697676
3059,19642,-20372,32,52,84,38.1,-0.007608333333333333,20.297619047619047
3060,20599,-72239,23,44,67,34.33,-0.016094029850746268,19.671641791044777
3062,16651,-35771,35,47,82,42.68,-0.005321951219512195,22.475609756097562
3090,7857,11923,16,16,32,50.0,0.0086375,28.1875
3094,11275,28605,34,30,64,53.12,0.0168953125,21.75
3130,14167,13033,8,11,19,42.11,-0.004968421052631581,23.842105263157894
3138,19308,117512,24,34,58,41.38,-0.009324137931034485,23.413793103448278
3149,5120,8960,18,17,35,51.43,0.018565714285714286,23.857142857142858
3164,7368,18212,17,18,35,48.57,0.008471428571428572,27.542857142857144
3167,6060,-10140,8,12,20,40.0,-0.0157,20.45
3189,42270,76170,39,39,78,50.0,0.013376923076923073,24.5
3209,4473,-2733,13,17,30,43.33,-0.009473333333333334,20.366666666666667
3229,6258,-11778,22,34,56,39.29,-0.010316071428571428,20.089285714285715
3231,10348,-30828,20,31,51,39.22,-0.011605882352941176,27.686274509803923
3257,9554,4526,14,14,28,50.0,0.009042857142857142,30.0
3266,5375,13395,23,21,44,52.27,0.014609090909090912,26.772727272727273
3296,8340,8990,21,28,49,42.86,-0.005787755102040814,21.53061224489796
3305,18419,36831,24,26,50,48.0,0.007562,16.92
3308,3712,4528,18,26,44,40.91,-0.00029318181818181207,26.181818181818183
3311,25421,21219,21,29,50,42.0,-0.003,24.74
3312,3458,-15068,14,25,39,35.9,-0.021946153846153844,20.358974358974358
3321,1875,-6375,9,13,22,40.91,-0.015436363636363637,18.818181818181817
3338,9160,8810,16,15,31,51.61,0.014748387096774196,23.806451612903224
3346,5734,16616,10,11,21,47.62,0.01729047619047619,28.0
3356,26603,-34913,20,26,46,43.48,-0.00910217391304348,25.804347826086957
3376,41538,109642,27,31,58,46.55,0.011963793103448276,29.517241379310345
3380,8590,7280,26,30,56,46.43,0.0040803571428571425,22.25
3406,104975,197015,39,41,80,48.75,0.013882499999999997,25.575
3413,30197,60463,16,15,31,51.61,0.012603225806451613,32.32258064516129
3416,5546,3104,7,6,13,53.85,0.012961538461538462,33.30769230769231
3419,5273,29747,24,22,46,52.17,0.021219565217391306,28.58695652173913
3432,3206,13924,18,15,33,54.55,0.023133333333333336,45.57575757575758
3437,6364,7906,18,21,39,46.15,0.0054615384615384595,19.102564102564102
3443,116941,-239151,30,51,81,37.04,-0.013382716049382718,19.358024691358025
3450,24868,-40798,29,39,68,42.65,-0.007529411764705886,24.147058823529413
3454,29723,109237,28,29,57,49.12,0.014084210526315791,18.56140350877193
3481,14189,8751,31,35,66,46.97,0.006493939393939395,17.848484848484848
3494,4385,7025,24,21,45,53.33,0.004635555555555556,25.844444444444445
3501,6525,-15245,9,16,25,36.0,-0.014564,17.76
3504,39786,145714,41,40,81,50.62,0.013576543209876545,19.296296296296298
3515,26484,122066,18,17,35,51.43,0.021028571428571428,17.857142857142858
3518,17366,41934,24,23,47,51.06,0.006391489361702125,20.914893617021278
3528,1131,-71,3,3,6,50.0,0.0030333333333333323,48.666666666666664
3530,28395,95385,33,40,73,45.21,0.014820547945205478,23.726027397260275
3532,46674,124656,37,38,75,49.33,0.013754666666666662,16.76
3533,84936,-151946,29,31,60,48.33,0.0074,23.933333333333334
3535,6757,-507,25,31,56,44.64,0.00925,15.125
3536,3525,7055,21,32,53,39.62,0.003969811320754715,18.92452830188679
3543,4868,-18018,13,20,33,39.39,-0.021393939393939392,35.63636363636363
3545,27362,140698,35,46,81,43.21,0.003425925925925926,18.839506172839506
3550,1701,-4091,6,12,18,33.33,-0.014277777777777775,27.944444444444443
3557,7979,-46989,21,23,44,47.73,-0.0028090909090909065,15.386363636363637
3563,36273,-24023,11,17,28,39.29,-0.007632142857142858,19.964285714285715
3576,10284,5686,28,39,67,41.79,-0.004767164179104475,16.761194029850746
3583,12373,-14333,13,19,32,40.62,-0.009618749999999997,25.5625
3588,18119,-80849,15,26,41,36.59,-0.01236341463414634,24.926829268292682
3591,7317,30473,13,26,39,33.33,-0.01748205128205128,28.615384615384617
3593,4232,-6732,14,28,42,33.33,-0.022416666666666668,23.928571428571427
3596,17869,-41549,17,28,45,37.78,-0.006228888888888889,19.977777777777778
3605,10751,27989,23,20,43,53.49,0.0156953488372093,16.511627906976745
3607,8568,-5278,15,25,40,37.5,-0.008230000000000001,26.4
3617,11983,22767,12,12,24,50.0,0.014808333333333335,34.041666666666664
3622,23827,-97927,14,26,40,35.0,-0.015662500000000003,23.8
3645,12369,27641,26,18,44,59.09,0.020634090909090907,23.09090909090909
3653,73009,-83239,29,37,66,43.94,-0.0009636363636363635,22.227272727272727
3661,115545,153405,25,28,53,47.17,0.018775471698113208,15.584905660377359
3665,61703,-287053,18,37,55,32.73,-0.024530909090909086,16.636363636363637
3669,5562,-4842,10,12,22,45.45,-0.021686363636363636,20.0
3673,58146,369864,25,26,51,49.02,0.020496078431372546,30.568627450980394
3679,8445,20135,10,9,19,52.63,0.01521052631578947,31.94736842105263
3682,616,-3686,3,6,9,33.33,-0.04134444444444445,29.333333333333332
3686,5708,15872,27,25,52,51.92,0.017582692307692313,17.826923076923077
3694,5772,938,22,24,46,47.83,0.0061478260869565204,25.76086956521739
3701,4743,-8233,16,28,44,36.36,-0.016704545454545448,19.431818181818183
3702,5339,19201,14,10,24,58.33,0.0248,15.291666666666666
3703,1364,2426,6,5,11,54.55,0.015090909090909094,13.818181818181818
3704,4801,-14511,13,24,37,35.14,-0.014578378378378378,17.324324324324323
3705,2355,5465,4,4,8,50.0,0.009487500000000003,65.25
3706,1268,-1788,3,5,8,37.5,-0.0104375,34.625
3708,12249,40491,8,11,19,42.11,0.02603157894736842,31.57894736842105
3711,4972,15578,6,4,10,60.0,0.02067,51.0
3712,2185,-15005,3,8,11,27.27,-0.03517272727272727,17.09090909090909
3714,3977,10333,4,5,9,44.44,0.01472222222222222,11.444444444444445
4104,6682,-26082,8,13,21,38.1,-0.0167,33.04761904761905
4106,10343,15787,24,30,54,44.44,0.013357407407407408,29.814814814814813
4108,13159,-65679,18,45,63,28.57,-0.0272968253968254,19.904761904761905
4119,14139,-52999,12,25,37,32.43,-0.025832432432432426,24.405405405405407
4133,7193,30107,9,16,25,36.0,0.0073079999999999985,51.72
4137,34637,86323,14,14,28,50.0,0.011753571428571431,19.785714285714285
4142,7294,1626,14,17,31,45.16,0.00201290322580645,16.806451612903224
4155,5471,-12411,9,15,24,37.5,-0.011358333333333337,22.375
4164,5409,2891,7,11,18,38.89,-0.002872222222222222,21.833333333333332
4190,10740,-35650,7,12,19,36.84,-0.016994736842105264,20.894736842105264
4306,3573,6657,15,17,32,46.88,0.00373125,25.40625
4414,4131,-16771,19,35,54,35.19,-0.015379629629629634,31.40740740740741
4426,14901,27429,22,35,57,38.6,-0.010557894736842105,23.24561403508772
4438,7049,-12039,3,6,9,33.33,-0.01023333333333333,19.88888888888889
4439,4946,-56096,0,6,6,0.0,-0.06653333333333335,14.5
4526,4353,9157,11,12,23,47.83,0.003865217391304348,38.130434782608695
4532,4286,-6816,16,23,39,41.03,-0.010961538461538457,39.05128205128205
4536,18416,-90526,7,16,23,30.43,-0.02845217391304348,13.173913043478262
4540,4528,-9918,6,8,14,42.86,-0.008571428571428572,24.0
4545,3108,562,6,10,16,37.5,-0.014950000000000005,29.0
4551,26565,-9055,14,16,30,46.67,0.004230000000000001,27.7
4552,2900,-5000,3,6,9,33.33,-0.019033333333333333,34.55555555555556
4555,2494,-5704,3,5,8,37.5,-0.016375000000000004,38.625
4557,2489,-3579,2,3,5,40.0,-0.006359999999999999,8.4
4560,3478,-14978,4,7,11,36.36,-0.02022727272727273,12.272727272727273
4562,1257,16113,4,3,7,57.14,0.07699999999999999,66.57142857142857
4564,3818,-22118,4,13,17,23.53,-0.02993529411764706,17.294117647058822
4566,2986,-10846,3,8,11,27.27,-0.02144545454545455,20.545454545454547
4571,4128,-56818,1,6,7,14.29,-0.06997142857142859,17.0
4572,6863,-9123,5,6,11,45.45,-0.00018181818181817945,13.818181818181818
4576,6868,26192,5,6,11,45.45,0.01926363636363636,23.454545454545453
4581,437,-6607,0,2,2,0.0,-0.08224999999999999,15.5
4720,2984,276,13,19,32,40.62,-0.0071375000000000015,31.71875
4722,3351,-10391,12,15,27,44.44,-0.005566666666666668,31.77777777777778
4737,4869,8461,6,7,13,46.15,0.019784615384615383,60.46153846153846
4739,21886,-125536,14,35,49,28.57,-0.03140816326530613,19.306122448979593
4746,15758,-20798,16,25,41,39.02,-0.014765853658536582,18.926829268292682
4755,3880,38340,4,2,6,66.67,0.04441666666666667,23.333333333333332
4763,6568,-50918,2,7,9,22.22,-0.050544444444444434,62.888888888888886
4764,2388,-27068,0,6,6,0.0,-0.06508333333333334,19.833333333333332
4766,5057,-7207,2,4,6,33.33,-0.007200000000000001,24.0
4807,1123,-3513,2,5,7,28.57,-0.011657142857142856,61.857142857142854
4904,3138,-16738,2,9,11,18.18,-0.03398181818181818,30.0
4906,16842,46158,29,34,63,46.03,0.007087301587301587,22.3015873015873
4912,20448,113372,15,18,33,45.45,0.009448484848484847,34.24242424242424
4915,9273,2407,14,17,31,45.16,-0.001399999999999999,29.387096774193548
4916,4833,4617,13,14,27,48.15,0.009840740740740742,14.814814814814815
4919,19211,-53301,20,28,48,41.67,-0.004781250000000001,19.770833333333332
4927,9090,44210,17,11,28,60.71,0.020139285714285717,20.214285714285715
4930,3130,3080,13,13,26,50.0,0.009092307692307693,21.115384615384617
4934,4669,401,20,21,41,48.78,0.0179219512195122,20.682926829268293
4935,11593,55487,15,10,25,60.0,0.034728,28.8
4938,7873,-25603,9,16,25,36.0,-0.016999999999999998,21.68
4942,3681,2369,8,9,17,47.06,0.0051,26.11764705882353
4943,30943,223947,22,14,36,61.11,0.033577777777777776,18.583333333333332
4952,7935,35925,21,12,33,63.64,0.032793939393939396,26.515151515151516
4956,4727,4273,16,18,34,47.06,0.006829411764705881,31.91176470588235
4958,14904,-43274,10,17,27,37.04,-0.01090740740740741,40.666666666666664
4960,4296,-14506,17,24,41,41.46,-0.014112195121951217,22.26829268292683
4961,19079,94551,24,14,38,63.16,0.03388684210526316,16.05263157894737
4967,539,-8109,2,2,4,50.0,-0.1117,1015.75
4968,40745,94165,19,16,35,54.29,0.03464857142857144,24.142857142857142
4976,7750,40380,17,15,32,53.12,0.017350000000000004,16.6875
4977,17845,-7915,13,20,33,39.39,-0.0018242424242424248,17.12121212121212
4989,2525,-4585,7,11,18,38.89,-0.04371666666666667,100.22222222222223
4994,22469,67121,11,16,27,40.74,7.40740740740708e-05,38.03703703703704
4999,2819,-7249,4,6,10,40.0,-0.01586,35.4
5007,3115,-4465,7,7,14,50.0,0.0005500000000000034,22.571428571428573
5203,32956,-6796,21,28,49,42.86,-0.0011081632653061214,14.551020408163266
5215,10183,42247,13,11,24,54.17,0.033737500000000004,28.5
5225,4001,-6681,6,14,20,30.0,-0.02483,26.75
5234,10951,73309,18,10,28,64.29,0.03357857142857143,20.357142857142858
5243,7765,-10095,12,17,29,41.38,-0.005089655172413792,22.655172413793103
5258,4328,5692,10,14,24,41.67,0.0011000000000000038,16.208333333333332
5269,252936,74504,26,35,61,42.62,-0.006895081967213115,18.59016393442623
5283,6011,-13241,5,12,17,29.41,-0.020258823529411763,21.294117647058822
5284,2289,-18959,1,6,7,14.29,-0.047985714285714284,9.285714285714286
5285,7728,-11748,8,11,19,42.11,-0.005626315789473684,17.157894736842106
5288,11822,34048,10,9,19,52.63,0.01082105263157895,41.0
5388,14695,-16095,24,39,63,38.1,-0.0029714285714285706,23.476190476190474
5434,20474,-34714,20,31,51,39.22,-0.008307843137254902,20.784313725490197
5469,8923,-11853,29,32,61,47.54,-0.006234426229508197,18.016393442622952
5471,22822,-45032,26,37,63,41.27,-0.011452380952380955,23.047619047619047
5484,8017,18303,27,23,50,54.0,0.021078,31.44
5515,4291,-10121,14,23,37,37.84,-0.017586486486486485,26.405405405405407
5519,0,0,0,0,0,0.0,,
5521,3496,15984,25,21,46,54.35,0.020191304347826088,24.47826086956522
5522,15900,-106630,15,35,50,30.0,-0.022795999999999997,20.32
5525,5948,-6168,14,27,41,34.15,-0.016978048780487802,24.365853658536587
5531,7871,-32341,19,30,49,38.78,-0.012918367346938776,30.979591836734695
5533,2891,10079,16,13,29,55.17,0.0229448275862069,28.310344827586206
5534,12965,87725,21,17,38,55.26,0.02997894736842106,35.3421052631579
5538,2319,-3379,5,6,11,45.45,-0.0009272727272727235,22.181818181818183
5546,896,-1566,1,1,2,50.0,-0.017249999999999998,36.0
5607,7268,-1958,16,25,41,39.02,-0.006958536585365856,24.75609756097561
5608,5887,4653,12,19,31,38.71,0.007403225806451613,24.93548387096774
5706,13131,1499,18,29,47,38.3,0.001582978723404256,25.27659574468085
5871,13788,38002,10,9,19,52.63,0.015573684210526318,40.78947368421053
5876,694,-4594,1,2,3,33.33,-0.028266666666666673,48.333333333333336
5880,86,984,1,0,1,100.0,0.0713,171.0
5906,2395,-3585,9,17,26,34.62,-0.02515,18.346153846153847
5907,3194,-5854,6,9,15,40.0,-0.018173333333333333,42.93333333333333
6005,3368,7442,17,23,40,42.5,0.0116425,41.3
6024,0,0,0,0,0,0.0,,
6108,7425,11725,26,27,53,49.06,0.009354716981132074,24.30188679245283
6112,3827,-13227,14,16,30,46.67,-0.005120000000000002,26.966666666666665
6115,4818,-23408,6,14,20,30.0,-0.032600000000000004,20.45
6116,4531,2209,31,36,67,46.27,0.007280597014925375,24.761194029850746
6117,6083,37037,27,24,51,52.94,0.022105882352941177,20.84313725490196
6120,11309,58341,42,37,79,53.16,0.02635443037974684,19.367088607594937
6128,2736,-11476,5,11,16,31.25,-0.02231875,25.0625
6133,4230,12570,22,18,40,55.0,0.0211625,40.9
6136,4180,-22590,9,11,20,45.0,-0.016255000000000002,32.5
6139,7489,-5859,11,20,31,35.48,-0.011645161290322578,32.193548387096776
6141,8180,-5610,21,35,56,37.5,-0.012358928571428573,23.660714285714285
6142,6021,7529,23,29,52,44.23,-0.007992307692307693,28.923076923076923
6152,6962,1308,22,29,51,43.14,0.001615686274509805,26.372549019607842
6153,20065,-30825,39,66,105,37.14,-0.01352190476190476,20.771428571428572
6155,9263,11087,27,30,57,47.37,0.003715789473684216,18.05263157894737
6164,7584,-12564,27,50,77,35.06,-0.01504805194805195,20.038961038961038
6165,7426,16714,28,34,62,45.16,0.004135483870967743,22.419354838709676
6166,13969,27141,26,24,50,52.0,0.013696000000000003,23.2
6168,13817,-4407,34,52,86,39.53,-0.004502325581395347,26.03488372093023
6176,30289,-199679,21,46,67,31.34,-0.032877611940298514,22.955223880597014
6177,5035,-20735,15,27,42,35.71,-0.021092857142857142,39.785714285714285
6183,2718,5262,10,10,20,50.0,0.00981,34.65
6184,1229,2661,3,3,6,50.0,0.012616666666666665,51.0
6189,3258,112,6,8,14,42.86,0.0031357142857142846,26.071428571428573
6191,8505,-13485,22,29,51,43.14,-0.0027941176470588215,23.313725490196077
6192,8260,-60070,6,19,25,24.0,-0.043255999999999996,17.68
6196,19767,-7057,28,32,60,46.67,0.0020183333333333316,26.616666666666667
6197,20029,31791,31,28,59,52.54,0.011606779661016947,19.016949152542374
6201,2476,21874,7,5,12,58.33,0.027224999999999996,45.0
6202,13984,17756,22,25,47,46.81,0.006089361702127659,28.70212765957447
6205,11329,-37509,18,28,46,39.13,-0.011895652173913047,18.5
6206,17923,17367,18,17,35,51.43,0.005582857142857142,25.37142857142857
6209,19520,47220,37,47,84,44.05,0.003109523809523813,19.904761904761905
6213,23409,13021,35,41,76,46.05,0.0005289473684210511,25.342105263157894
6214,8144,-9574,12,19,31,38.71,-0.01363548387096774,32.25806451612903
6215,7181,-11121,23,38,61,37.7,-0.012022950819672133,28.868852459016395
6216,11857,35523,24,27,51,47.06,0.005962745098039217,20.03921568627451
6224,18886,-12606,21,29,50,42.0,-0.010264000000000002,16.82
6225,6139,7911,32,45,77,41.56,-0.009171428571428563,30.415584415584416
6226,4919,-22679,22,43,65,33.85,-0.029255384615384617,27.184615384615384
6230,36983,-2293,35,37,72,48.61,0.013399999999999999,28.555555555555557
6235,10640,25810,33,34,67,49.25,0.022813432835820897,22.26865671641791
6239,24495,-97875,14,38,52,26.92,-0.02659423076923077,21.384615384615383
6243,22673,-19793,47,52,99,47.47,0.011515151515151516,15.93939393939394
6257,7913,-3913,23,26,49,46.94,0.0063938775510204065,27.081632653061224
6269,27783,-13903,37,35,72,51.39,0.008144444444444447,23.194444444444443
6271,55391,-7001,31,40,71,43.66,0.0014225352112676073,15.47887323943662
6277,8935,41575,12,8,20,60.0,0.035245,46.3
6278,24011,-8001,25,33,58,43.1,0.00026034482758620597,21.25862068965517
6281,1946,-16206,2,5,7,28.57,-0.03215714285714285,6.714285714285714
6282,7205,-16205,20,32,52,38.46,-0.013715384615384614,25.384615384615383
6283,11561,22239,35,36,71,49.3,0.00815633802816901,20.197183098591548
6285,20291,36909,28,25,53,52.83,0.021428301886792456,21.358490566037737
6288,0,0,0,0,0,0.0,,
6405,2437,-1007,7,10,17,41.18,-0.00244705882352941,29.764705882352942
6409,138947,361283,14,16,30,46.67,0.007466666666666666,18.133333333333333
6412,3548,4922,6,5,11,54.55,0.00880909090909091,41.45454545454545
6414,78574,-16194,20,24,44,45.45,0.0007068181818181828,20.75
6415,426302,1078768,21,33,54,38.89,-0.006438888888888888,23.666666666666668
6416,16348,31342,14,14,28,50.0,0.013892857142857143,33.25
6431,1979,4421,9,8,17,52.94,0.00768235294117647,20.470588235294116
6438,8313,-18953,7,11,18,38.89,-0.015188888888888894,18.055555555555557
6442,3596,19534,8,5,13,61.54,0.03152307692307692,20.46153846153846
6443,3638,10222,12,15,27,44.44,0.005151851851851851,22.77777777777778
6449,6051,-4911,9,12,21,42.86,-0.006171428571428573,15.095238095238095
6451,22730,60630,15,19,34,44.12,0.010017647058823529,22.647058823529413
6456,30607,-162437,9,29,38,23.68,-0.03415,26.473684210526315
6464,693,-6593,0,1,1,0.0,-0.0536,62.0
6477,6927,-20997,11,19,30,36.67,-0.019909999999999997,9.8
6491,39055,-31185,9,18,27,33.33,-0.00996296296296296,52.851851851851855
6504,18049,-5869,9,10,19,47.37,0.014778947368421055,30.63157894736842
6505,9666,-35406,6,13,19,31.58,-0.02378421052631579,23.736842105263158
6515,23797,-98317,4,8,12,33.33,-0.026583333333333334,19.083333333333332
6525,8329,-659,9,10,19,47.37,0.0005736842105263139,33.36842105263158
6531,68974,-255274,15,21,36,41.67,0.0016055555555555584,20.52777777777778
6533,52378,-42888,12,20,32,37.5,-0.009574999999999998,18.21875
6541,10150,93160,16,6,22,72.73,0.060677272727272746,34.77272727272727
6552,8878,13942,13,11,24,54.17,0.0016749999999999994,12.916666666666666
6558,4221,-9301,9,13,22,40.91,0.0005545454545454552,17.136363636363637
6573,3632,-17412,8,14,22,36.36,-0.02532727272727272,17.59090909090909
6579,4202,5448,4,4,8,50.0,0.013062499999999998,34.625
6581,4877,-26327,3,7,10,30.0,-0.031630000000000005,17.7
6582,12570,129110,9,6,15,60.0,0.031426666666666665,22.666666666666668
6591,8601,-63681,7,16,23,30.43,-0.036047826086956516,37.26086956521739
6592,1226,1554,1,1,2,50.0,0.0076500000000000005,15.0
6598,6718,28232,9,9,18,50.0,0.027338888888888895,18.27777777777778
6605,11562,-39132,8,15,23,34.78,-0.015213043478260874,28.434782608695652
6625,1607,10443,3,3,6,50.0,0.03406666666666667,18.5
6641,382,6118,1,0,1,100.0,0.0913,99.0
6655,326,3774,1,0,1,100.0,0.072,28.0
6666,9417,6963,6,7,13,46.15,-0.005569230769230769,15.461538461538462
6668,5810,12320,7,9,16,43.75,0.009987500000000002,20.0625
6669,91493,-315473,7,13,20,35.0,-0.022285,12.3
6670,12309,27271,5,6,11,45.45,0.01312727272727273,22.727272727272727
6671,0,0,0,0,0,0.0,,
6672,7504,-10334,6,7,13,46.15,0.0011384615384615385,14.538461538461538
6674,1100,10330,5,1,6,83.33,0.04908333333333333,19.166666666666668
6698,3136,21224,8,4,12,66.67,0.038225,13.0
6706,20399,58061,10,10,20,50.0,0.013904999999999997,14.55
6715,7117,-16997,2,7,9,22.22,-0.012877777777777773,11.88888888888889
6743,4391,-10781,3,5,8,37.5,-0.020762499999999996,17.125
6754,0,0,0,0,0,0.0,,
6756,24133,-37723,5,6,11,45.45,0.003463636363636363,22.272727272727273
8011,8295,15615,22,30,52,42.31,0.00331153846153846,67.26923076923077
8016,54939,-156869,30,53,83,36.14,-0.014314457831325301,18.674698795180724
8021,10649,2061,24,26,50,48.0,0.003326000000000001,25.96
8028,0,0,0,0,0,0.0,,
8033,6289,5211,27,34,61,44.26,0.0026770491803278693,20.114754098360656
8039,21008,50682,40,37,77,51.95,0.018137662337662338,23.285714285714285
8046,54733,161677,28,35,63,44.44,0.0007031746031746068,23.952380952380953
8070,28860,45460,23,23,46,50.0,0.0035304347826086956,32.891304347826086
8072,15825,84015,13,10,23,56.52,0.023769565217391302,20.08695652173913
8081,68797,125513,37,40,77,48.05,0.008475324675324676,22.662337662337663
8101,5668,10952,23,30,53,43.4,0.0029000000000000002,16.150943396226417
8103,12002,-26602,21,29,50,42.0,-0.010369999999999999,22.64
8104,0,0,0,0,0,0.0,,
8105,8642,2668,33,44,77,42.86,-0.002042857142857143,20.038961038961038
8110,3391,9119,22,18,40,55.0,0.018234999999999998,31.075
8112,4674,20316,24,16,40,60.0,0.030367500000000002,33.975
8114,23764,52056,18,18,36,50.0,0.00961111111111111,20.194444444444443
8131,4636,23934,13,10,23,56.52,0.028391304347826097,25.347826086956523
8150,4610,-14170,8,14,22,36.36,-0.016154545454545456,23.272727272727273
8163,11512,7058,22,32,54,40.74,-0.0008148148148148132,21.555555555555557
8201,4339,12021,21,17,38,55.26,0.020423684210526316,16.92105263157895
8210,9161,23279,18,20,38,47.37,0.004171052631578945,25.44736842105263
8213,3089,19941,10,4,14,71.43,0.03782142857142857,33.92857142857143
8215,6067,-6257,18,28,46,39.13,-0.0006217391304347829,19.58695652173913
8222,2522,5738,10,10,20,50.0,0.013014999999999999,12.15
8249,5982,4058,17,22,39,43.59,0.002710256410256409,22.435897435897434
8261,20959,-32109,37,54,91,40.66,-0.007649450549450551,17.24175824175824
8271,3118,-27928,5,12,17,29.41,-0.0347235294117647,31.764705882352942
8341,12099,-7289,5,7,12,41.67,-0.0031583333333333337,30.916666666666668
8367,3042,-11642,4,9,13,30.77,-0.024446153846153847,14.0
8374,8694,8866,18,27,45,40.0,-0.008522222222222224,33.24444444444445
8404,3942,-13042,11,11,22,50.0,0.008240909090909089,20.5
8411,2503,-34343,1,7,8,12.5,-0.0592,23.25
8422,12212,-28742,4,7,11,36.36,-0.010481818181818182,25.363636363636363
8429,5815,-1405,10,17,27,37.04,-0.014414814814814816,22.40740740740741
8442,1734,2346,3,3,6,50.0,0.0032333333333333333,7.666666666666667
8443,449,-869,2,3,5,40.0,-0.024999999999999998,32.4
8454,118937,215733,14,10,24,58.33,0.024533333333333338,28.625
8462,8466,53974,5,4,9,55.56,0.03931111111111111,20.333333333333332
8463,2367,-5557,5,9,14,35.71,-0.007135714285714289,17.071428571428573
8464,41105,-167045,8,16,24,33.33,-0.024279166666666668,24.291666666666668
8466,1295,-8655,1,3,4,25.0,-0.046775000000000004,126.75
8467,3465,-15165,5,8,13,38.46,-0.030046153846153847,10.461538461538462
8473,1384,-12414,1,4,5,20.0,-0.04768,24.6
8478,15346,-38476,5,14,19,26.32,-0.00973157894736842,15.421052631578947
8480,0,0,0,0,0,0.0,,
8481,518,4052,1,0,1,100.0,0.0476,7.0
8482,3066,12414,3,2,5,60.0,0.03048,48.0
8488,544,-4824,1,5,6,16.67,-0.054450000000000005,28.833333333333332
8499,7172,-77432,2,9,11,18.18,-0.05557272727272727,23.454545454545453
8926,1326,10224,10,4,14,71.43,0.04719285714285715,30.142857142857142
8940,5118,-23048,13,27,40,32.5,-0.02566,22.125
8996,15626,17244,25,26,51,49.02,0.0073117647058823535,22.41176470588235
9802,17443,-47383,11,17,28,39.29,-0.017210714285714284,15.392857142857142
9902,3098,1192,21,22,43,48.84,0.00451395348837209,21.511627906976745
9904,8183,-51383,11,35,46,23.91,-0.035639130434782604,18.195652173913043
9905,3336,-4766,9,14,23,39.13,-0.01241739130434783,31.0
9906,2067,41813,16,25,41,39.02,0.687660975609756,132.4878048780488
9907,3602,-6112,18,26,44,40.91,-0.02006136363636363,27.113636363636363
9908,1143,-3603,4,9,13,30.77,-0.02243846153846154,24.923076923076923
9910,35656,-117696,17,28,45,37.78,-0.013786666666666662,29.2
9911,4273,-2093,18,28,46,39.13,-0.014617391304347823,23.67391304347826
9912,3308,5762,23,21,44,52.27,0.0067250000000000035,21.568181818181817
9914,50965,-185055,27,37,64,42.19,-0.007454687499999995,25.1875
9917,4337,-13077,5,10,15,33.33,-0.01966666666666667,53.266666666666666
9918,1003,-10343,0,6,6,0.0,-0.0598,9.833333333333334
9919,4576,-18796,14,22,36,38.89,-0.010894444444444444,28.27777777777778
9921,39495,-72595,14,27,41,34.15,-0.01618536585365854,22.463414634146343
9924,4828,4032,12,15,27,44.44,0.0012333333333333322,23.0
9925,1052,-2082,4,4,8,50.0,0.0008875000000000029,29.25
9926,2029,-13699,2,10,12,16.67,-0.039483333333333336,63.25
9927,4335,30975,13,7,20,65.0,0.039935000000000005,26.4
9928,4030,930,20,29,49,40.82,-0.006832653061224492,16.448979591836736
9929,2244,-7574,12,28,40,30.0,-0.037279999999999994,19.925
9930,1578,7972,5,3,8,62.5,0.0276375,21.75
9931,1049,1481,4,6,10,40.0,-0.001919999999999998,40.0
9933,7369,-39359,11,28,39,28.21,-0.028561538461538454,29.897435897435898
9934,5936,17284,18,20,38,47.37,0.012510526315789475,30.68421052631579
9935,5556,6064,28,26,54,51.85,0.012577777777777778,22.296296296296298
9937,1914,-11764,3,8,11,27.27,-0.029109090909090907,33.0
9938,18621,37029,30,32,62,48.39,0.009661290322580647,23.419354838709676
9939,8503,5067,16,19,35,45.71,0.0064857142857142865,29.714285714285715
9940,10178,42772,13,13,26,50.0,0.02006538461538461,30.96153846153846
9941,3868,-10878,5,6,11,45.45,-0.004990909090909092,18.90909090909091
9942,8211,-42611,6,12,18,33.33,-0.03310555555555555,22.333333333333332
9943,3823,667,9,12,21,42.86,0.0011809523809523804,23.476190476190474
9944,6224,-28404,13,25,38,34.21,-0.027481578947368423,23.157894736842106
9945,12375,6265,28,34,62,45.16,-0.002343548387096774,30.983870967741936
9946,2845,585,14,18,32,43.75,0.003293749999999999,20.0625
9955,11363,-3923,22,31,53,41.51,-0.007250943396226415,27.452830188679247
9958,12171,-27761,16,20,36,44.44,0.005483333333333336,15.38888888888889
1312A,1342,248,7,9,16,43.75,-0.0007750000000000022,32.0
2002A,944,-6064,1,3,4,25.0,-0.03280000000000001,31.0
2836A,0,0,0,0,0,0.0,,
2838A,0,0,0,0,0,0.0,,
2881A,0,0,0,0,0,0.0,,
2881B,0,0,0,0,0,0.0,,
2882A,0,0,0,0,0,0.0,,
2882B,0,0,0,0,0,0.0,,
2887E,0,0,0,0,0,0.0,,
2887F,0,0,0,0,0,0.0,,
2888A,0,0,0,0,0,0.0,,
2888B,0,0,0,0,0,0.0,,
2891B,0,0,0,0,0,0.0,,
2891C,0,0,0,0,0,0.0,,
2897A,0,0,0,0,0,0.0,,
3702A,0,0,0,0,0,0.0,,
5871A,0,0,0,0,0,0.0,,
9941A,0,0,0,0,0,0.0,,
1240,2068,-328,3,4,7,42.86,0.0016714285714285698,59.714285714285715
1258,2972,-11092,8,12,20,40.0,-0.026720000000000004,28.35
1259,1367,6483,1,1,2,50.0,0.012300000000000002,17.5
1264,1221,24879,1,0,1,100.0,0.1316,515.0
1268,2866,-28136,0,3,3,0.0,-0.05723333333333333,6.0
1336,3779,13271,18,16,34,52.94,0.011655882352941177,23.058823529411764
1565,117638,-324298,22,29,51,43.14,-0.00034901960784313417,18.980392156862745
1569,12053,-25903,25,39,64,39.06,-0.011531249999999998,19.859375
1570,4855,-18045,20,31,51,39.22,-0.015552941176470587,20.980392156862745
1580,13727,-62257,8,13,21,38.1,-0.01443809523809524,24.142857142857142
1584,4076,-3566,13,21,34,38.24,-0.011908823529411769,20.11764705882353
1586,3071,5619,9,8,17,52.94,0.016194117647058824,20.823529411764707
1591,3580,15580,12,9,21,57.14,0.02943333333333333,29.571428571428573
1593,6808,-57728,6,14,20,30.0,-0.032895,20.8
1595,3356,-4456,4,7,11,36.36,-0.014454545454545454,27.454545454545453
1599,2329,-739,4,5,9,44.44,0.0005444444444444416,31.333333333333332
1742,4706,10464,18,16,34,52.94,0.005235294117647064,48.88235294117647
1752,6994,-17744,14,19,33,42.42,-0.011742424242424243,22.0
1777,7600,-13910,11,14,25,44.0,-0.007627999999999999,43.2
1781,10750,5550,30,38,68,44.12,-0.005232352941176469,19.823529411764707
1784,11988,10792,20,25,45,44.44,0.003326666666666666,20.733333333333334
1785,25551,121709,24,34,58,41.38,0.004434482758620691,21.689655172413794
1788,5557,-19817,3,8,11,27.27,-0.02405454545454546,66.45454545454545
1796,2828,14192,6,4,10,60.0,0.02295,45.3
1799,6056,-29836,17,34,51,33.33,-0.023517647058823535,20.098039215686274
1813,5226,-17346,8,18,26,30.77,-0.023607692307692305,23.192307692307693
1815,5510,15600,26,27,53,49.06,0.013209433962264152,24.50943396226415
2035,4493,-9163,8,14,22,36.36,-0.010686363636363636,12.090909090909092
2061,1598,4182,8,8,16,50.0,0.014925,56.75
2063,3051,5819,6,8,14,42.86,0.00018571428571428756,29.214285714285715
2064,878,-8518,2,6,8,25.0,-0.051612500000000006,10.75
2065,935,-15485,0,4,4,0.0,-0.09209999999999999,28.0
2066,8672,-32912,4,9,13,30.77,-0.027861538461538462,19.23076923076923
2067,961,-3621,3,9,12,25.0,-0.02740833333333333,30.0
2070,2377,-7357,3,6,9,33.33,-0.014100000000000001,35.888888888888886
2221,6370,4820,22,26,48,45.83,-0.0008854166666666675,21.583333333333332
2230,2802,-8262,11,17,28,39.29,-0.019664285714285714,14.642857142857142
2235,5272,-57512,1,9,10,10.0,-0.061919999999999996,19.9
2596,628,-1908,2,3,5,40.0,-0.011720000000000003,21.0
2640,6802,30878,8,5,13,61.54,0.030723076923076915,23.46153846153846
2641,2615,10235,12,12,24,50.0,0.02422083333333333,15.25
2643,4308,-25508,2,9,11,18.18,-0.04204545454545455,18.09090909090909
2718,1186,-11806,2,5,7,28.57,-0.05172857142857142,62.42857142857143
2719,2288,-9788,7,18,25,28.0,-0.042436,36.6
2724,2017,11463,8,10,18,44.44,-0.0001833333333333355,37.0
2726,1460,-6680,3,4,7,42.86,-0.028357142857142862,18.0
2729,6517,4333,3,2,5,60.0,0.002900000000000001,32.8
2732,11077,52693,8,8,16,50.0,0.011149999999999998,41.125
2734,4499,-10129,15,19,34,44.12,-0.011241176470588232,12.470588235294118
2736,1260,1070,7,6,13,53.85,0.01174615384615385,27.076923076923077
2740,1921,-801,8,7,15,53.33,0.006913333333333331,13.066666666666666
2743,4525,4625,10,12,22,45.45,0.00029090909090909167,18.90909090909091
2745,4599,-779,10,11,21,47.62,-0.0036904761904761937,32.666666666666664
2752,1034,-12034,0,1,1,0.0,-0.065,28.0
2754,859,-159,1,1,2,50.0,0.0012500000000000011,45.5
2755,471,-2471,0,1,1,0.0,-0.0301,39.0
2916,1340,-8130,4,7,11,36.36,-0.027963636363636357,45.54545454545455
2924,726,9704,2,1,3,66.67,0.0562,63.666666666666664
2926,4296,45634,3,2,5,60.0,0.052059999999999995,40.0
2937,1653,-1273,5,5,10,50.0,0.007190000000000002,61.7
3064,30290,93860,37,40,77,48.05,0.0227,22.83116883116883
3066,5852,-4042,25,38,63,39.68,-0.005555555555555557,20.063492063492063
3067,4401,-14761,12,24,36,33.33,-0.02283888888888889,32.333333333333336
3071,6191,-7001,27,39,66,40.91,-0.0036424242424242413,15.757575757575758
3073,7199,-35779,22,40,62,35.48,-0.027340322580645164,21.274193548387096
3078,8170,18310,28,23,51,54.9,0.025109803921568627,25.431372549019606
3081,59827,-24887,16,20,36,44.44,0.0017277777777777803,16.666666666666668
3083,46896,31674,39,40,79,49.37,0.01417341772151899,23.063291139240505
3085,6746,-16,28,41,69,40.58,-0.011920289855072463,27.434782608695652
3086,14154,-30094,42,47,89,47.19,0.009612359550561797,22.179775280898877
3088,10420,-6920,17,22,39,43.59,-0.0022307692307692297,32.205128205128204
3089,7292,8098,30,41,71,42.25,-0.0012549295774647864,21.52112676056338
3092,8270,-10600,17,20,37,45.95,0.011594594594594594,25.135135135135137
3093,8792,-48322,6,18,24,25.0,-0.031275000000000004,21.458333333333332
3095,11556,-21306,34,53,87,39.08,-0.020733333333333333,20.597701149425287
3105,45544,68306,23,22,45,51.11,0.011124444444444445,20.488888888888887
3114,4464,-1834,18,21,39,46.15,-0.006046153846153846,48.64102564102564
3115,4733,-7203,16,31,47,34.04,-0.019857446808510638,21.872340425531913
3118,6176,-12006,10,21,31,32.26,-0.01856774193548387,36.29032258064516
3122,5193,-27533,10,24,34,29.41,-0.03857941176470587,18.735294117647058
3128,7114,1816,22,36,58,37.93,-0.007213793103448275,17.24137931034483
3131,50642,-56012,15,19,34,44.12,-0.0006852941176470592,16.705882352941178
3141,14000,56750,12,21,33,36.36,-0.0037242424242424263,22.78787878787879
3147,4865,-5635,12,15,27,44.44,-0.001955555555555554,20.85185185185185
3152,68716,218074,26,20,46,56.52,0.029106521739130423,15.826086956521738
3162,5817,-8317,20,27,47,42.55,-0.005095744680851067,32.61702127659574
3163,13839,161,19,28,47,40.43,-0.006525531914893615,21.872340425531913
3169,14350,118530,23,16,39,58.97,0.025248717948717945,22.28205128205128
3171,3556,-4526,17,24,41,41.46,-0.005039024390243904,19.21951219512195
3176,30918,-82488,17,28,45,37.78,-0.00905333333333333,13.28888888888889
3178,11098,-22698,30,49,79,37.97,-0.014855696202531646,16.27848101265823
3188,7444,57336,33,21,54,61.11,0.03339074074074074,18.87037037037037
3191,8066,8134,32,32,64,50.0,0.011560937500000004,15.40625
3202,0,0,0,0,0,0.0,,
3205,639,-7149,4,2,6,66.67,-0.016283333333333334,931.8333333333334
3206,5056,6294,17,18,35,48.57,0.015931428571428572,20.085714285714285
3207,6661,-24851,24,43,67,35.82,-0.018755223880597013,18.34328358208955
3211,23644,-51574,16,28,44,36.36,-0.013218181818181816,19.65909090909091
3213,13761,-53891,10,19,29,34.48,-0.021237931034482755,22.275862068965516
3217,12641,-21251,22,28,50,44.0,-0.009264,22.08
3218,41012,5368,35,38,73,47.95,0.011364383561643838,23.863013698630137
3219,4407,83213,20,13,33,60.61,0.32314242424242423,141.78787878787878
3221,10261,13029,29,32,61,47.54,0.012599999999999995,23.21311475409836
3224,8353,-2513,27,34,61,44.26,-0.0029098360655737707,20.81967213114754
3226,5902,-16842,13,19,32,40.62,-0.010068749999999996,25.40625
3227,61897,124563,33,34,67,49.25,0.007885074626865668,20.925373134328357
3228,63613,232877,35,52,87,40.23,0.0017413793103448285,16.114942528735632
3230,3758,-4048,12,25,37,32.43,-0.027283783783783787,26.324324324324323
3232,7968,-6148,29,29,58,50.0,0.009953448275862066,28.5
3234,11036,-36766,17,33,50,34.0,-0.015896,22.66
3236,8287,5333,28,39,67,41.79,0.0009417910447761192,24.776119402985074
3252,6704,-24694,22,45,67,32.84,-0.02906865671641791,21.28358208955224
3259,7701,-8551,23,30,53,43.4,-0.00044716981132075236,18.50943396226415
3260,23526,66464,31,29,60,51.67,0.020696666666666665,23.166666666666668
3264,9394,-3064,22,32,54,40.74,-0.0007537037037037055,23.666666666666668
3265,9014,-14314,29,34,63,46.03,-0.003739682539682542,21.555555555555557
3268,17175,-12575,32,46,78,41.03,-0.0012487179487179474,16.358974358974358
3272,8817,80653,17,10,27,62.96,0.047607407407407404,35.48148148148148
3276,4895,13235,32,27,59,54.24,0.019966101694915254,25.83050847457627
3284,2988,-10168,14,21,35,40.0,-0.016191428571428572,18.17142857142857
3285,4120,3160,13,18,31,41.94,-0.0028999999999999963,34.483870967741936
3287,4972,-5912,22,30,52,42.31,-0.002176923076923075,14.326923076923077
3288,15074,26776,36,50,86,41.86,-0.007113953488372092,16.546511627906977
3289,19915,-77665,17,39,56,30.36,-0.025453571428571426,20.089285714285715
3290,6358,2372,29,32,61,47.54,0.009793442622950815,14.704918032786885
3293,104991,-320271,27,40,67,40.3,-0.003767164179104477,24.55223880597015
3294,7444,8006,26,34,60,43.33,-0.004115,23.916666666666668
3297,5899,-32939,11,27,38,28.95,-0.036771052631578954,21.157894736842106
3303,5802,-6252,13,23,36,36.11,-0.017399999999999995,26.916666666666668
3306,12180,13700,27,34,61,44.26,-0.0021704918032786863,25.278688524590162
3310,4340,3800,17,20,37,45.95,0.005067567567567566,17.054054054054053
3313,10103,-4263,29,33,62,46.77,0.0009435483870967739,24.14516129032258
3317,17612,79588,34,35,69,49.28,0.014866666666666663,19.28985507246377
3322,3430,-1320,16,19,35,45.71,0.00162,16.857142857142858
3323,9837,14923,21,23,44,47.73,0.013950000000000002,17.613636363636363
3324,34308,53302,35,52,87,40.23,-0.0010218390804597687,20.7816091954023
3325,7017,40823,25,23,48,52.08,0.01740625,21.833333333333332
3332,2382,-1392,4,7,11,36.36,-0.009136363636363637,31.272727272727273
3339,7746,12034,34,36,70,48.57,0.0034242857142857126,19.985714285714284
3354,6969,2461,30,38,68,44.12,0.002044117647058824,22.705882352941178
3360,4752,8868,26,22,48,54.17,0.021764583333333334,24.458333333333332
3362,15529,41481,34,34,68,50.0,0.012638235294117646,19.36764705882353
3363,5780,-8810,13,20,33,39.39,-0.010524242424242422,28.90909090909091
3372,3960,-11390,16,29,45,35.56,-0.01527333333333333,18.2
3373,10018,-5298,21,21,42,50.0,0.012895238095238095,22.857142857142858
3374,17362,65898,23,16,39,58.97,0.03438461538461539,20.46153846153846
3379,2858,19682,8,11,19,42.11,0.008852631578947369,55.05263157894737
3388,12807,28903,11,12,23,47.83,0.0013260869565217387,16.08695652173913
3390,4225,-6885,12,18,30,40.0,-0.012426666666666667,39.166666666666664
3402,4853,16567,15,15,30,50.0,0.007133333333333334,23.633333333333333
3426,1189,-6459,2,2,4,50.0,0.005149999999999995,153.5
3434,3812,2358,18,24,42,42.86,-0.0034000000000000015,24.642857142857142
3438,31160,-2210,20,39,59,33.9,-0.021308474576271177,21.338983050847457
3441,11189,12691,26,29,55,47.27,0.009049090909090908,22.70909090909091
3444,5380,-36930,10,22,32,31.25,-0.03903125,19.59375
3455,12418,-40918,19,31,50,38.0,-0.014787999999999999,25.42
3465,7230,-4290,19,29,48,39.58,-0.01855,18.8125
3466,8551,14719,16,26,42,38.1,-0.00956904761904762,19.476190476190474
3479,8798,35672,17,11,28,60.71,0.023542857142857147,27.464285714285715
3483,21334,84956,26,29,55,47.27,0.01129090909090909,24.854545454545455
3484,10433,32447,22,19,41,53.66,0.016697560975609753,36.170731707317074
3489,3297,6583,15,19,34,44.12,0.0023852941176470575,51.38235294117647
3490,13427,-3127,20,33,53,37.74,-0.007756603773584907,19.547169811320753
3491,22915,-8275,22,26,48,45.83,0.00036249999999999824,21.458333333333332
3492,3217,-11017,8,12,20,40.0,-0.020469999999999995,16.4
3498,16922,146928,33,26,59,55.93,0.032277966101694915,24.983050847457626
3499,6411,21879,32,25,57,56.14,0.01660350877192983,15.842105263157896
3508,24853,47107,35,44,79,44.3,0.0047113924050632885,21.025316455696203
3511,12345,-45295,23,39,62,37.1,-0.022390322580645158,16.725806451612904
3512,6946,38614,23,23,46,50.0,0.021006521739130438,26.630434782608695
3516,1956,2564,10,14,24,41.67,-0.002287499999999998,69.45833333333333
3520,11452,10508,29,33,62,46.77,0.002522580645161291,14.435483870967742
3521,5612,24338,23,29,52,44.23,0.005701923076923077,29.865384615384617
3522,6132,2648,20,30,50,40.0,-0.005638000000000001,25.52
3523,7119,-9729,18,25,43,41.86,-0.00208139534883721,24.674418604651162
3526,25784,-119924,18,34,52,34.62,-0.019138461538461535,21.28846153846154
3527,44355,36035,30,31,61,49.18,0.008757377049180327,18.491803278688526
3529,202624,216256,27,34,61,44.26,0.0009344262295081956,17.57377049180328
3531,4418,-4008,12,18,30,40.0,-0.01104,38.13333333333333
3537,4279,-15869,9,15,24,37.5,-0.02638333333333333,31.083333333333332
3540,12859,-63969,21,35,56,37.5,-0.019075,19.053571428571427
3541,16680,22660,15,15,30,50.0,0.012773333333333334,20.866666666666667
3546,31854,-23014,27,26,53,50.94,0.011735849056603773,21.943396226415093
3548,13361,36109,24,27,51,47.06,0.011427450980392157,20.686274509803923
3551,7797,10293,15,14,29,51.72,0.006893103448275863,26.03448275862069
3552,64291,-79901,25,39,64,39.06,-0.002831250000000002,25.6875
3555,6185,18095,19,19,38,50.0,0.010315789473684205,26.894736842105264
3556,17001,44359,20,20,40,50.0,0.014470000000000002,25.7
3558,15233,37217,8,8,16,50.0,0.01815,32.625
3564,4914,-5974,9,12,21,42.86,-0.006647619047619048,16.523809523809526
3567,2309,441,8,11,19,42.11,-0.013721052631578945,16.842105263157894
3570,12875,1775,14,17,31,45.16,-0.0034096774193548385,33.74193548387097
3577,8630,41200,18,13,31,58.06,0.026770967741935485,15.838709677419354
3580,7951,33659,24,19,43,55.81,0.03414418604651163,22.511627906976745
3581,1569,-3809,6,8,14,42.86,-0.005585714285714286,16.642857142857142
3587,17863,-95433,12,29,41,29.27,-0.02989268292682927,18.048780487804876
3594,5775,-9965,12,16,28,42.86,-0.012214285714285716,33.0
3597,0,0,0,0,0,0.0,,
3609,3111,17199,11,8,19,57.89,0.015926315789473688,33.05263157894737
3611,31830,82510,14,14,28,50.0,0.006432142857142857,27.607142857142858
3615,14280,-40430,21,29,50,42.0,-0.007093999999999996,27.62
3623,5860,-540,16,19,35,45.71,-0.006374285714285715,25.057142857142857
3624,10418,20002,24,26,50,48.0,0.008459999999999999,22.88
3625,5345,4005,21,24,45,46.67,0.006886666666666667,19.511111111111113
3628,10279,15611,9,12,21,42.86,0.007295238095238098,17.80952380952381
3629,5691,23609,21,15,36,58.33,0.030052777777777786,19.694444444444443
3630,22248,34622,26,39,65,40.0,0.0015723076923076906,21.107692307692307
3631,6319,36611,16,12,28,57.14,0.03016785714285714,17.178571428571427
3632,6873,-3263,16,26,42,38.1,-0.021228571428571427,21.833333333333332
3642,4427,-10177,15,23,38,39.47,-0.018573684210526315,28.973684210526315
3646,2375,6035,10,9,19,52.63,0.014294736842105263,36.89473684210526
3652,4383,-5953,11,18,29,37.93,-0.010013793103448276,24.137931034482758
3663,4107,-20337,9,18,27,33.33,-0.027948148148148146,29.666666666666668
3664,5332,16178,21,24,45,46.67,0.004346666666666662,20.444444444444443
3666,5812,21818,20,13,33,60.61,0.038821212121212124,14.969696969696969
3672,2807,12423,13,8,21,61.9,0.03475714285714286,10.714285714285714
3675,22286,11724,18,20,38,47.37,0.010252631578947364,22.44736842105263
3680,40164,-59384,19,22,41,46.34,-0.0008121951219512177,17.804878048780488
3684,4896,-11956,7,10,17,41.18,-0.00963529411764706,27.705882352941178
3685,5447,-3627,16,15,31,51.61,0.009996774193548386,15.516129032258064
3687,35815,-52865,22,32,54,40.74,-0.005925925925925929,15.277777777777779
3689,4148,20912,11,6,17,64.71,0.031,44.1764705882353
3691,91443,239197,27,27,54,50.0,0.014109259259259259,24.22222222222222
3693,14438,-13178,11,18,29,37.93,-0.0095448275862069,22.275862068965516
3707,13571,-4131,19,27,46,41.3,-0.008710869565217392,15.41304347826087
3709,650,-1770,2,2,4,50.0,-0.0013999999999999985,28.0
3710,1314,3926,7,12,19,36.84,0.0059157894736842145,24.526315789473685
3713,637,-847,1,2,3,33.33,-0.019266666666666665,11.0
4102,9466,-34756,23,32,55,41.82,-0.012921818181818184,22.70909090909091
4105,25064,-166074,12,35,47,25.53,-0.04122978723404255,25.72340425531915
4107,22502,52338,34,32,66,51.52,0.010536363636363637,32.166666666666664
4109,6333,-6123,22,27,49,44.9,-0.002191836734693879,23.6734693877551
4111,5441,-17901,15,27,42,35.71,-0.015857142857142858,23.666666666666668
4113,4014,-4364,20,27,47,42.55,-0.010753191489361704,16.425531914893618
4114,8999,-16999,23,32,55,41.82,-0.008332727272727273,21.78181818181818
4116,3009,10901,5,5,10,50.0,0.019679999999999996,44.3
4120,13108,-19668,18,27,45,40.0,-0.012108888888888888,16.822222222222223
4121,6986,-12046,25,39,64,39.06,-0.016104687500000003,29.375
4123,14917,26603,22,25,47,46.81,0.002897872340425534,16.53191489361702
4126,12954,3246,16,17,33,48.48,0.00547878787878788,22.696969696969695
4127,6268,5472,25,30,55,45.45,0.0027036363636363647,26.945454545454545
4128,13145,-14375,25,30,55,45.45,0.0059854545454545455,22.12727272727273
4129,10654,38206,26,21,47,55.32,0.019697872340425526,16.659574468085108
4130,8902,6798,19,19,38,50.0,0.013407894736842105,24.605263157894736
4131,598,-14678,3,6,9,33.33,-0.28049999999999997,706.3333333333334
4138,9906,-64666,5,14,19,26.32,-0.0326,32.31578947368421
4139,5210,28680,8,5,13,61.54,0.05641538461538461,33.23076923076923
4147,18572,-5942,9,13,22,40.91,-0.00878181818181818,28.136363636363637
4153,7537,36723,13,12,25,52.0,0.018259999999999995,20.08
4154,3675,17475,10,10,20,50.0,0.019039999999999998,26.1
4157,3137,-6667,9,15,24,37.5,-0.020137500000000003,31.875
4160,5289,-17789,11,18,29,37.93,-0.01919655172413793,22.17241379310345
4161,7865,-865,9,12,21,42.86,0.005952380952380951,45.666666666666664
4162,29286,38094,17,17,34,50.0,0.007473529411764709,18.764705882352942
4163,15073,54327,11,8,19,57.89,0.01873684210526316,13.421052631578947
4167,2511,-26541,3,15,18,16.67,-0.06149444444444444,46.833333333333336
4168,9730,54100,18,14,32,56.25,0.019596875,16.6875
4171,15532,7538,13,21,34,38.24,-0.0013941176470588217,19.735294117647058
4173,2365,7985,7,9,16,43.75,0.010374999999999997,44.9375
4174,39189,-135329,14,16,30,46.67,-0.007920000000000002,18.366666666666667
4175,2195,-16755,1,4,5,20.0,-0.0441,53.2
4183,1177,-5797,3,7,10,30.0,-0.031069999999999997,17.2
4188,1911,7149,5,7,12,41.67,0.024658333333333334,42.083333333333336
4192,4803,-10723,8,11,19,42.11,-0.004047368421052634,17.42105263157895
4198,1846,-7666,8,15,23,34.78,-0.0022565217391304336,22.26086956521739
4205,350,-2370,1,2,3,33.33,-0.043300000000000005,59.333333333333336
4207,2401,-4251,13,19,32,40.62,-0.007075000000000001,23.09375
4303,5778,-5668,22,29,51,43.14,-0.01419803921568628,25.92156862745098
4304,4955,1355,31,41,72,43.06,-0.004966666666666666,21.75
4305,2500,-23180,4,15,19,21.05,-0.05183684210526316,39.0
4401,13575,-52315,15,25,40,37.5,-0.0210225,23.525
4402,4829,1561,39,44,83,46.99,0.0005132530120481931,17.867469879518072
4406,2783,-4833,15,28,43,34.88,-0.01319302325581395,23.6046511627907
4413,1870,5890,11,21,32,34.38,0.065121875,146.28125
4416,6921,-21211,8,9,17,47.06,-0.011199999999999998,31.529411764705884
4417,4605,15025,17,16,33,51.52,0.01785454545454546,31.424242424242426
4419,6935,-24415,23,33,56,41.07,-0.0168,19.625
4420,2116,27784,6,5,11,54.55,0.05188181818181819,60.81818181818182
4430,2280,-8740,4,7,11,36.36,-0.01787272727272727,58.09090909090909
4432,7255,32795,14,10,24,58.33,0.033508333333333334,39.208333333333336
4433,3851,-15981,7,12,19,36.84,-0.015899999999999997,24.36842105263158
4502,7947,-21337,18,43,61,29.51,-0.033698360655737704,20.852459016393443
4503,7899,-1009,33,52,85,38.82,-0.012036470588235293,18.305882352941175
4506,1921,1009,9,11,20,45.0,-1.999999999999988e-05,23.75
4510,3668,-13568,16,26,42,38.1,-0.009102380952380949,34.476190476190474
4513,3708,-17608,12,34,46,26.09,-0.03994999999999999,28.717391304347824
4523,8809,-8519,21,29,50,42.0,-0.007270000000000002,31.48
4527,2056,2484,7,11,18,38.89,-0.0007055555555555565,26.11111111111111
4528,10703,-83,25,31,56,44.64,-0.003274999999999998,22.482142857142858
4529,7562,-4412,34,38,72,47.22,-0.0036222222222222233,19.22222222222222
4530,5409,-22759,29,46,75,38.67,-0.026046666666666662,17.506666666666668
4533,2018,-168,10,11,21,47.62,0.006823809523809525,28.333333333333332
4534,5240,570,24,31,55,43.64,-0.0009490909090909095,21.618181818181817
4535,3245,-20475,4,7,11,36.36,-0.02347272727272727,19.818181818181817
4538,1127,583,6,6,12,50.0,0.004208333333333332,99.25
4541,2636,10224,8,7,15,53.33,0.026533333333333343,31.933333333333334
4542,2294,-16624,5,11,16,31.25,-0.034425,25.1875
4543,1326,-2016,3,7,10,30.0,-0.01799,15.6
4549,6826,144,6,6,12,50.0,-0.001966666666666664,24.5
4550,664,5976,3,2,5,60.0,0.05582,87.6
4554,2656,-10406,6,11,17,35.29,-0.020982352941176466,14.470588235294118
4556,828,-3498,1,3,4,25.0,-0.0232,48.5
4561,1461,6399,5,3,8,62.5,0.027225,6.125
4563,1367,9093,4,1,5,80.0,0.026780000000000005,32.0
4568,1927,-7307,2,3,5,40.0,-0.0172,14.6
4580,571,-8841,0,1,1,0.0,-0.0925,153.0
4609,4873,-12443,23,38,61,37.7,-0.024701639344262293,26.59016393442623
4702,5423,-513,29,43,72,40.28,-0.008450000000000003,19.02777777777778
4706,2030,-3340,10,15,25,40.0,-0.008936,23.6
4707,3891,14729,19,14,33,57.58,0.003136363636363638,42.121212121212125
4711,1318,2822,7,6,13,53.85,0.011061538461538458,83.38461538461539
4712,6637,653,25,43,68,36.76,-0.01487205882352941,21.294117647058822
4714,4175,-7015,21,28,49,42.86,-0.007434693877551016,24.081632653061224
4716,7352,5438,27,30,57,47.37,0.002615789473684213,22.982456140350877
4721,22865,-100245,21,52,73,28.77,-0.030030136986301366,29.0
4726,7489,12131,14,16,30,46.67,0.0159,22.7
4728,7794,33436,13,15,28,46.43,0.002825,17.75
4729,4742,13888,19,21,40,47.5,0.014429999999999995,23.275
4735,7447,-777,11,24,35,31.43,-0.023888571428571426,24.97142857142857
4736,28167,-15377,14,21,35,40.0,-0.00037142857142857095,15.485714285714286
4741,10677,5403,15,12,27,55.56,0.011207407407407404,17.0
4743,23711,240129,21,20,41,51.22,0.025802439024390247,26.0
4744,10630,-15630,20,26,46,43.48,0.0004195652173913004,26.02173913043478
4745,5411,-23261,6,9,15,40.0,-0.009153333333333336,45.0
4747,1195,-5625,1,3,4,25.0,-0.055400000000000005,403.5
4754,696,2224,1,1,2,50.0,0.014400000000000003,21.0
4760,10162,2198,10,11,21,47.62,0.014480952380952383,14.714285714285714
4767,636,-2726,1,3,4,25.0,-0.027949999999999996,31.5
4804,2512,13268,9,7,16,56.25,0.017268750000000003,24.3125
4806,2269,24761,8,12,20,40.0,-0.008595000000000002,23.05
4903,5804,-6104,34,42,76,44.74,0.00016052631578947362,24.039473684210527
4905,4023,-1893,15,25,40,37.5,-0.0112225,19.275
4907,3274,27356,27,25,52,51.92,0.11060769230769231,90.5
4908,16238,-19448,33,46,79,41.77,-0.006811392405063291,20.0
4909,11357,4303,23,30,53,43.4,-0.007424528301886796,19.60377358490566
4911,8284,10386,10,10,20,50.0,0.006715000000000001,12.25
4924,2430,-15850,8,17,25,32.0,-0.022188000000000003,22.04
4931,3202,-5372,10,13,23,43.48,0.007239130434782603,30.73913043478261
4933,8491,-60751,10,14,24,41.67,-0.016491666666666665,27.375
4939,4283,-5533,15,22,37,40.54,-0.0072351351351351316,16.27027027027027
4944,6677,32033,27,25,52,51.92,0.021948076923076924,19.423076923076923
4945,3639,29931,7,3,10,70.0,0.036449999999999996,18.0
4946,13234,-38914,16,26,42,38.1,-0.015859523809523806,20.11904761904762
4950,2311,569,9,11,20,45.0,0.016359999999999993,21.3
4953,11346,-36196,13,16,29,44.83,-0.013544827586206898,25.310344827586206
4966,239107,1543,26,34,60,43.33,0.0002300000000000022,19.35
4971,18076,12434,19,20,39,48.72,0.007269230769230763,29.17948717948718
4972,1571,-14071,1,7,8,12.5,-0.05215,24.5
4973,2866,-7026,6,10,16,37.5,-0.024162499999999996,23.125
4974,4440,19030,10,7,17,58.82,0.019147058823529413,32.0
4979,12965,5995,26,30,56,46.43,0.0066857142857142835,20.535714285714285
4987,3702,-3922,3,6,9,33.33,-0.01578888888888889,21.22222222222222
4991,9498,18572,12,13,25,48.0,0.008484000000000002,18.6
4995,2789,-12239,3,9,12,25.0,-0.021391666666666666,23.5
5009,9931,-19281,27,41,68,39.71,-0.009652941176470592,29.13235294117647
5011,256,19834,4,0,4,100.0,3.0129249999999996,1592.5
5013,3542,-15322,8,22,30,26.67,-0.02626333333333333,24.966666666666665
5014,4601,-20871,20,30,50,40.0,-0.015173999999999998,30.08
5015,2857,-5087,8,13,21,38.1,-0.014199999999999999,25.285714285714285
5016,2497,-9107,7,11,18,38.89,-0.02394444444444444,54.22222222222222
5201,6161,12229,27,29,56,48.21,0.013435714285714289,23.25
5202,5935,-10695,31,41,72,43.06,-0.008752777777777781,21.694444444444443
5205,1061,-18501,8,9,17,47.06,-0.06746470588235294,340.6470588235294
5206,3367,-8807,21,37,58,36.21,-0.03438793103448276,20.5
5209,4937,-14777,10,18,28,35.71,-0.017796428571428578,25.357142857142858
5210,4014,-9094,24,31,55,43.64,-0.010549090909090912,14.945454545454545
5211,11099,22361,23,32,55,41.82,-0.002565454545454546,29.454545454545453
5212,7251,-23091,21,27,48,43.75,-0.008602083333333331,33.458333333333336
5213,4431,13819,21,19,40,52.5,0.011150000000000002,19.625
5220,2127,25373,9,2,11,81.82,0.0645090909090909,113.36363636363636
5223,4757,43303,10,4,14,71.43,0.058992857142857145,19.357142857142858
5227,7901,-34481,18,23,41,43.9,7.07317073170691e-05,23.78048780487805
5230,5912,22198,10,8,18,55.56,0.01849444444444445,19.833333333333332
5245,15789,8631,13,22,35,37.14,-0.016457142857142858,19.82857142857143
5251,3115,-15075,6,12,18,33.33,-0.016533333333333337,24.88888888888889
5263,46865,-331125,9,23,32,28.12,-0.0284125,21.65625
5272,9832,-9762,16,25,41,39.02,-0.0067536585365853665,20.51219512195122
5274,425074,-1131654,22,48,70,31.43,-0.025022857142857142,17.542857142857144
5276,1582,3158,8,8,16,50.0,0.01111875,34.5625
5278,17499,23501,18,18,36,50.0,0.006725000000000002,14.5
5281,5061,8399,11,12,23,47.83,0.004986956521739129,21.17391304347826
5287,23915,-133975,5,9,14,35.71,-0.0306,30.0
5289,13601,9219,9,9,18,50.0,0.004327777777777779,20.333333333333332
5291,2362,-11592,5,12,17,29.41,-0.03708235294117647,27.41176470588235
5299,22763,58977,20,22,42,47.62,0.017528571428571428,34.904761904761905
5301,6051,-13901,25,35,60,41.67,-0.0038950000000000005,17.616666666666667
5302,7560,-6080,39,52,91,42.86,-0.00685934065934066,17.978021978021978
5306,22833,-24293,40,34,74,54.05,0.017989189189189188,19.22972972972973
5309,8543,-5183,38,42,80,47.5,0.0021262499999999984,23.35
5310,9784,23106,35,38,73,47.95,0.010716438356164383,16.506849315068493
5312,11865,-58315,13,25,38,34.21,-0.021276315789473685,27.105263157894736
5314,5179,5521,37,39,76,48.68,0.0013052631578947358,20.026315789473685
5315,6124,-3844,33,42,75,44.0,-0.0029079999999999996,22.733333333333334
5321,14853,9937,47,44,91,51.65,0.01304945054945055,14.56043956043956
5324,4265,9985,22,26,48,45.83,-0.0032125000000000005,20.875
5328,4634,-3854,30,38,68,44.12,-0.004164705882352941,21.058823529411764
5340,5616,40714,35,25,60,58.33,0.027863333333333334,23.85
5344,6118,1882,31,44,75,41.33,-0.014161333333333337,17.826666666666668
5345,5322,5398,41,44,85,48.24,0.005034117647058825,17.152941176470588
5347,19534,-17444,37,42,79,46.84,0.0021746835443037953,21.481012658227847
5348,5589,-16559,21,42,63,33.33,-0.034680952380952396,17.555555555555557
5351,15925,-4245,45,64,109,41.28,-0.002122018348623853,18.38532110091743
5353,5344,2976,25,37,62,40.32,-0.003937096774193546,23.629032258064516
5355,4829,17301,28,30,58,48.28,0.009005172413793103,24.620689655172413
5356,4552,-202,16,17,33,48.48,0.014736363636363641,23.666666666666668
5364,6296,7324,26,37,63,41.27,-0.006888888888888889,26.158730158730158
5371,14079,-8309,26,39,65,40.0,-0.0038738461538461544,27.092307692307692
5381,5145,5085,45,45,90,50.0,0.007577777777777776,18.72222222222222
5383,6018,33652,34,28,62,54.84,0.027725806451612902,26.322580645161292
5386,10264,-17634,20,33,53,37.74,-0.003339622641509436,18.830188679245282
5392,36001,199419,40,45,85,47.06,0.016921176470588235,22.32941176470588
5398,6900,-13490,27,39,66,40.91,-0.007877272727272728,23.0
5403,1685,-10305,3,9,12,25.0,-0.025275000000000002,22.416666666666668
5410,3544,-8154,20,31,51,39.22,-0.0084921568627451,16.11764705882353
5425,20654,-44154,39,57,96,40.62,-0.008020833333333336,19.395833333333332
5426,2858,-3948,15,21,36,41.67,-0.016527777777777777,20.02777777777778
5432,5716,-2366,28,37,65,43.08,0.004570769230769232,18.323076923076922
5438,4674,-19314,9,18,27,33.33,-0.021481481481481483,53.2962962962963
5439,6634,-1294,18,22,40,45.0,-0.0016699999999999985,35.5
5443,10214,-19504,34,56,90,37.78,-0.01781333333333333,17.27777777777778
5450,4371,22639,21,23,44,47.73,0.016265909090909088,34.29545454545455
5452,6405,-6375,28,36,64,43.75,0.0009281250000000019,20.484375
5455,3776,-6126,26,24,50,52.0,-0.06280399999999998,95.06
5457,19940,-37400,36,43,79,45.57,0.006363291139240504,24.20253164556962
5460,3815,15825,18,17,35,51.43,0.01795714285714286,22.8
5464,5613,10857,20,20,40,50.0,0.011274999999999999,18.25
5465,4925,-2595,26,35,61,42.62,0.0033983606557377037,15.442622950819672
5468,7184,-7684,35,63,98,35.71,-0.029089795918367346,17.489795918367346
5474,22281,159819,35,38,73,47.95,0.008793150684931507,23.726027397260275
5475,5684,2696,36,35,71,50.7,0.005816901408450706,20.154929577464788
5478,40275,132795,41,35,76,53.95,0.018800000000000004,26.657894736842106
5481,5539,10571,20,27,47,42.55,0.005442553191489361,29.29787234042553
5483,45117,32053,44,45,89,49.44,0.015020224719101121,20.191011235955056
5487,5277,-1087,19,24,43,44.19,-0.004165116279069767,20.41860465116279
5488,4996,11494,25,33,58,43.1,0.0033396551724137937,24.17241379310345
5489,5985,-27755,10,18,28,35.71,-0.01848571428571429,28.857142857142858
5490,13479,78821,29,27,56,51.79,0.019148214285714282,21.089285714285715
5493,5550,-22870,16,25,41,39.02,-0.01809268292682927,62.073170731707314
5498,5907,3613,34,44,78,43.59,0.000588461538461535,22.371794871794872
5508,3691,11799,8,8,16,50.0,0.0092,33.375
5511,2467,2963,11,17,28,39.29,-0.004403571428571428,75.32142857142857
5512,4150,20280,26,20,46,56.52,0.032702173913043475,38.76086956521739
5514,4302,-24422,15,34,49,30.61,-0.03275306122448979,21.306122448979593
5516,3907,-20697,12,39,51,23.53,-0.03486862745098039,21.19607843137255
5520,3499,4461,10,12,22,45.45,0.009772727272727273,33.13636363636363
5523,4859,-4439,21,33,54,38.89,-0.01296111111111111,19.962962962962962
5529,6142,128,24,36,60,40.0,-0.005508333333333328,23.083333333333332
5530,9908,22752,16,31,47,34.04,-0.014806382978723399,23.25531914893617
5536,14494,28546,10,6,16,62.5,0.015412499999999999,22.3125
5543,791,-8301,0,4,4,0.0,-0.061849999999999995,12.5
5601,3004,-32664,4,24,28,14.29,-0.061657142857142855,17.107142857142858
5603,3671,-1891,18,20,38,47.37,0.004247368421052634,23.763157894736842
5604,1561,-9491,3,7,10,30.0,-0.03746000000000001,42.5
5609,10526,-23916,18,25,43,41.86,-0.007616279069767441,25.697674418604652
5701,4687,-5537,26,38,64,40.62,-0.004337499999999998,29.625
5703,0,0,0,0,0,0.0,,
5704,4378,-22238,7,20,27,25.93,-0.03189629629629629,28.555555555555557
5820,1718,3662,14,13,27,51.85,0.012196296296296294,22.333333333333332
5864,3168,-1878,15,33,48,31.25,-0.013377083333333336,21.020833333333332
5878,361,3279,1,0,1,100.0,0.0556,6.0
5902,3218,6002,20,25,45,44.44,0.005526666666666667,28.88888888888889
5903,7736,-21806,4,6,10,40.0,-0.005390000000000001,99.7
5904,37367,-36437,14,14,28,50.0,0.00415,34.857142857142854
5905,4704,-4354,22,28,50,44.0,-0.005161999999999997,19.96
6015,3193,4717,18,29,47,38.3,-0.018021276595744675,38.808510638297875
6016,3283,457,24,21,45,53.33,0.003679999999999998,26.57777777777778
6020,2795,-3485,12,14,26,46.15,-0.006265384615384617,42.80769230769231
6021,0,0,0,0,0,0.0,,
6023,1908,-5258,2,5,7,28.57,-0.011028571428571434,31.571428571428573
6026,551,-3361,2,4,6,33.33,-0.034883333333333336,51.666666666666664
6101,8282,-4352,32,39,71,45.07,-0.0030690140845070443,16.830985915492956
6103,7806,-2726,32,44,76,42.11,-0.01367894736842106,23.07894736842105
6104,35779,149421,54,52,106,50.94,0.020746226415094337,16.4811320754717
6109,3348,3302,19,24,43,44.19,-0.0031558139534883737,24.093023255813954
6111,25754,43096,31,38,69,44.93,-0.0004695652173913057,20.246376811594203
6113,5713,29987,41,31,72,56.94,0.032418055555555554,24.27777777777778
6114,1413,-12843,9,12,21,42.86,-0.29786190476190477,225.61904761904762
6118,8564,23886,42,43,85,49.41,0.010164705882352939,19.929411764705883
6121,50416,-85326,22,29,51,43.14,-0.009641176470588236,31.313725490196077
6122,3069,-12789,14,23,37,37.84,-0.022754054054054056,35.5945945945946
6123,8371,-9391,27,29,56,48.21,0.006025000000000001,19.267857142857142
6124,10748,-8068,26,38,64,40.62,-0.005254687500000001,19.109375
6125,9065,-42805,20,37,57,35.09,-0.023017543859649128,28.43859649122807
6126,10466,5074,33,40,73,45.21,0.0006041095890410951,18.561643835616437
6127,9260,21810,46,47,93,49.46,0.01317956989247312,21.172043010752688
6129,11418,-11738,33,53,86,38.37,-0.009286046511627906,22.476744186046513
6130,15232,87318,30,26,56,53.57,0.01890178571428571,17.642857142857142
6134,7129,24231,28,25,53,52.83,0.02029245283018868,23.37735849056604
6138,40621,-42731,41,71,112,36.61,-0.01302767857142857,16.491071428571427
6140,5296,-23866,21,45,66,31.82,-0.028037878787878792,17.681818181818183
6143,19549,101811,39,29,68,57.35,0.02597058823529412,20.764705882352942
6144,4326,-35046,10,48,58,17.24,-0.05552758620689655,24.93103448275862
6146,19903,-8703,11,18,29,37.93,-0.0060620689655172385,24.17241379310345
6147,21068,-63518,31,53,84,36.9,-0.012171428571428574,13.535714285714286
6148,4039,13191,32,29,61,52.46,0.012949180327868853,27.131147540983605
6150,23042,89918,45,50,95,47.37,0.018562105263157894,20.842105263157894
6151,4415,-6845,12,17,29,41.38,-0.008389655172413793,21.310344827586206
6154,4013,4547,12,9,21,57.14,0.013276190476190478,43.23809523809524
6156,8490,5520,36,45,81,44.44,-0.0009790123456790134,18.864197530864196
6158,14974,50206,39,35,74,52.7,0.01910810810810811,19.54054054054054
6160,13520,-560,24,30,54,44.44,-0.007161111111111111,40.2037037037037
6161,5548,1962,23,32,55,41.82,-0.00034181818181818304,23.90909090909091
6163,5868,862,30,33,63,47.62,0.007461904761904762,20.047619047619047
6167,5689,7881,40,44,84,47.62,0.00755714285714286,22.11904761904762
6169,12834,25696,37,44,81,45.68,0.01125185185185185,20.65432098765432
6170,10545,23975,30,38,68,44.12,0.0031882352941176445,23.176470588235293
6171,3131,-19351,9,31,40,22.5,-0.033815,38.325
6173,16072,31728,46,39,85,54.12,0.02013058823529412,17.50588235294118
6174,5972,12238,29,36,65,44.62,0.005009230769230766,26.184615384615384
6175,9503,44377,37,32,69,53.62,0.017760869565217396,20.666666666666668
6179,6130,800,23,27,50,46.0,-0.0030360000000000027,18.42
6180,11821,40059,27,29,56,48.21,0.012269642857142856,31.75
6182,27426,-37766,42,47,89,47.19,-0.002740449438202246,17.752808988764045
6185,5691,25889,18,20,38,47.37,0.014171052631578944,29.973684210526315
6186,5147,30903,26,26,52,50.0,0.02249423076923077,30.75
6187,24951,-2961,38,40,78,48.72,0.00867051282051282,22.794871794871796
6188,17282,-36542,29,27,56,51.79,0.0043999999999999985,34.57142857142857
6190,5581,-19031,23,30,53,43.4,-0.014726415094339617,19.0188679245283
6194,9615,-19015,14,20,34,41.18,-0.012173529411764706,24.676470588235293
6195,10352,-27432,20,30,50,40.0,-0.009236000000000001,18.12
6198,7317,-13967,27,46,73,36.99,-0.010001369863013698,22.589041095890412
6199,5682,-9562,25,35,60,41.67,-0.013866666666666664,21.933333333333334
6203,12560,-38740,12,24,36,33.33,-0.020572222222222224,22.47222222222222
6204,6203,33057,14,14,28,50.0,0.01605,18.464285714285715
6207,7174,27776,22,17,39,56.41,0.013594871794871791,33.282051282051285
6208,7107,-12407,21,34,55,38.18,-0.010952727272727272,24.145454545454545
6210,5604,-4344,17,21,38,44.74,0.004971052631578949,40.026315789473685
6212,3425,16845,13,17,30,43.33,0.0039866666666666705,18.1
6217,14311,-56061,29,49,78,37.18,-0.01611923076923077,24.705128205128204
6218,4127,-7627,11,16,27,40.74,-0.01431851851851852,34.74074074074074
6219,4968,7052,31,32,63,49.21,0.019431746031746033,17.904761904761905
6220,7906,49624,30,24,54,55.56,0.02342962962962963,27.61111111111111
6221,9080,-10270,23,38,61,37.7,-0.017263934426229508,14.311475409836065
6222,4741,-3401,25,36,61,40.98,-0.007221311475409835,27.131147540983605
6223,46047,122693,49,43,92,53.26,0.01988804347826087,21.66304347826087
6227,7126,11544,24,21,45,53.33,0.02296,41.666666666666664
6228,6708,-37408,32,50,82,39.02,-0.025047560975609756,17.317073170731707
6229,9199,29031,37,37,74,50.0,0.011502702702702702,21.87837837837838
6231,38969,-120509,36,53,89,40.45,-0.012425842696629214,22.764044943820224
6233,18785,-34025,44,57,101,43.56,-0.0018386138613861393,19.554455445544555
6234,11407,-4927,20,27,47,42.55,-0.004753191489361705,25.76595744680851
6236,2190,-21410,9,15,24,37.5,-0.21777916666666663,242.83333333333334
6237,44761,142249,48,58,106,45.28,0.008129245283018866,19.254716981132077
6240,4579,10171,21,33,54,38.89,-0.010212962962962967,18.814814814814813
6241,5855,-1625,20,34,54,37.04,-0.01256851851851852,43.25925925925926
6242,6108,2562,20,26,46,43.48,-0.007965217391304347,13.673913043478262
6244,63297,-229587,40,43,83,48.19,0.008469879518072291,21.746987951807228
6245,13615,12325,29,34,63,46.03,0.009419047619047617,20.73015873015873
6246,6085,-11785,30,48,78,38.46,-0.016934615384615385,22.333333333333332
6247,1864,-3124,7,15,22,31.82,-0.019204545454545453,39.04545454545455
6248,5336,-7096,25,33,58,43.1,-0.013324137931034482,24.137931034482758
6259,7881,35079,48,49,97,49.48,0.015684536082474224,16.835051546391753
6261,18432,42708,24,20,44,54.55,0.01645227272727273,20.477272727272727
6263,5656,13744,11,11,22,50.0,0.019713636363636367,20.40909090909091
6264,5641,-16641,21,27,48,43.75,-0.009754166666666668,25.0
6265,2681,5419,16,17,33,48.48,0.0059666666666666705,32.36363636363637
6266,3665,-29015,10,32,42,23.81,-0.045752380952380954,24.785714285714285
6270,4885,-825,12,17,29,41.38,-0.0023275862068965533,31.620689655172413
6274,21301,-18311,30,41,71,42.25,-0.0037943661971830984,28.6056338028169
6275,5976,37454,30,18,48,62.5,0.03523958333333333,27.229166666666668
6276,6243,7257,27,34,61,44.26,-0.000952459016393443,23.39344262295082
6279,21663,-60193,18,25,43,41.86,-0.004909302325581397,22.046511627906977
6284,16027,32083,36,36,72,50.0,0.011633333333333334,25.708333333333332
6287,4596,514,36,43,79,45.57,-0.006244303797468356,19.443037974683545
6290,10233,45097,24,24,48,50.0,0.0189,29.916666666666668
6291,10015,3455,35,59,94,37.23,-0.024626595744680853,14.553191489361701
6292,2453,-3633,9,8,17,52.94,-0.004752941176470592,21.11764705882353
6294,9837,-4267,19,24,43,44.19,-0.009765116279069765,16.72093023255814
6404,4846,24704,18,18,36,50.0,0.02295,19.416666666666668
6411,22450,-83790,14,21,35,40.0,-0.00998285714285714,22.742857142857144
6417,468,7592,2,0,2,100.0,0.09215,12.5
6418,2468,-8508,8,16,24,33.33,-0.021275000000000002,20.791666666666668
6419,3259,-7849,11,16,27,40.74,-0.006162962962962965,21.62962962962963
6425,3034,16636,9,5,14,64.29,0.039900000000000005,36.714285714285715
6426,17936,42744,17,18,35,48.57,0.02361142857142857,23.114285714285714
6432,4796,18604,14,13,27,51.85,0.017262962962962963,15.185185185185185
6435,18562,81918,15,14,29,51.72,0.023282758620689657,18.517241379310345
6441,21503,-19483,19,27,46,41.3,-0.0031739130434782596,24.195652173913043
6446,27380,182550,10,12,22,45.45,0.010904545454545455,22.5
6457,16917,-2987,12,13,25,48.0,0.011768,15.52
6461,4585,25905,15,9,24,62.5,0.03175,18.708333333333332
6462,40028,-237978,10,25,35,28.57,-0.03628571428571429,19.914285714285715
6465,3694,866,10,7,17,58.82,0.01583529411764706,19.941176470588236
6469,13051,-7841,5,5,10,50.0,-0.0006299999999999986,33.1
6470,3823,-8063,6,7,13,46.15,-0.0013923076923076884,15.615384615384615
6472,16207,-14437,8,6,14,57.14,0.0035642857142857065,63.57142857142857
6482,3413,-15583,6,8,14,42.86,-0.02590714285714286,29.428571428571427
6485,16077,-54527,11,19,30,36.67,-0.02471,15.166666666666666
6486,3222,-20812,3,7,10,30.0,-0.03895,15.8
6488,91474,220066,20,17,37,54.05,0.023862162162162165,23.972972972972972
6492,18194,-96614,9,15,24,37.5,-0.018595833333333336,15.041666666666666
6494,9458,12022,10,8,18,55.56,0.009177777777777776,11.722222222222221
6496,2470,3110,5,4,9,55.56,0.03023333333333334,28.11111111111111
6499,8720,-12990,7,11,18,38.89,-0.006783333333333331,29.27777777777778
6506,1377,2253,6,7,13,46.15,0.007723076923076922,25.846153846153847
6508,6092,-9992,12,20,32,37.5,-0.012468750000000002,26.5
6509,8244,-22134,19,39,58,32.76,-0.015358620689655171,22.913793103448278
6510,156944,293016,17,17,34,50.0,0.015573529411764708,20.58823529411765
6512,1086,-7686,2,6,8,25.0,-0.02855,49.5
6514,5371,7559,8,10,18,44.44,0.0013055555555555552,30.61111111111111
6516,14041,-121131,2,13,15,13.33,-0.05056666666666666,20.066666666666666
6523,7586,75924,7,5,12,58.33,0.06425833333333332,51.75
6527,2378,2512,5,4,9,55.56,0.001666666666666668,14.666666666666666
6530,1336,-5936,4,8,12,33.33,-0.019275,11.666666666666666
6532,4225,-49105,3,14,17,17.65,-0.0641235294117647,28.764705882352942
6535,3932,-10222,6,12,18,33.33,-0.014750000000000001,18.77777777777778
6538,17214,-136454,6,15,21,28.57,-0.03927619047619048,27.761904761904763
6542,5086,-21956,5,8,13,38.46,-0.013861538461538463,15.846153846153847
6547,22374,-23614,8,14,22,36.36,-0.0132,9.863636363636363
6548,10648,-9548,8,8,16,50.0,0.010618750000000003,12.125
6556,2637,-17837,2,7,9,22.22,-0.027344444444444442,20.88888888888889
6560,7849,-10139,9,12,21,42.86,-0.006342857142857142,30.047619047619047
6561,17607,25263,6,5,11,54.55,0.015663636363636366,21.727272727272727
6568,31266,-18346,10,16,26,38.46,-0.01311153846153846,16.846153846153847
6569,8089,-20489,4,5,9,44.44,-0.005866666666666667,36.77777777777778
6570,2154,-6444,3,7,10,30.0,-0.01334,2.8
6574,2492,-10762,2,3,5,40.0,-0.029200000000000004,46.2
6576,10323,11187,10,11,21,47.62,0.006347619047619051,16.095238095238095
6577,1154,-16464,0,3,3,0.0,-0.0783,24.666666666666668
6578,1040,-18980,1,6,7,14.29,-0.09001428571428571,42.857142857142854
6588,2702,25448,4,1,5,80.0,0.052860000000000004,15.4
6589,6195,29935,8,5,13,61.54,0.032523076923076925,33.84615384615385
6590,1592,-3582,3,4,7,42.86,-0.001614285714285709,51.714285714285715
6593,1359,11901,4,3,7,57.14,0.04215714285714285,92.42857142857143
6594,4593,13817,9,13,22,40.91,0.012713636363636364,16.5
6596,2786,-6896,3,5,8,37.5,-0.015575000000000002,35.5
6603,4295,-4215,20,30,50,40.0,-0.007137999999999995,22.18
6609,6575,-8835,13,22,35,37.14,-0.008068571428571428,21.685714285714287
6612,7416,-11726,8,10,18,44.44,-0.009511111111111113,19.61111111111111
6613,1023,-21123,0,1,1,0.0,-0.1112,133.0
6615,5016,-7656,4,7,11,36.36,-0.012236363636363634,45.72727272727273
6616,1398,4392,6,5,11,54.55,0.03137272727272727,23.727272727272727
6624,214,-3514,0,1,1,0.0,-0.09,85.0
6629,0,0,0,0,0,0.0,,
6640,3246,4244,3,3,6,50.0,0.004099999999999997,19.666666666666668
6642,3092,-12522,3,5,8,37.5,-0.020624999999999998,36.375
6643,23019,-109109,6,6,12,50.0,-0.016124999999999997,42.5
6649,1887,6993,5,5,10,50.0,0.028509999999999997,26.7
6651,7087,5033,6,6,12,50.0,0.007233333333333335,15.916666666666666
6654,2070,25450,4,1,5,80.0,0.06024,54.6
6661,261,-281,1,1,2,50.0,-0.0037500000000000033,13.5
6662,217,7683,1,0,1,100.0,0.1973,403.0
6664,3481,-22491,2,6,8,25.0,-0.041887499999999994,29.5
6667,5458,-29888,4,9,13,30.77,-0.03556923076923076,18.384615384615383
6679,28245,-158535,6,16,22,27.27,-0.03132272727272728,17.227272727272727
6680,694,2366,1,1,2,50.0,0.014599999999999998,35.5
6683,29743,174607,10,9,19,52.63,0.04465263157894737,20.05263157894737
6690,7010,-30260,2,7,9,22.22,-0.030766666666666664,32.77777777777778
6697,810,3440,2,1,3,66.67,0.030833333333333334,14.333333333333334
6703,639,-10289,0,1,1,0.0,-0.0883,16.0
6712,16828,-87708,4,7,11,36.36,-0.02361818181818182,19.636363636363637
6716,3388,13812,1,5,6,16.67,-0.017283333333333328,69.0
6727,1559,22591,3,1,4,75.0,0.07385,120.0
6728,951,13219,1,0,1,100.0,0.0796,4.0
6732,38149,259971,7,4,11,63.64,0.04811818181818183,21.272727272727273
6733,119,-69,0,1,1,0.0,-0.0034,8.0
6747,9151,-78831,1,5,6,16.67,-0.050083333333333334,17.333333333333332
6751,1020,-4310,1,2,3,33.33,-0.032400000000000005,6.666666666666667
6752,349,-3119,0,1,1,0.0,-0.0528,5.0
6762,3771,4879,1,1,2,50.0,0.00485,28.0
6767,372,6638,2,0,2,100.0,0.10235,16.5
6803,2931,6299,2,2,4,50.0,0.0085,15.75
7402,3195,35635,3,6,9,33.33,0.014211111111111112,104.22222222222223
7556,5753,9547,3,4,7,42.86,0.011842857142857145,17.714285714285715
8024,7633,26357,22,25,47,46.81,0.009791489361702127,21.4468085106383
8027,10172,-37252,12,21,33,36.36,-0.017193939393939386,15.606060606060606
8032,5371,2939,17,19,36,47.22,0.0018861111111111082,25.805555555555557
8034,3884,3666,20,31,51,39.22,0.0026176470588235305,41.21568627450981
8038,8069,8801,13,18,31,41.94,0.006409677419354837,22.677419354838708
8040,12494,41706,34,35,69,49.28,0.014556521739130437,18.594202898550726
8042,8060,39800,22,13,35,62.86,0.03968857142857143,34.114285714285714
8043,8302,24928,26,24,50,52.0,0.013697999999999998,23.76
8044,85142,-198562,33,62,95,34.74,-0.013329473684210523,18.16842105263158
8047,3320,-8570,16,26,42,38.1,-0.014571428571428574,34.642857142857146
8048,2828,-10668,7,11,18,38.89,-0.019805555555555555,33.22222222222222
8049,6414,7106,35,40,75,46.67,0.00495066666666667,19.746666666666666
8050,15272,13848,17,23,40,42.5,-0.0032,30.9
8054,24830,122150,32,38,70,45.71,0.0061342857142857145,16.82857142857143
8059,2456,-5456,13,19,32,40.62,-0.013978125000000001,18.5
8064,7526,-2366,25,37,62,40.32,-0.010180645161290325,28.161290322580644
8066,958,-25038,5,11,16,31.25,-0.7157437500000001,338.625
8067,3625,585,16,34,50,32.0,-0.013467999999999997,27.84
8068,16991,52949,37,51,88,42.05,0.0005090909090909088,16.125
8069,25439,45161,40,50,90,44.44,-0.004186666666666667,18.266666666666666
8071,7573,-18623,20,43,63,31.75,-0.027114285714285716,21.984126984126984
8074,2992,17518,17,8,25,68.0,0.037968,28.0
8076,33227,462243,33,30,63,52.38,0.023358730158730155,24.3015873015873
8077,4137,-8817,19,30,49,38.78,-0.013495918367346937,14.326530612244898
8080,7290,1750,29,43,72,40.28,-0.015040277777777781,32.666666666666664
8083,7487,-7347,7,12,19,36.84,-0.0126,18.31578947368421
8084,9061,-15891,27,25,52,51.92,0.006453846153846156,17.98076923076923
8085,4546,21024,29,25,54,53.7,0.021196296296296293,34.629629629629626
8086,21912,40758,27,30,57,47.37,0.006340350877192981,21.736842105263158
8087,3760,360,19,29,48,39.58,-0.012570833333333335,26.895833333333332
8088,7617,16003,32,33,65,49.23,0.01600461538461538,19.384615384615383
8089,0,0,0,0,0,0.0,,
8091,13085,-20075,16,19,35,45.71,-0.003371428571428569,25.37142857142857
8092,3872,2698,20,24,44,45.45,0.004604545454545456,37.09090909090909
8093,4621,17169,23,21,44,52.27,0.022304545454545452,24.454545454545453
8096,9357,8993,36,38,74,48.65,0.012291891891891893,22.16216216216216
8097,8501,-1361,39,45,84,46.43,0.0021214285714285692,18.666666666666668
8099,7169,16211,19,28,47,40.43,0.008746808510638302,21.085106382978722
8107,7584,22036,28,31,59,47.46,0.01108135593220339,20.949152542372882
8109,5146,-2556,7,11,18,38.89,-0.005638888888888883,40.05555555555556
8111,9618,2582,40,41,81,49.38,0.007418518518518521,17.22222222222222
8121,20474,91636,45,48,93,48.39,0.005409677419354839,18.892473118279568
8147,4468,10282,9,9,18,50.0,0.020888888888888887,23.38888888888889
8155,21258,-69398,15,23,38,39.47,-0.013031578947368422,21.0
8171,5164,12626,16,16,32,50.0,0.0188625,35.125
8176,2306,-4806,11,21,32,34.38,-0.016340625000000004,24.1875
8182,6092,4178,18,17,35,51.43,0.012971428571428573,26.82857142857143
8183,7536,-12146,24,34,58,41.38,-0.007606896551724139,17.413793103448278
8234,8609,-11569,18,29,47,38.3,-0.010346808510638301,21.97872340425532
8240,15665,79325,19,21,40,47.5,0.0213275,29.8
8255,39546,33534,22,28,50,44.0,0.0013660000000000005,18.08
8277,11511,-44861,33,54,87,37.93,-0.011635632183908043,16.620689655172413
8279,11263,29447,8,7,15,53.33,0.022473333333333335,27.866666666666667
8284,4472,-19672,4,13,17,23.53,-0.02165882352941176,22.705882352941178
8289,4130,-7310,11,20,31,35.48,-0.01868064516129032,17.451612903225808
8291,1704,-3234,13,18,31,41.94,-0.02012258064516129,24.806451612903224
8299,85015,23115,24,42,66,36.36,-0.001921212121212119,28.424242424242426
8342,283,2257,1,0,1,100.0,0.0484,12.0
8349,10469,-45239,10,15,25,40.0,-0.020783999999999997,40.12
8354,943,8157,5,5,10,50.0,0.03956,114.5
8358,6482,-4942,13,13,26,50.0,0.01206923076923077,30.692307692307693
8383,9577,-7377,19,26,45,42.22,-0.00447333333333333,28.155555555555555
8390,5392,-7902,11,17,28,39.29,-0.012889285714285716,21.892857142857142
8401,1884,-7644,5,12,17,29.41,-0.02799411764705882,34.1764705882353
8403,5472,-38622,7,18,25,28.0,-0.041228,33.64
8409,3386,-28816,6,17,23,26.09,-0.04287826086956521,33.47826086956522
8410,6700,8770,15,14,29,51.72,0.007151724137931037,28.93103448275862
8415,1208,6372,4,2,6,66.67,0.03471666666666667,29.666666666666668
8416,12154,13666,5,11,16,31.25,-0.009006249999999997,43.5
8418,1456,-7166,3,10,13,23.08,-0.02503076923076923,34.07692307692308
8420,2963,-1593,5,9,14,35.71,-0.017900000000000003,59.0
8421,1754,-8494,6,13,19,31.58,-0.02466842105263158,22.157894736842106
8423,2411,-15591,3,15,18,16.67,-0.03843888888888889,20.444444444444443
8424,480,-6530,0,2,2,0.0,-0.07835,333.0
8426,1819,-12369,3,6,9,33.33,-0.0191,21.444444444444443
8431,12743,78627,19,16,35,54.29,0.03300857142857143,26.285714285714285
8432,9155,-8345,7,13,20,35.0,-0.007540000000000001,39.6
8433,9152,35678,10,10,20,50.0,0.010894999999999998,14.95
8435,946,3844,2,1,3,66.67,0.0253,19.333333333333332
8436,57891,30649,19,22,41,46.34,0.004126829268292684,24.0
8437,11097,-45927,3,8,11,27.27,-0.021118181818181817,13.636363636363637
8440,4004,2326,10,12,22,45.45,0.008681818181818178,21.181818181818183
8444,4794,-4494,3,5,8,37.5,-0.0058375,17.5
8446,7183,34187,5,6,11,45.45,0.03101818181818182,165.0
8450,5144,18226,8,8,16,50.0,0.008106249999999999,13.0625
8455,2520,9440,6,11,17,35.29,0.0078058823529411755,36.76470588235294
8472,2216,-16306,3,6,9,33.33,-0.032933333333333335,16.555555555555557
8476,2491,-2901,6,9,15,40.0,-0.0022733333333333355,18.0
8477,2327,24493,7,2,9,77.78,0.06398888888888889,12.222222222222221
8489,14695,51435,11,9,20,55.0,0.025555000000000005,22.45
8905,2590,-920,12,14,26,46.15,-0.005496153846153846,47.26923076923077
8906,2595,-9685,12,30,42,28.57,-0.03098809523809523,29.857142857142858
8908,3027,-5297,7,19,26,26.92,-0.028738461538461543,23.03846153846154
8916,4060,40,9,20,29,31.03,-0.022413793103448276,23.03448275862069
8917,0,0,0,0,0,0.0,,
8921,1315,-17155,2,15,17,11.76,-0.07892352941176471,33.588235294117645
8923,1426,-5096,5,10,15,33.33,-0.008786666666666668,43.333333333333336
8924,10821,-29761,13,22,35,37.14,-0.012854285714285714,29.942857142857143
8927,3838,-15228,12,22,34,35.29,-0.01957941176470588,21.441176470588236
8928,5641,15969,23,21,44,52.27,0.02317954545454545,38.81818181818182
8929,5230,-14450,11,34,45,24.44,-0.05560444444444443,21.822222222222223
8930,1624,-1924,9,11,20,45.0,-0.004574999999999999,30.5
8931,1725,11865,10,7,17,58.82,0.041823529411764704,17.470588235294116
8932,4605,-26415,17,46,63,26.98,-0.03674444444444445,23.841269841269842
8933,4966,-4366,22,31,53,41.51,-0.008539622641509434,34.075471698113205
8935,3312,12518,25,23,48,52.08,0.019054166666666667,18.3125
8936,10218,53182,37,25,62,59.68,0.024612903225806455,20.774193548387096
8937,4592,28348,27,17,44,61.36,0.04138181818181818,27.045454545454547
8938,10395,-45015,11,19,30,36.67,-0.020933333333333328,33.63333333333333
8941,5471,-51241,7,23,30,23.33,-0.042006666666666664,36.9
8942,9196,-10136,14,21,35,40.0,-0.009785714285714285,17.742857142857144
9949,3863,12877,9,11,20,45.0,0.011025,19.1
9950,1946,-866,8,10,18,44.44,-0.01367777777777778,59.94444444444444
9951,25903,-47423,20,24,44,45.45,-3.181818181818273e-05,24.09090909090909
9960,5193,5557,17,19,36,47.22,0.01810833333333333,35.69444444444444
9962,3285,4935,14,14,28,50.0,0.014717857142857142,22.285714285714285
8916A,0,0,0,0,0,0.0,,
4148,7178,-15418,6,12,18,33.33,-0.01650555555555555,26.166666666666668
6781,70515,-194265,5,6,11,45.45,-0.005127272727272725,11.818181818181818
6776,0,0,0,0,0,0.0,,
2211,676,1894,1,1,2,50.0,0.019299999999999998,19.5
6768,420,-5110,0,1,1,0.0,-0.0724,42.0
3357,3466,-20506,6,11,17,35.29,-0.016364705882352944,129.11764705882354
6741,8059,-67349,2,5,7,28.57,-0.029885714285714283,32.0
2250,1551,15559,2,1,3,66.67,0.0469,49.333333333333336
5236,3668,36562,4,1,5,80.0,0.05232,9.2
1522A,0,0,0,0,0,0.0,,
6684,5575,5905,4,4,8,50.0,0.007975,11.25
2753,2813,9207,2,1,3,66.67,0.02806666666666666,14.666666666666666
2348A,0,0,0,0,0,0.0,,
6790,0,0,0,0,0,0.0,,
6788,6086,10314,4,4,8,50.0,0.0024500000000000043,12.375
2947,596,7704,1,0,1,100.0,0.0741,60.0
4440,0,0,0,0,0,0.0,,
5222,8867,-6727,11,13,24,45.83,0.00755416666666667,18.166666666666668
2881C,0,0,0,0,0,0.0,,
6761,682,13418,1,0,1,100.0,0.1118,42.0
6806,558,-5648,0,1,1,0.0,-0.06,7.0
2945,0,0,0,0,0,0.0,,
6770,659,-2559,1,2,3,33.33,-0.01123333333333333,3.6666666666666665
6792,2366,7374,2,2,4,50.0,0.020300000000000002,13.0
4770,6473,56657,3,1,4,75.0,0.050824999999999995,6.25
2883B,0,0,0,0,0,0.0,,
6691,0,0,0,0,0,0.0,,
3592,33975,42705,19,16,35,54.29,0.007645714285714288,10.771428571428572
6719,11927,131153,3,2,5,60.0,0.06154,23.8
2756,632,-7182,0,1,1,0.0,-0.0636,6.0
5244,882,2018,5,7,12,41.67,0.004999999999999999,20.833333333333332
6693,506,12004,1,0,1,100.0,0.1341,80.0
8112A,0,0,0,0,0,0.0,,
8438,2061,-671,4,8,12,33.33,-0.004383333333333332,46.416666666666664
6829,1345,-8545,1,2,3,33.33,-0.03420000000000001,33.0
4923,847,12313,3,3,6,50.0,0.025383333333333338,76.5
6763,5528,-3578,1,1,2,50.0,-0.0092,24.5
4558,394,2116,2,1,3,66.67,0.015766666666666665,61.333333333333336
3349,0,0,0,0,0,0.0,,
6804,616,-12706,0,2,2,0.0,-0.1184,10.0
4768,2601,-19951,1,2,3,33.33,-0.040600000000000004,5.0
6807,0,0,0,0,0,0.0,,
6721,0,0,0,0,0,0.0,,
6735,0,0,0,0,0,0.0,,
4583,0,0,0,0,0,0.0,,
6799,705,17525,1,0,1,100.0,0.1402,14.0
6585,376,3854,1,0,1,100.0,0.0588,11.0
5228,1352,8278,6,3,9,66.67,0.039177777777777784,19.22222222222222
6546,2554,-15224,5,2,7,71.43,0.018885714285714283,16.857142857142858
6796,969,21211,2,0,2,100.0,0.113,12.0
6550,3115,55285,3,2,5,60.0,0.07914000000000002,9.2
4577,0,0,0,0,0,0.0,,
6789,1412,27988,1,0,1,100.0,0.1126,12.0
6823,0,0,0,0,0,0.0,,
2887Z1,0,0,0,0,0,0.0,,
6811,0,0,0,0,0,0.0,,
6854,0,0,0,0,0,0.0,,
3715,0,0,0,0,0,0.0,,
6830,0,0,0,0,0,0.0,,
6834,0,0,0,0,0,0.0,,
3430,978,9982,6,1,7,85.71,0.04694285714285714,105.0
6689,0,0,0,0,0,0.0,,
6592A,0,0,0,0,0,0.0,,
