代號,總成本,總損益(淨),獲利次數,損失次數,總交易次數,勝率%,平均報酬,平均持倉時間(日)
1101,5350,15190,18,10,28,64.29,0.022653571428571433,55.17857142857143
1102,4009,-11199,9,12,21,42.86,-0.020295238095238095,76.0
1103,2760,2960,17,12,29,58.62,0.011168965517241378,67.65517241379311
1104,2661,-471,12,12,24,50.0,-0.002554166666666666,85.79166666666667
1108,1499,3901,15,8,23,65.22,0.021995652173913045,94.65217391304348
1109,1908,-7288,9,15,24,37.5,-0.031891666666666665,115.83333333333333
1110,1649,-2219,10,10,20,50.0,-0.006789999999999999,59.25
1201,6035,28225,25,15,40,62.5,0.017830000000000002,37.95
1203,2859,2121,14,10,24,58.33,0.008741666666666667,106.25
1210,4472,-13172,10,15,25,40.0,-0.023648000000000002,56.0
1213,1727,-677,8,9,17,47.06,-0.012217647058823533,55.64705882352941
1215,5323,207,19,11,30,63.33,0.02333,65.1
1216,5749,1491,12,10,22,54.55,0.006795454545454546,69.9090909090909
1217,1362,-602,11,9,20,55.0,0.0022600000000000038,59.7
1218,1935,-13775,8,14,22,36.36,-0.03440454545454545,45.72727272727273
1219,1590,1210,12,8,20,60.0,0.015109999999999998,64.25
1220,1400,-2620,9,11,20,45.0,-0.017529999999999997,117.8
1225,4523,17587,20,13,33,60.61,0.014996969696969696,40.96969696969697
1227,5529,-9789,8,11,19,42.11,-0.021926315789473686,114.42105263157895
1229,3807,2693,15,13,28,53.57,0.0028321428571428586,87.82142857142857
1231,5030,-17490,11,13,24,45.83,-0.017820833333333334,84.04166666666667
1232,8881,7879,11,11,22,50.0,-0.006036363636363632,128.77272727272728
1233,3245,5965,8,6,14,57.14,0.0030571428571428603,156.92857142857142
1234,2415,4805,9,10,19,47.37,-0.009363157894736842,87.63157894736842
1235,2011,1459,6,6,12,50.0,-0.005908333333333334,60.583333333333336
1236,2537,-4987,11,11,22,50.0,-0.005977272727272729,84.36363636363636
1256,13710,68390,6,5,11,54.55,0.00303636363636364,24.272727272727273
1301,10349,-25419,11,13,24,45.83,-0.01419583333333333,86.45833333333333
1303,7970,-50980,9,15,24,37.5,-0.030920833333333328,56.583333333333336
1304,3097,-397,13,13,26,50.0,-0.0042846153846153815,45.53846153846154
1305,3265,10365,19,12,31,61.29,0.016103225806451613,30.193548387096776
1307,4337,-16667,11,16,27,40.74,-0.02446296296296296,95.4074074074074
1308,4184,18366,17,11,28,60.71,0.015478571428571427,44.964285714285715
1309,3266,-636,18,16,34,52.94,-0.0009029411764705892,31.41176470588235
1310,2500,-26930,5,19,24,20.83,-0.06445833333333333,45.5
1312,3446,-1176,19,17,36,52.78,-0.0009527777777777773,24.833333333333332
1313,3046,-3896,16,17,33,48.48,-0.00599090909090909,36.81818181818182
1314,1922,-3532,11,13,24,45.83,-0.015316666666666668,38.25
1315,3243,-2973,7,12,19,36.84,-0.03261578947368421,74.36842105263158
1316,2228,6102,17,9,26,65.38,0.023173076923076925,33.84615384615385
1319,4396,23364,12,6,18,66.67,0.027433333333333327,34.388888888888886
1321,4454,-27014,13,20,33,39.39,-0.027118181818181816,39.696969696969695
1323,2518,-1408,8,9,17,47.06,-0.012076470588235293,81.29411764705883
1324,1910,-790,11,12,23,47.83,-0.011078260869565221,73.69565217391305
1325,5067,33933,13,12,25,52.0,-0.002179999999999999,56.28
1326,8989,-44429,9,13,22,40.91,-0.024086363636363628,70.13636363636364
1337,3252,2268,8,7,15,53.33,7.333333333333359e-05,34.266666666666666
1338,4218,-43468,2,7,9,22.22,-0.06142222222222222,50.888888888888886
1339,3248,4982,7,5,12,58.33,0.01079166666666667,90.66666666666667
1340,4547,-21737,5,9,14,35.71,-0.031414285714285714,34.142857142857146
1341,1142,4398,2,1,3,66.67,0.027333333333333334,61.0
1342,2175,-12675,2,4,6,33.33,-0.039333333333333324,47.5
1402,4570,-30020,11,15,26,42.31,-0.02388076923076923,70.57692307692308
1409,2220,-9220,12,18,30,40.0,-0.025686666666666667,45.03333333333333
1410,1204,-8194,4,7,11,36.36,-0.034254545454545454,97.18181818181819
1413,1376,-1186,12,11,23,52.17,-0.006300000000000001,43.52173913043478
1414,2308,-4198,18,17,35,51.43,-0.006028571428571427,43.94285714285714
1416,2077,3553,15,12,27,55.56,0.0023888888888888887,42.629629629629626
1417,1459,-5029,11,12,23,47.83,-0.013139130434782605,33.69565217391305
1418,1019,2641,13,5,18,72.22,0.033438888888888886,21.666666666666668
1419,3716,-10966,10,10,20,50.0,-0.005889999999999998,88.45
1423,1583,737,13,10,23,56.52,0.00707391304347826,78.69565217391305
1432,1399,5601,11,6,17,64.71,0.022311764705882354,45.0
1434,2428,-20378,5,12,17,29.41,-0.047205882352941174,133.52941176470588
1435,2072,-15782,6,22,28,21.43,-0.06642857142857142,48.714285714285715
1436,1235,-5345,4,8,12,33.33,-0.040875,61.166666666666664
1437,3257,13853,19,11,30,63.33,0.021729999999999996,57.36666666666667
1438,825,-4185,4,8,12,33.33,-0.03880833333333334,47.416666666666664
1439,3205,13765,14,11,25,56.0,0.005751999999999997,35.08
1440,2487,-1417,15,15,30,50.0,-0.003879999999999997,37.333333333333336
1441,1679,-7529,11,15,26,42.31,-0.02167692307692308,57.84615384615385
1442,3187,8573,17,12,29,58.62,0.010172413793103447,43.93103448275862
1443,989,1881,11,7,18,61.11,0.010322222222222224,25.77777777777778
1444,2016,2124,18,12,30,60.0,0.01173333333333333,55.3
1445,1634,446,15,11,26,57.69,0.003123076923076921,66.53846153846153
1446,3530,-16000,13,15,28,46.43,-0.01501785714285714,48.642857142857146
1447,2487,-1407,21,16,37,56.76,0.005227027027027029,33.432432432432435
1449,1632,2038,17,12,29,58.62,0.0022310344827586193,20.275862068965516
1451,3666,-606,14,12,26,53.85,0.0018384615384615436,84.65384615384616
1452,2389,10171,14,10,24,58.33,0.009645833333333334,51.875
1453,1288,822,11,9,20,55.0,0.00018500000000000043,56.2
1454,1202,-2812,8,11,19,42.11,-0.024178947368421053,80.10526315789474
1455,2001,5689,16,12,28,57.14,0.0069428571428571395,47.392857142857146
1456,0,0,0,0,0,0.0,,
1457,826,-1206,7,6,13,53.85,-0.0017230769230769244,51.23076923076923
1459,1976,184,17,13,30,56.67,0.005209999999999998,35.233333333333334
1460,1904,1666,16,12,28,57.14,0.006446428571428571,40.714285714285715
1463,1649,-11629,9,12,21,42.86,-0.019838095238095238,38.57142857142857
1464,2683,14477,20,10,30,66.67,0.024016666666666665,49.5
1465,1087,-5907,5,9,14,35.71,-0.03516428571428572,148.92857142857142
1466,1881,-3441,8,16,24,33.33,-0.038054166666666674,30.416666666666668
1467,2451,-12221,13,20,33,39.39,-0.028463636363636368,31.939393939393938
1468,1052,-7322,4,10,14,28.57,-0.049485714285714286,89.42857142857143
1470,1424,-5444,8,10,18,44.44,-0.018755555555555557,42.44444444444444
1471,1689,-3959,7,11,18,38.89,-0.031083333333333338,20.666666666666668
1472,1729,-8759,8,13,21,38.1,-0.033033333333333324,29.523809523809526
1473,5682,22278,18,9,27,66.67,0.02738888888888889,72.51851851851852
1474,1643,1437,14,9,23,60.87,0.014430434782608697,64.78260869565217
1475,1718,8412,8,9,17,47.06,-0.01358235294117647,16.11764705882353
1476,26131,-21881,12,12,24,50.0,-0.006066666666666662,41.625
1477,13731,57079,13,7,20,65.0,0.02408,65.25
1503,3633,9837,9,8,17,52.94,-0.00010588235294117787,143.88235294117646
1504,3347,9353,19,11,30,63.33,0.020500000000000008,60.03333333333333
1506,1878,-4338,8,11,19,42.11,-0.021952631578947363,60.78947368421053
1512,1602,3358,15,10,25,60.0,0.011236,24.96
1513,3221,3749,14,12,26,53.85,0.0015653846153846187,64.61538461538461
1514,2349,-219,17,14,31,54.84,0.00212258064516129,41.193548387096776
1515,5249,27221,19,11,30,63.33,0.019780000000000002,34.266666666666666
1516,2381,-1851,14,12,26,53.85,-0.00010769230769230757,38.07692307692308
1517,2229,5071,17,11,28,60.71,0.014571428571428572,48.964285714285715
1519,4061,-9021,14,12,26,53.85,0.0016576923076923092,41.46153846153846
1521,8035,-29125,11,15,26,42.31,-0.02418846153846153,70.46153846153847
1522,4941,16449,21,14,35,60.0,0.01414571428571429,34.94285714285714
1524,1542,-2312,10,11,21,47.62,-0.012376190476190475,46.714285714285715
1525,9456,67124,21,11,32,65.62,0.02785,47.75
1526,4681,-1151,17,16,33,51.52,-0.00413939393939394,37.75757575757576
1527,5149,11131,13,9,22,59.09,0.014190909090909089,50.45454545454545
1528,1655,-2705,10,10,20,50.0,-0.006744999999999998,34.9
1529,1713,-3513,11,13,24,45.83,-0.018125,17.458333333333332
1530,7877,-26487,13,20,33,39.39,-0.027142424242424242,51.18181818181818
1531,4158,8072,14,15,29,48.28,-0.005982758620689655,38.724137931034484
1532,5190,-16280,11,15,26,42.31,-0.02119230769230769,60.42307692307692
1533,7839,-50729,15,23,38,39.47,-0.026431578947368414,25.07894736842105
1535,5856,38124,16,9,25,64.0,0.025000000000000005,49.32
1536,6872,-5172,15,11,26,57.69,0.009257692307692312,34.80769230769231
1537,11002,-92482,8,16,24,33.33,-0.04255,82.875
1538,3806,-17616,13,14,27,48.15,-0.010940740740740739,32.51851851851852
1539,2860,-4800,13,13,26,50.0,-0.007142307692307689,32.34615384615385
1540,3135,2175,13,9,22,59.09,0.012318181818181822,62.86363636363637
1541,3141,219,9,9,18,50.0,-0.006238888888888888,31.88888888888889
1558,10644,-67104,5,9,14,35.71,-0.03442142857142857,126.5
1560,8564,44406,13,9,22,59.09,0.012222727272727274,43.09090909090909
1568,1751,-3621,5,7,12,41.67,-0.022533333333333332,29.583333333333332
1582,6665,-31125,7,10,17,41.18,-0.023382352941176465,69.70588235294117
1583,5786,43244,13,5,18,72.22,0.043783333333333334,67.77777777777777
1587,2046,3294,9,6,15,60.0,0.014066666666666672,34.8
1589,5106,-41376,4,8,12,33.33,-0.03485,31.75
1590,43777,-82777,7,8,15,46.67,-0.012406666666666661,23.4
1597,7269,4491,11,9,20,55.0,0.004150000000000002,31.9
1598,4432,28,7,5,12,58.33,0.010691666666666669,43.166666666666664
1603,2025,-3495,13,11,24,54.17,2.916666666666577e-05,38.958333333333336
1604,2264,-2184,15,12,27,55.56,0.0034962962962962973,51.888888888888886
1605,2883,-3283,17,17,34,50.0,-0.006579411764705881,31.676470588235293
1608,2040,3840,16,12,28,57.14,0.0066035714285714265,37.17857142857143
1609,1928,-1078,16,10,26,61.54,0.0157,79.92307692307692
1611,1832,-202,11,10,21,52.38,-0.0018523809523809545,54.76190476190476
1612,2061,-2251,13,12,25,52.0,-0.0028239999999999993,95.52
1614,4753,2267,16,13,29,55.17,0.007234482758620688,84.65517241379311
1615,2104,-3384,14,10,24,58.33,0.0098125,51.5
1616,1589,1841,13,11,24,54.17,-0.00018333333333333626,51.958333333333336
1617,1863,-2363,13,13,26,50.0,-0.0035999999999999973,49.38461538461539
1618,1610,-950,9,12,21,42.86,-0.021428571428571425,55.666666666666664
1626,2976,1464,7,7,14,50.0,-0.005978571428571426,34.92857142857143
1701,3513,10267,19,12,31,61.29,0.016599999999999997,70.48387096774194
1702,4844,15836,15,6,21,71.43,0.03401428571428572,78.0952380952381
1707,13979,119071,14,5,19,73.68,0.04116315789473685,66.0
1708,4400,25770,16,9,25,64.0,0.021568,66.08
1709,2206,4754,14,9,23,60.87,0.015630434782608695,73.3913043478261
1710,3706,-8506,11,13,24,45.83,-0.014116666666666666,71.54166666666667
1711,3049,9751,14,12,26,53.85,0.0015653846153846154,73.34615384615384
1712,2271,3159,16,11,27,59.26,0.011759259259259263,95.66666666666667
1713,2336,7234,18,9,27,66.67,0.02882222222222222,69.03703703703704
1714,1910,-3230,12,13,25,48.0,-0.008516000000000003,55.32
1717,3317,-11527,9,10,19,47.37,-0.011063157894736839,72.05263157894737
1718,2079,-6109,13,16,29,44.83,-0.014824137931034485,36.0
1720,5291,-30951,12,19,31,38.71,-0.02844838709677419,76.09677419354838
1721,2160,-12950,11,17,28,39.29,-0.026685714285714285,35.75
1722,10278,-888,14,14,28,50.0,-0.005828571428571425,67.64285714285714
1723,14473,51137,15,9,24,62.5,0.0191375,70.66666666666667
1725,2294,-204,11,11,22,50.0,-0.0059999999999999975,101.4090909090909
1726,7713,25087,15,8,23,65.22,0.02829565217391305,138.65217391304347
1727,2113,-4543,9,10,19,47.37,-0.011305263157894737,42.05263157894737
1730,4847,-5187,11,14,25,44.0,-0.016423999999999998,60.2
1731,2049,5511,13,10,23,56.52,0.006847826086956526,66.69565217391305
1732,1895,-4675,8,10,18,44.44,-0.017238888888888883,74.44444444444444
1733,7418,38702,19,10,29,65.52,0.02505862068965518,46.55172413793103
1734,3810,-2260,10,11,21,47.62,-0.010666666666666666,35.19047619047619
1735,1411,-421,8,8,16,50.0,-0.006212499999999997,73.6875
1736,13818,39282,16,13,29,55.17,0.004393103448275862,33.0
1737,3926,-19366,10,16,26,38.46,-0.02518461538461538,105.42307692307692
1760,0,0,0,0,0,0.0,,
1762,5482,-12362,11,10,21,52.38,-0.0011047619047619027,45.142857142857146
1773,6085,-35545,5,10,15,33.33,-0.03938666666666667,46.46666666666667
1776,327,-1507,1,2,3,33.33,-0.039233333333333335,352.3333333333333
1783,2547,-647,8,8,16,50.0,-0.0058937500000000006,35.0625
1786,3742,-32632,3,7,10,30.0,-0.045849999999999995,28.2
1789,3683,-16943,6,9,15,40.0,-0.02582,53.06666666666667
1795,8970,-96780,6,14,20,30.0,-0.045725,15.25
1802,4375,6265,18,12,30,60.0,0.014026666666666668,48.8
1805,1419,13641,16,4,20,80.0,0.05005999999999999,43.1
1806,1866,2564,16,10,26,61.54,0.014965384615384613,31.5
1808,4983,-36423,7,15,22,31.82,-0.042199999999999994,46.95454545454545
1809,2175,8085,17,10,27,62.96,0.019070370370370373,32.74074074074074
1810,1461,4489,13,7,20,65.0,0.02097,50.45
1817,1706,4374,5,3,8,62.5,0.014349999999999998,141.625
1903,7375,-375,16,14,30,53.33,0.0007400000000000027,45.1
1904,2371,7329,14,9,23,60.87,0.014934782608695654,75.0
1905,2719,-7309,13,18,31,41.94,-0.02265806451612903,62.225806451612904
1906,2317,823,16,12,28,57.14,0.006146428571428568,34.535714285714285
1907,2090,7100,17,8,25,68.0,0.029616000000000003,81.88
1909,2787,-2807,16,15,31,51.61,-0.003412903225806449,45.225806451612904
2002,3928,7312,14,9,23,60.87,0.01591739130434783,149.6086956521739
2006,3646,1424,12,10,22,54.55,0.0032454545454545475,68.81818181818181
2007,1599,-4289,9,16,25,36.0,-0.037548,31.2
2008,2011,1259,17,12,29,58.62,0.009003448275862065,37.13793103448276
2009,2790,-50,18,14,32,56.25,0.0057312499999999985,38.3125
2010,2252,-8652,11,15,26,42.31,-0.01948846153846154,75.88461538461539
2012,2067,53,13,13,26,50.0,-0.008815384615384614,42.15384615384615
2013,3563,-9963,12,15,27,44.44,-0.017114814814814812,77.70370370370371
2014,3131,20629,19,12,31,61.29,0.015619354838709677,35.96774193548387
2015,4724,10066,11,8,19,57.89,0.009815789473684213,89.05263157894737
2017,1444,7476,12,6,18,66.67,0.025444444444444447,39.0
2020,2192,-24782,4,16,20,20.0,-0.065685,82.45
2022,1541,2219,14,11,25,56.0,0.0023759999999999944,41.96
2023,2918,10832,21,12,33,63.64,0.02088787878787879,45.27272727272727
2024,2015,2495,15,13,28,53.57,0.001921428571428571,25.642857142857142
2025,1755,3275,18,12,30,60.0,0.009009999999999999,27.966666666666665
2027,3153,1657,10,13,23,43.48,-0.018895652173913046,71.78260869565217
2028,2241,6259,16,8,24,66.67,0.027195833333333336,19.375
2029,0,0,0,0,0,0.0,,
2030,3222,16388,20,12,32,62.5,0.021209375000000003,43.09375
2031,4877,-17357,13,19,32,40.62,-0.024628124999999997,39.75
2032,2756,-1486,14,14,28,50.0,-0.006317857142857143,48.285714285714285
2033,1766,9184,12,8,20,60.0,0.013375000000000007,62.65
2034,5047,-8387,15,16,31,48.39,-0.009229032258064516,48.74193548387097
2038,1767,-5287,7,11,18,38.89,-0.028916666666666663,49.27777777777778
2049,30206,89094,14,8,22,63.64,0.0213,20.09090909090909
2059,35920,-147820,9,12,21,42.86,-0.020128571428571426,39.38095238095238
2062,3450,12450,11,7,18,61.11,0.016294444444444445,72.33333333333333
2069,1482,-8862,4,6,10,40.0,-0.019929999999999996,74.0
2101,4384,15116,13,7,20,65.0,0.024025,55.65
2102,2550,-4690,11,13,24,45.83,-0.014374999999999999,42.291666666666664
2103,5278,-23708,12,16,28,42.86,-0.017117857142857143,39.035714285714285
2104,5343,-19583,15,19,34,44.12,-0.019864705882352937,68.17647058823529
2105,8419,-34199,11,16,27,40.74,-0.020503703703703698,63.148148148148145
2106,5980,4250,14,14,28,50.0,-0.005710714285714283,65.78571428571429
2107,2724,3286,14,11,25,56.0,0.005975999999999997,55.2
2108,5064,13886,18,16,34,52.94,-3.823529411764775e-05,35.76470588235294
2109,2383,377,15,15,30,50.0,-0.00678,29.866666666666667
2114,11148,34842,15,10,25,60.0,0.014096000000000003,89.16
2115,2967,16633,7,3,10,70.0,0.03426,38.9
2201,6383,-14023,15,16,31,48.39,-0.009045161290322583,54.70967741935484
2204,3818,-12938,9,12,21,42.86,-0.020176190476190476,78.9047619047619
2206,2298,3682,14,8,22,63.64,0.020718181818181816,78.9090909090909
2207,44940,-9680,15,15,30,50.0,-0.0030466666666666637,50.833333333333336
2208,1532,-1602,6,7,13,46.15,-0.013576923076923077,58.53846153846154
2227,34119,-98889,12,13,25,48.0,-0.009831999999999999,54.76
2228,7508,47152,8,2,10,80.0,0.054299999999999994,42.1
2231,26910,138930,13,8,21,61.9,0.017876190476190483,26.714285714285715
2233,11644,-87714,7,14,21,33.33,-0.043019047619047616,19.714285714285715
2236,2538,3882,7,4,11,63.64,0.021481818181818182,41.63636363636363
2239,6445,-47815,3,5,8,37.5,-0.0307375,47.625
2241,2705,-21065,2,4,6,33.33,-0.03914999999999999,32.5
2243,999,-8599,3,7,10,30.0,-0.04605,17.9
2247,1258,12742,1,0,1,100.0,0.0583,472.0
2301,7716,-33956,13,19,32,40.62,-0.024603124999999997,52.65625
2302,2065,-8175,13,21,34,38.24,-0.03380294117647059,28.558823529411764
2303,3156,-8756,14,11,25,56.0,0.0030239999999999937,55.36
2305,2098,-4648,18,15,33,54.55,-0.0005696969696969709,21.575757575757574
2308,18941,152919,19,8,27,70.37,0.033685185185185186,48.51851851851852
2312,2154,15606,21,8,29,72.41,0.037451724137931026,37.310344827586206
2313,3880,140,17,13,30,56.67,0.007003333333333335,27.533333333333335
2314,5196,-52396,11,26,37,29.73,-0.04537567567567567,19.18918918918919
2316,2876,294,13,12,25,52.0,-0.0022359999999999993,38.68
2317,16864,-45644,12,16,28,42.86,-0.01729642857142857,55.285714285714285
2321,1185,-505,11,7,18,61.11,0.009261111111111109,20.944444444444443
2323,2156,3744,21,13,34,61.76,0.014188235294117644,41.588235294117645
2324,4206,3004,15,13,28,53.57,0.0012821428571428567,79.53571428571429
2327,28515,189365,24,15,39,61.54,0.01657692307692308,27.05128205128205
2328,5605,-13105,15,18,33,45.45,-0.012975757575757573,42.57575757575758
2329,1718,-1708,14,12,26,53.85,-0.002111538461538458,27.923076923076923
2330,23743,18907,16,16,32,50.0,-0.005903124999999997,69.125
2331,4369,11561,25,16,41,60.98,0.016946341463414633,26.390243902439025
2332,4844,13386,19,14,33,57.58,0.009160606060606064,40.27272727272727
2337,3213,-12713,15,21,36,41.67,-0.024552777777777778,29.833333333333332
2338,4858,-21648,14,15,29,48.28,-0.012448275862068967,49.41379310344828
2340,3733,-8683,15,12,27,55.56,0.0032999999999999995,21.77777777777778
2342,4626,-21656,20,22,42,47.62,-0.011809523809523808,18.238095238095237
2344,2163,877,14,13,27,51.85,-0.003718518518518516,35.370370370370374
2345,7812,-10852,12,14,26,46.15,-0.013607692307692303,32.88461538461539
2347,6536,7374,11,9,20,55.0,0.00414,41.25
2348,4773,2147,12,12,24,50.0,-0.008166666666666668,19.25
2349,2088,-5298,17,15,32,53.12,-0.002740624999999997,27.71875
2351,6714,-24364,11,15,26,42.31,-0.021380769230769224,29.96153846153846
2352,4264,-13314,16,15,31,51.61,-0.000199999999999997,32.16129032258065
2353,6989,26911,17,11,28,60.71,0.01563214285714286,46.285714285714285
2354,18881,15959,14,12,26,53.85,0.001830769230769232,60.19230769230769
2355,7003,-32533,14,21,35,40.0,-0.025882857142857138,50.22857142857143
2356,2910,-17230,9,16,25,36.0,-0.033916,67.92
2357,34336,2964,15,15,30,50.0,-0.008579999999999997,69.5
2358,2474,-7774,14,15,29,48.28,-0.009951724137931035,21.620689655172413
2359,1766,-8926,8,12,20,40.0,-0.026744999999999998,52.05
2360,13209,-52819,10,14,24,41.67,-0.025624999999999995,38.291666666666664
2362,6265,19665,17,11,28,60.71,0.015367857142857147,42.17857142857143
2363,1987,-11147,9,15,24,37.5,-0.03553750000000001,34.916666666666664
2364,1934,-694,22,14,36,61.11,0.008125000000000002,25.166666666666668
2365,2380,-2080,12,12,24,50.0,-0.00364166666666667,52.25
2367,2468,7412,15,11,26,57.69,0.009023076923076924,31.423076923076923
2368,3530,23340,23,9,32,71.88,0.03666875,23.53125
2369,2347,843,17,12,29,58.62,0.010689655172413794,20.96551724137931
2371,3212,-7542,18,19,37,48.65,-0.009354054054054055,31.45945945945946
2373,5419,-26559,7,13,20,35.0,-0.037455,116.55
2374,4255,6765,15,11,26,57.69,0.008403846153846154,37.76923076923077
2375,5287,12913,15,13,28,53.57,-7.142857142858339e-06,32.92857142857143
2376,6741,26869,19,9,28,67.86,0.029685714285714287,36.0
2377,9696,21304,17,10,27,62.96,0.02262222222222223,35.333333333333336
2379,23933,94127,15,12,27,55.56,0.005118518518518522,30.11111111111111
2380,1742,9198,11,8,19,57.89,0.008263157894736842,46.05263157894737
2382,10252,21798,16,12,28,57.14,0.008432142857142859,52.214285714285715
2383,9545,-1825,13,11,24,54.17,0.002149999999999999,33.083333333333336
2385,9361,32759,14,8,22,63.64,0.02146818181818182,64.4090909090909
2387,4122,-27242,11,17,28,39.29,-0.02742142857142857,32.607142857142854
2388,5295,5235,18,16,34,52.94,-0.00015294117647058936,16.205882352941178
2390,2232,9518,16,8,24,66.67,0.02645,29.166666666666668
2392,12006,-15916,17,17,34,50.0,-0.00588235294117647,35.73529411764706
2393,10740,26900,18,14,32,56.25,0.006681250000000003,39.625
2395,22196,-159066,8,13,21,38.1,-0.024880952380952375,60.04761904761905
2397,7052,-13892,11,13,24,45.83,-0.016337499999999994,72.16666666666667
2399,2720,-6990,15,15,30,50.0,-0.006596666666666664,32.56666666666667
2401,5662,-25652,17,18,35,48.57,-0.010414285714285714,22.485714285714284
2402,5339,-26199,17,20,37,45.95,-0.014016216216216215,23.0
2404,8395,43485,16,7,23,69.57,0.03680434782608695,45.43478260869565
2405,2454,14526,17,9,26,65.38,0.02414615384615384,26.73076923076923
2406,3094,3926,15,15,30,50.0,-0.007556666666666669,19.166666666666668
2408,8295,-915,17,18,35,48.57,-0.01027428571428571,26.62857142857143
2409,6630,-2010,18,15,33,54.55,0.0030484848484848494,29.363636363636363
2412,4279,-1529,5,4,9,55.56,-0.0032222222222222157,366.44444444444446
2413,3111,-2901,17,16,33,51.52,-0.003218181818181816,28.636363636363637
2414,2589,15151,16,8,24,66.67,0.0272125,63.25
2415,2380,13890,15,6,21,71.43,0.03675238095238097,32.38095238095238
2417,5028,11952,18,14,32,56.25,0.004796875000000001,31.78125
2419,2450,4350,15,12,27,55.56,0.004374074074074075,21.666666666666668
2420,5128,5762,16,13,29,55.17,0.0015655172413793117,40.241379310344826
2421,3382,-12322,10,13,23,43.48,-0.018956521739130434,47.69565217391305
2423,2488,-5658,9,11,20,45.0,-0.012424999999999995,90.75
2424,3009,-20639,7,15,22,31.82,-0.043245454545454545,33.09090909090909
2425,4418,-17398,15,20,35,42.86,-0.021668571428571426,31.34285714285714
2426,3114,-4464,13,16,29,44.83,-0.01670344827586207,29.724137931034484
2427,1429,71,10,10,20,50.0,-0.00791,52.6
2428,9025,-5635,10,15,25,40.0,-0.022087999999999997,37.08
2429,1306,1794,13,5,18,72.22,0.026627777777777778,26.833333333333332
2430,5215,50365,17,6,23,73.91,0.04196521739130434,80.1304347826087
2431,2034,13226,17,6,23,73.91,0.041039130434782606,21.956521739130434
2433,3720,-8430,13,11,24,54.17,0.0020583333333333356,78.16666666666667
2434,3205,-8975,16,15,31,51.61,-0.004109677419354841,33.03225806451613
2436,4413,-24233,13,18,31,41.94,-0.02205806451612903,28.06451612903226
2438,2007,-4737,13,19,32,40.62,-0.030871874999999997,28.875
2439,13427,-13887,12,16,28,42.86,-0.021060714285714287,25.464285714285715
2440,1495,455,12,9,21,57.14,0.006261904761904759,23.952380952380953
2441,5734,5406,15,10,25,60.0,0.014128,57.72
2442,2805,-5795,20,20,40,50.0,-0.007557499999999999,28.775
2443,1628,222,16,13,29,55.17,-0.0017068965517241389,20.896551724137932
2444,2310,6500,17,11,28,60.71,0.014428571428571428,16.714285714285715
2449,6111,-18811,19,24,43,44.19,-0.01900930232558139,35.395348837209305
2450,8683,17487,16,15,31,51.61,-0.0026806451612903215,63.58064516129032
2451,14321,-47181,13,16,29,44.83,-0.016272413793103447,60.310344827586206
2453,2661,4379,19,12,31,61.29,0.01594193548387097,34.516129032258064
2454,73740,434260,22,12,34,64.71,0.023429411764705886,33.61764705882353
2455,10016,-34676,16,16,32,50.0,-0.005962500000000001,18.4375
2457,3985,-17935,15,14,29,51.72,-0.0026413793103448268,34.3448275862069
2458,8347,-37407,14,13,27,51.85,-0.00225555555555555,24.666666666666668
2459,7143,-16213,16,18,34,47.06,-0.011761764705882354,63.411764705882355
2460,2527,12393,14,7,21,66.67,0.027066666666666666,45.666666666666664
2461,2670,4350,12,11,23,52.17,-0.004526086956521737,41.78260869565217
2462,4035,14065,17,10,27,62.96,0.02011111111111111,39.25925925925926
2464,4050,5900,11,9,20,55.0,0.0040950000000000005,54.25
2465,2662,17468,18,11,29,62.07,0.01627931034482758,21.75862068965517
2466,2775,-2605,10,10,20,50.0,-0.0063500000000000015,75.9
2467,4416,17114,21,13,34,61.76,0.017535294117647062,42.3235294117647
2468,1538,-2408,10,10,20,50.0,-0.006414999999999997,60.7
2471,1681,7609,12,5,17,70.59,0.03994117647058824,34.529411764705884
2472,4915,1755,14,12,26,53.85,0.001569230769230771,23.884615384615383
2474,33366,-49756,12,14,26,46.15,-0.01355384615384615,35.11538461538461
2476,4870,27870,18,10,28,64.29,0.02269642857142857,29.678571428571427
2477,3559,34071,21,5,26,80.77,0.05553461538461539,28.692307692307693
2478,4178,27592,17,6,23,73.91,0.04198695652173913,39.30434782608695
2480,4300,-13710,9,15,24,37.5,-0.031004166666666666,91.08333333333333
2481,5095,-12995,18,12,30,60.0,0.01388333333333334,16.7
2482,2392,-4612,12,11,23,52.17,-0.001669565217391305,46.65217391304348
2483,2657,-9767,11,12,23,47.83,-0.010317391304347823,44.82608695652174
2484,2603,10557,15,9,24,62.5,0.018750000000000003,37.333333333333336
2485,3994,7976,12,7,19,63.16,0.0205578947368421,22.526315789473685
2486,3494,6166,15,11,26,57.69,0.008930769230769233,32.42307692307692
2488,3197,7223,14,9,23,60.87,0.015860869565217393,47.08695652173913
2489,3076,20094,18,7,25,72.0,0.037676,29.28
2491,1242,-1262,9,10,19,47.37,-0.014736842105263156,17.263157894736842
2492,12822,72248,18,11,29,62.07,0.017693103448275863,24.448275862068964
2493,3797,22593,20,9,29,68.97,0.03371724137931034,65.44827586206897
2495,4093,-5923,12,13,25,48.0,-0.008247999999999998,60.96
2496,7138,-10978,8,11,19,42.11,-0.018147368421052627,20.36842105263158
2497,5040,12580,15,10,25,60.0,0.014055999999999999,30.0
2498,65381,-38921,19,19,38,50.0,-0.0058789473684210496,26.710526315789473
2501,2281,-2021,11,12,23,47.83,-0.010399999999999994,70.65217391304348
2504,2435,6285,19,9,28,67.86,0.02491428571428572,48.857142857142854
2505,2553,-8723,13,13,26,50.0,-0.009919230769230767,40.34615384615385
2506,1671,-911,15,12,27,55.56,-0.0017148148148148146,46.407407407407405
2509,3300,300,13,13,26,50.0,-0.006299999999999998,53.03846153846154
2511,1097,7293,10,4,14,71.43,0.03476428571428571,40.42857142857143
2514,1247,1013,7,6,13,53.85,0.0016846153846153827,46.76923076923077
2515,2008,3312,19,13,32,59.38,0.010009375000000004,42.375
2516,1452,1418,15,9,24,62.5,0.015166666666666667,72.0
2520,4677,-647,22,16,38,57.89,0.00955526315789474,28.07894736842105
2524,4314,11396,18,9,27,66.67,0.027244444444444446,51.44444444444444
2527,3184,9126,20,12,32,62.5,0.017306250000000002,35.84375
2528,1617,6373,14,7,21,66.67,0.02881428571428571,26.952380952380953
2530,1832,3228,14,10,24,58.33,0.008479166666666668,29.791666666666668
2534,3579,-8669,15,16,31,48.39,-0.010848387096774194,46.935483870967744
2535,2833,8037,16,9,25,64.0,0.021928,50.04
2536,4921,-18991,13,15,28,46.43,-0.011646428571428571,52.892857142857146
2537,1295,3685,13,5,18,72.22,0.03475555555555555,57.333333333333336
2538,2367,2133,16,12,28,57.14,0.006925000000000001,43.25
2539,0,0,0,0,0,0.0,,
2540,2114,-13694,4,7,11,36.36,-0.038863636363636364,34.0
2542,6834,-27144,10,15,25,40.0,-0.025987999999999997,57.76
2543,2106,-2286,16,16,32,50.0,-0.008303125000000001,33.5625
2545,7460,-36050,10,17,27,37.04,-0.03180740740740741,46.81481481481482
2546,3011,8309,16,12,28,57.14,0.0049321428571428546,38.464285714285715
2547,4721,27729,25,14,39,64.1,0.021815384615384608,34.0
2548,6457,-11567,9,8,17,52.94,0.0008176470588235299,37.23529411764706
2597,4394,2926,6,8,14,42.86,-0.020192857142857134,81.64285714285714
2601,4262,23758,17,12,29,58.62,0.010403448275862067,33.41379310344828
2603,4438,-56018,8,16,24,33.33,-0.03922916666666666,49.0
2605,3823,717,12,12,24,50.0,-0.005916666666666665,71.08333333333333
2606,5612,-18842,8,12,20,40.0,-0.020939999999999997,60.0
2607,3036,-3566,13,13,26,50.0,-0.005953846153846152,74.42307692307692
2608,3249,23391,13,6,19,68.42,0.034852631578947364,91.26315789473684
2609,3872,3948,16,8,24,66.67,0.027125,32.916666666666664
2610,2002,-2462,12,12,24,50.0,-0.006345833333333333,59.458333333333336
2611,1726,-1826,11,11,22,50.0,-0.006913636363636367,59.81818181818182
2612,5417,-14197,13,16,29,44.83,-0.01644137931034483,38.310344827586206
2613,1946,-5066,9,14,23,39.13,-0.02826956521739131,46.52173913043478
2614,2144,-8224,14,15,29,48.28,-0.012144827586206898,33.55172413793103
2615,5398,-10108,20,10,30,66.67,0.027423333333333334,40.43333333333333
2616,1628,3782,7,5,12,58.33,0.010674999999999999,162.25
2617,4678,38752,17,6,23,73.91,0.04183913043478261,39.56521739130435
2618,3067,-12037,13,20,33,39.39,-0.027384848484848484,58.121212121212125
2630,1139,-2599,4,5,9,44.44,-0.016977777777777776,61.0
2633,1451,6839,5,3,8,62.5,0.019187500000000003,85.125
2634,2818,19872,10,4,14,71.43,0.036800000000000006,72.85714285714286
2636,3593,-15103,6,10,16,37.5,-0.0309125,65.4375
2637,2873,-21623,4,8,12,33.33,-0.039224999999999996,97.66666666666667
2642,4881,24909,12,7,19,63.16,0.02047894736842105,41.78947368421053
2701,1463,-5323,7,10,17,41.18,-0.0277764705882353,95.29411764705883
2702,3938,-31748,8,20,28,28.57,-0.05216428571428572,48.57142857142857
2704,3908,-4238,10,12,22,45.45,-0.01142727272727273,93.0909090909091
2705,2681,5839,18,10,28,64.29,0.02233214285714286,27.678571428571427
2706,2367,-19287,5,13,18,27.78,-0.050338888888888884,134.83333333333334
2707,26250,321830,14,5,19,73.68,0.041336842105263165,54.78947368421053
2712,1205,14535,5,1,6,83.33,0.06063333333333334,44.333333333333336
2722,1441,5299,5,3,8,62.5,0.019025,34.75
2723,27761,51889,13,10,23,56.52,0.010339130434782611,23.82608695652174
2727,18250,-38850,8,8,16,50.0,-0.0008499999999999966,66.25
2731,9008,-3318,8,7,15,53.33,0.0007466666666666659,43.8
2739,1998,-11158,4,8,12,33.33,-0.039200000000000006,59.083333333333336
2748,1143,-3173,2,2,4,50.0,-0.0057,62.75
2801,2484,-11044,10,14,24,41.67,-0.022475,85.70833333333333
2809,3772,-612,16,14,30,53.33,3.6666666666666794e-05,58.766666666666666
2812,1643,-6343,10,14,24,41.67,-0.02745416666666667,109.875
2816,2751,-8041,13,14,27,48.15,-0.010048148148148152,46.25925925925926
2820,1232,7928,13,4,17,76.47,0.05070588235294117,146.0
2832,1498,-5578,5,7,12,41.67,-0.022425,188.66666666666666
2834,1536,-4186,11,12,23,47.83,-0.011895652173913042,113.21739130434783
2836,2352,198,14,13,27,51.85,-0.0029222222222222228,93.62962962962963
2838,1625,2535,14,10,24,58.33,0.008875,106.33333333333333
2845,1864,2606,14,10,24,58.33,0.010074999999999999,104.5
2849,1732,-2212,10,12,22,45.45,-0.016040909090909092,67.77272727272727
2850,3276,5294,14,10,24,58.33,0.0104125,75.75
2851,2322,798,12,10,22,54.55,0.0030318181818181824,88.5
2852,1121,1789,7,6,13,53.85,0.0012538461538461536,100.76923076923077
2855,2429,4541,14,11,25,56.0,0.005948000000000002,71.8
2867,804,-1194,4,5,9,44.44,-0.017544444444444446,64.44444444444444
2880,2761,8019,13,9,22,59.09,0.01221363636363636,93.22727272727273
2881,6638,27862,17,10,27,62.96,0.01737037037037037,77.37037037037037
2882,10780,10370,20,17,37,54.05,0.0024324324324324397,76.70270270270271
2883,2078,-688,15,13,28,53.57,0.00015357142857142653,58.607142857142854
2884,2957,-18617,10,16,26,38.46,-0.031188461538461536,99.96153846153847
2885,2706,2244,16,12,28,57.14,0.010392857142857145,71.71428571428571
2886,3021,-22981,7,16,23,30.43,-0.04502608695652173,72.56521739130434
2887,2787,-7127,13,16,29,44.83,-0.01639655172413793,57.10344827586207
2888,4346,-2906,20,21,41,48.78,-0.007124390243902437,34.707317073170735
2889,1326,794,10,9,19,52.63,-0.0020052631578947357,136.89473684210526
2890,2236,-9866,11,18,29,37.93,-0.030868965517241373,62.55172413793103
2891,3365,-8615,10,14,24,41.67,-0.020862499999999996,77.95833333333333
2892,4241,1849,18,16,34,52.94,1.1764705882353686e-05,102.91176470588235
2897,455,-1425,3,4,7,42.86,-0.02202857142857143,177.71428571428572
2901,1773,147,6,6,12,50.0,-0.005691666666666664,76.41666666666667
2903,4501,16969,19,10,29,65.52,0.021893103448275858,54.93103448275862
2904,2177,8383,14,8,22,63.64,0.019868181818181816,70.68181818181819
2905,3471,-4581,14,16,30,46.67,-0.01285333333333333,57.53333333333333
2906,957,-4417,5,8,13,38.46,-0.02996153846153846,115.07692307692308
2908,1533,3127,8,5,13,61.54,0.017123076923076925,121.84615384615384
2910,2239,2041,8,6,14,57.14,0.00445,44.0
2911,2881,7189,14,12,26,53.85,0.0011615384615384612,42.92307692307692
2912,28214,-66064,15,13,28,53.57,0.001153571428571434,94.10714285714286
2913,1670,10400,13,6,19,68.42,0.029063157894736843,74.78947368421052
2915,9770,44760,19,9,28,67.86,0.029746428571428573,44.25
2923,1157,-577,4,4,8,50.0,-0.0057125000000000006,43.75
2929,5027,-28957,4,6,10,40.0,-0.025809999999999993,44.0
2939,4686,51434,6,2,8,75.0,0.044325,30.5
3002,1940,-7900,8,12,20,40.0,-0.026250000000000002,37.2
3003,5793,33597,17,8,25,68.0,0.029956,31.68
3004,6628,-31078,10,18,28,35.71,-0.03587499999999999,34.142857142857146
3005,4406,7054,17,12,29,58.62,0.011296551724137934,45.96551724137931
3006,10646,-21826,17,17,34,50.0,-0.005855882352941176,19.5
3008,336585,-602435,21,14,35,60.0,0.014162857142857149,21.571428571428573
3010,7876,48914,18,8,26,69.23,0.03253461538461539,71.76923076923077
3011,2231,-7451,16,13,29,55.17,0.0030689655172413807,39.44827586206897
3013,2668,-1898,12,15,27,44.44,-0.017222222222222222,34.666666666666664
3014,9474,21796,18,16,34,52.94,-6.176470588234818e-05,37.411764705882355
3015,4743,-28853,10,17,27,37.04,-0.02799259259259259,61.111111111111114
3016,6915,25195,17,16,33,51.52,-0.0030090909090909074,18.333333333333332
3017,8179,5881,18,18,36,50.0,-0.0058527777777777745,28.916666666666668
3018,3349,-35049,7,22,29,24.14,-0.054958620689655166,23.689655172413794
3019,10787,1383,15,14,29,51.72,-0.0024551724137930994,25.344827586206897
3021,2218,-7458,11,14,25,44.0,-0.019379999999999998,48.16
3022,5906,42574,16,7,23,69.57,0.0332304347826087,54.869565217391305
3023,10568,20392,17,13,30,56.67,0.007393333333333335,58.9
3024,2793,-16253,14,18,32,43.75,-0.0199125,33.09375
3025,3605,-7475,18,18,36,50.0,-0.006438888888888891,27.13888888888889
3026,9992,23008,15,13,28,53.57,0.0012750000000000018,46.107142857142854
3027,2934,-11904,12,16,28,42.86,-0.020592857142857142,33.785714285714285
3028,2732,-1272,11,9,20,55.0,-0.0004799999999999997,66.7
3029,2797,5153,14,10,24,58.33,0.010325,36.166666666666664
3030,8383,-24663,14,19,33,42.42,-0.0178030303030303,50.24242424242424
3031,4894,13706,16,15,31,51.61,-0.002712903225806448,24.06451612903226
3032,3763,-4723,17,14,31,54.84,0.0034935483870967743,37.70967741935484
3033,2360,-410,9,10,19,47.37,-0.006478947368421051,67.94736842105263
3034,22474,108536,16,10,26,61.54,0.017100000000000004,43.80769230769231
3035,12666,-78986,15,18,33,45.45,-0.014969696969696966,21.96969696969697
3036,6420,2980,13,12,25,52.0,-0.004551999999999997,91.56
3037,6862,-5212,16,15,31,51.61,-0.0026322580645161257,28.93548387096774
3038,2670,-9750,13,16,29,44.83,-0.01763103448275862,32.275862068965516
3040,3585,15675,14,10,24,58.33,0.010716666666666671,46.583333333333336
3041,5961,33859,20,10,30,66.67,0.027363333333333337,21.2
3042,7515,7185,15,11,26,57.69,0.0060769230769230805,50.65384615384615
3043,3799,12961,14,6,20,70.0,0.030474999999999995,18.05
3044,9039,-48129,8,11,19,42.11,-0.021631578947368415,39.36842105263158
3045,7536,-54686,6,11,17,35.29,-0.04095294117647058,98.23529411764706
3046,2895,7675,18,8,26,69.23,0.030761538461538465,21.615384615384617
3047,2183,12477,17,8,25,68.0,0.02932,40.0
3048,2525,12425,18,7,25,72.0,0.034352,45.08
3049,2755,-6885,17,16,33,51.52,-0.003975757575757575,23.727272727272727
3050,2544,7246,17,8,25,68.0,0.028387999999999997,21.28
3051,5408,-21218,17,14,31,54.84,-0.001593548387096776,12.32258064516129
3052,2263,4567,19,13,32,59.38,0.0111125,56.90625
3054,3480,11150,14,11,25,56.0,0.005867999999999997,33.04
3055,3547,13693,19,10,29,65.52,0.023427586206896556,42.0
3056,3246,2354,14,13,27,51.85,-0.0028777777777777786,48.74074074074074
3057,2208,622,9,7,16,56.25,0.0019062500000000008,26.1875
3058,2036,844,12,13,25,48.0,-0.010867999999999997,42.68
3059,5638,-1748,14,13,27,51.85,-0.002111111111111111,24.40740740740741
3060,9745,-995,14,16,30,46.67,-0.012563333333333336,30.2
3062,6305,16535,17,15,32,53.12,0.0004812500000000025,27.3125
3090,6942,-11202,15,14,29,51.72,-0.005579310344827585,39.48275862068966
3094,3754,-8164,10,11,21,47.62,-0.010709523809523808,41.285714285714285
3130,14532,-87742,7,11,18,38.89,-0.028238888888888886,70.88888888888889
3138,6761,7659,11,5,16,68.75,0.03025625,38.9375
3149,3356,13054,12,6,18,66.67,0.027088888888888895,24.555555555555557
3164,2918,-15258,7,11,18,38.89,-0.028122222222222222,62.666666666666664
3167,4149,4811,7,7,14,50.0,-0.005785714285714283,40.714285714285715
3189,6600,8360,10,8,18,55.56,0.005166666666666668,31.0
3209,4191,-5261,15,14,29,51.72,-0.0008206896551724126,32.689655172413794
3229,2277,5563,11,10,21,52.38,-0.0015190476190476176,25.428571428571427
3231,6439,-10949,16,18,34,47.06,-0.009811764705882351,40.23529411764706
3257,4693,36627,11,4,15,73.33,0.04086,43.46666666666667
3266,3096,-14666,10,15,25,40.0,-0.026035999999999997,39.0
3296,3967,23823,16,7,23,69.57,0.03322608695652174,31.08695652173913
3305,8029,-7479,14,14,28,50.0,-0.005807142857142857,35.107142857142854
3308,1423,167,11,8,19,57.89,0.010826315789473686,34.63157894736842
3311,10286,-25226,14,14,28,50.0,-0.005864285714285713,24.928571428571427
3312,1699,10701,12,6,18,66.67,0.02698888888888889,39.611111111111114
3321,574,-1914,3,4,7,42.86,-0.020399999999999998,23.0
3338,4572,27118,10,6,16,62.5,0.019143749999999998,26.875
3346,4420,16840,8,5,13,61.54,0.017184615384615385,25.846153846153847
3356,17308,69122,17,15,32,53.12,0.00034062500000000325,48.0625
3376,12794,-113034,7,13,20,35.0,-0.035744999999999985,28.5
3380,3452,-13082,11,15,26,42.31,-0.023107692307692305,37.07692307692308
3406,47920,116900,17,13,30,56.67,0.007503333333333336,14.333333333333334
3413,16100,16250,10,7,17,58.82,0.011717647058823536,22.58823529411765
3416,9566,-1116,13,13,26,50.0,-0.00340384615384615,74.0
3419,3471,16369,18,11,29,62.07,0.01816896551724138,30.482758620689655
3432,2517,-4697,15,12,27,55.56,0.004814814814814816,36.51851851851852
3437,2680,20360,12,4,16,75.0,0.0440875,26.5
3443,22193,-15403,9,10,19,47.37,-0.011152631578947364,42.473684210526315
3450,10924,-38854,12,15,27,44.44,-0.016996296296296294,22.59259259259259
3454,8877,55463,12,5,17,70.59,0.0351764705882353,35.411764705882355
3481,3212,-7422,7,13,20,35.0,-0.03615499999999999,27.95
3494,2078,782,11,12,23,47.83,-0.01156521739130435,25.26086956521739
3501,5165,-2565,10,10,20,50.0,-0.0059349999999999984,55.65
3504,12870,-780,18,12,30,60.0,0.01411666666666667,21.066666666666666
3515,8019,77061,11,4,15,73.33,0.04084,38.666666666666664
3518,8530,9470,15,13,28,53.57,0.0011714285714285748,24.928571428571427
3528,2350,-1110,6,6,12,50.0,0.00020833333333333524,119.33333333333333
3530,12057,41783,17,13,30,56.67,0.007273333333333336,30.9
3532,11698,-958,10,10,20,50.0,-0.005849999999999997,29.55
3533,25078,-126318,8,15,23,34.78,-0.0331391304347826,32.91304347826087
3535,2129,-2869,12,9,21,57.14,0.008057142857142855,18.476190476190474
3536,2148,-7518,12,18,30,40.0,-0.02817333333333334,20.933333333333334
3543,2942,10198,12,10,22,54.55,-0.0003727272727272722,38.95454545454545
3545,6347,-8317,12,12,24,50.0,-0.00594583333333333,15.458333333333334
3550,1739,-9559,6,11,17,35.29,-0.03534705882352941,37.11764705882353
3557,4145,-7495,11,10,21,52.38,-0.0024714285714285715,30.238095238095237
3563,24379,-35699,11,12,23,47.83,-0.010204347826086953,29.130434782608695
3576,1894,-9264,7,11,18,38.89,-0.028399999999999998,22.22222222222222
3583,3573,-20053,4,6,10,40.0,-0.025879999999999997,34.3
3588,6231,-15001,7,8,15,46.67,-0.012499999999999995,29.733333333333334
3591,1924,236,7,5,12,58.33,0.010858333333333336,48.833333333333336
3593,1912,-3542,11,11,22,50.0,-0.006881818181818183,24.772727272727273
3596,9698,21522,16,9,25,64.0,0.025548000000000005,35.92
3605,5611,-34781,9,14,23,39.13,-0.02754782608695652,24.043478260869566
3607,5490,13930,12,10,22,54.55,0.006136363636363637,43.40909090909091
3617,9244,12366,12,9,21,57.14,0.008452380952380958,42.904761904761905
3622,8848,109252,13,5,18,72.22,0.03842777777777779,49.888888888888886
3645,4739,16421,13,7,20,65.0,0.024100000000000003,24.65
3653,20861,-11451,10,13,23,43.48,-0.01896086956521738,21.391304347826086
3661,24462,-58862,10,7,17,58.82,0.011758823529411768,10.941176470588236
3665,22214,-95934,8,13,21,38.1,-0.029790476190476183,30.714285714285715
3669,3058,292,8,9,17,47.06,-0.011688235294117647,36.1764705882353
3673,17695,51595,10,8,18,55.56,0.009388888888888891,27.27777777777778
3679,8152,33158,12,8,20,60.0,0.014110000000000001,31.0
3682,832,2448,8,4,12,66.67,0.018533333333333332,79.91666666666667
3686,1065,3685,7,6,13,53.85,0.0008769230769230765,20.53846153846154
3694,2337,4163,12,7,19,63.16,0.020373684210526315,29.63157894736842
3701,1960,-24440,5,11,16,31.25,-0.04505625,41.25
3702,5087,713,11,10,21,52.38,0.0010619047619047643,78.80952380952381
3703,1440,10100,11,4,15,73.33,0.040406666666666674,41.2
3704,1969,4471,11,7,18,61.11,0.016255555555555554,38.55555555555556
3705,3276,8164,7,5,12,58.33,0.010733333333333336,185.75
3706,2025,-4495,6,6,12,50.0,-0.0058,54.416666666666664
3708,5328,32852,7,3,10,70.0,0.034210000000000004,29.0
3711,2618,-19648,2,4,6,33.33,-0.03903333333333333,34.833333333333336
3712,1058,-5398,3,4,7,42.86,-0.020114285714285713,19.571428571428573
3714,1019,-3059,1,2,3,33.33,-0.039466666666666664,9.333333333333334
4104,8631,18909,17,12,29,58.62,0.0135551724137931,78.75862068965517
4106,5136,2924,17,12,29,58.62,0.011427586206896555,41.172413793103445
4108,6130,520,18,14,32,56.25,0.006678124999999998,22.8125
4119,12569,-17099,16,15,31,51.61,-0.0005935483870967702,43.67741935483871
4133,6441,4229,11,10,21,52.38,-0.001019047619047619,38.857142857142854
4137,17949,-12099,8,8,16,50.0,-0.005774999999999995,36.375
4142,2688,-18988,4,9,13,30.77,-0.04452307692307692,61.46153846153846
4155,5548,23312,15,10,25,60.0,0.017920000000000002,35.44
4164,4488,18812,9,6,15,60.0,0.014226666666666669,64.26666666666667
4190,9618,63342,12,5,17,70.59,0.03531764705882353,30.764705882352942
4306,2010,-3150,9,10,19,47.37,-0.006568421052631576,67.94736842105263
4414,1974,2546,14,11,25,56.0,0.004307999999999998,35.64
4426,8292,56748,16,11,27,59.26,0.012114814814814814,24.51851851851852
4438,6266,75684,7,1,8,87.5,0.0692625,69.25
4439,1788,29562,2,0,2,100.0,0.0943,28.0
4526,5119,-28309,9,21,30,30.0,-0.042809999999999994,54.4
4532,3093,4277,15,10,25,60.0,0.013888000000000001,36.84
4536,8388,5362,6,5,11,54.55,0.0033090909090909117,58.81818181818182
4540,2517,-14597,5,5,10,50.0,-0.0058600000000000015,53.0
4545,1354,-12194,2,6,8,25.0,-0.0559875,51.0
4551,3345,-43075,1,4,5,20.0,-0.0657,22.6
4552,2390,-11510,3,5,8,37.5,-0.017987499999999997,47.875
4555,3197,5833,5,4,9,55.56,0.00527777777777778,95.11111111111111
4557,2125,-22035,1,4,5,20.0,-0.06582,149.8
4560,1642,4698,3,3,6,50.0,0.006366666666666667,134.5
4562,687,-5197,1,3,4,25.0,-0.055825,104.75
4564,1734,18726,6,1,7,85.71,0.06561428571428571,30.571428571428573
4566,2153,7437,4,3,7,57.14,0.008485714285714282,69.0
4571,3143,-27163,2,3,5,40.0,-0.025759999999999995,37.0
4572,599,-10599,0,1,1,0.0,-0.106,79.0
4576,2839,-31239,1,4,5,20.0,-0.06606,24.0
4581,413,-7683,0,2,2,0.0,-0.10575,119.0
4720,1974,-1574,11,12,23,47.83,-0.010465217391304344,90.69565217391305
4722,1901,3529,9,6,15,60.0,0.013486666666666664,57.6
4737,5315,-19825,6,8,14,42.86,-0.020157142857142856,64.14285714285714
4739,3077,-1107,4,4,8,50.0,-0.005925,24.375
4746,6728,442,10,8,18,55.56,0.005272222222222227,51.111111111111114
4755,3164,-4364,7,6,13,53.85,0.0016923076923076948,68.07692307692308
4763,5114,10296,4,3,7,57.14,0.00845714285714286,25.571428571428573
4764,1562,9228,3,1,4,75.0,0.044225,57.75
4766,3120,23680,3,1,4,75.0,0.044075,74.5
4807,1568,6832,4,3,7,57.14,0.008571428571428572,58.42857142857143
4904,6117,-54277,7,14,21,33.33,-0.03921428571428571,158.57142857142858
4906,6433,-7753,14,15,29,48.28,-0.009341379310344823,24.655172413793103
4912,11146,-10886,8,10,18,44.44,-0.01705,20.72222222222222
4915,6094,35926,15,6,21,71.43,0.03698571428571428,30.333333333333332
4916,2609,5041,9,7,16,56.25,0.006681250000000003,21.9375
4919,5852,14278,9,10,19,47.37,-0.011136842105263155,23.473684210526315
4927,4373,-14513,7,9,16,43.75,-0.01845,33.375
4930,2173,-3703,8,9,17,47.06,-0.012152941176470589,42.411764705882355
4934,1481,-5671,6,9,15,40.0,-0.02247333333333333,15.866666666666667
4935,4603,10387,8,5,13,61.54,0.0172,45.15384615384615
4938,7288,-11338,9,11,20,45.0,-0.015804999999999993,36.85
4942,3412,-842,9,8,17,52.94,-0.004800000000000003,77.23529411764706
4943,9403,5157,7,5,12,58.33,0.010791666666666672,17.0
4952,3839,-4519,9,8,17,52.94,-1.764705882352992e-05,37.11764705882353
4956,2122,-3992,8,10,18,44.44,-0.012816666666666665,29.555555555555557
4958,10445,-50005,8,13,21,38.1,-0.029695238095238087,43.38095238095238
4960,1197,-2647,5,5,10,50.0,-0.00625,53.3
4961,7043,61477,13,4,17,76.47,0.047035294117647064,57.23529411764706
4967,2743,2537,7,7,14,50.0,-0.006057142857142856,29.428571428571427
4968,12078,6362,9,3,12,75.0,0.044125000000000004,11.833333333333334
4976,4021,7459,10,6,16,62.5,0.02123125,22.0625
4977,6074,-16534,7,7,14,50.0,-0.005807142857142852,42.785714285714285
4989,886,6494,4,1,5,80.0,0.05189999999999999,19.6
4994,9923,44547,10,5,15,66.67,0.027413333333333335,21.133333333333333
4999,3550,-3930,6,6,12,50.0,-0.005849999999999998,76.58333333333333
5007,3510,-6540,9,5,14,64.29,0.02152142857142858,95.42857142857143
5203,17453,39467,17,13,30,56.67,0.010310000000000005,48.166666666666664
5215,5555,45015,12,5,17,70.59,0.03527647058823529,38.05882352941177
5225,2560,-240,6,8,14,42.86,-0.020185714285714283,43.0
5234,6484,-23974,8,9,17,47.06,-0.011623529411764703,53.8235294117647
5243,2448,14652,8,3,11,72.73,0.03947272727272728,44.18181818181818
5258,1652,-13342,3,7,10,30.0,-0.04592999999999999,29.1
5269,47454,289376,9,4,13,69.23,0.03252307692307692,16.23076923076923
5283,4236,9914,5,4,9,55.56,0.012311111111111115,88.44444444444444
5284,2142,23908,6,1,7,85.71,0.053899999999999997,102.71428571428571
5285,1759,22121,5,1,6,83.33,0.06093333333333333,59.166666666666664
5288,7564,-23254,6,6,12,50.0,-0.005899999999999999,54.416666666666664
5388,7449,-19009,13,16,29,44.83,-0.016155172413793103,49.58620689655172
5434,12447,-9407,14,16,30,46.67,-0.012506666666666664,47.833333333333336
5469,3861,-10261,14,15,29,48.28,-0.009462068965517238,26.75862068965517
5471,7451,-4951,11,13,24,45.83,-0.010479166666666666,41.958333333333336
5484,2108,9112,11,7,18,61.11,0.014955555555555555,24.77777777777778
5515,2195,8855,13,10,23,56.52,0.0066304347826086915,66.34782608695652
5519,2776,-7956,8,10,18,44.44,-0.016911111111111113,47.27777777777778
5521,2189,-5459,13,17,30,43.33,-0.020373333333333323,53.36666666666667
5522,8715,-35855,12,18,30,40.0,-0.02861333333333333,64.8
5525,2037,-4937,6,9,15,40.0,-0.025940000000000005,65.53333333333333
5531,4954,-1304,11,15,26,42.31,-0.02522307692307692,30.307692307692307
5533,1189,-4209,4,6,10,40.0,-0.026070000000000003,115.1
5534,9321,32349,14,10,24,58.33,0.010770833333333335,47.75
5538,899,1781,3,2,5,60.0,0.01394,114.0
5546,781,6979,1,1,2,50.0,0.040499999999999994,21.0
5607,3366,524,13,12,25,52.0,-0.001916,56.2
5608,3728,10902,12,11,23,52.17,0.002417391304347828,64.95652173913044
5706,7990,11190,14,13,27,51.85,-0.0022333333333333324,53.629629629629626
5871,11776,-33716,9,7,16,56.25,0.006493750000000003,43.75
5876,2478,2552,5,5,10,50.0,0.0029100000000000024,122.1
5880,747,-5137,2,4,6,33.33,-0.02481666666666667,200.66666666666666
5906,1670,11440,11,5,16,68.75,0.030068749999999995,24.75
5907,3673,11907,13,5,18,72.22,0.03857222222222223,40.333333333333336
6005,1878,-7398,10,15,25,40.0,-0.026635999999999996,67.64
6024,2963,-7993,5,8,13,38.46,-0.02283076923076923,127.84615384615384
6108,4113,21547,20,11,31,64.52,0.026267741935483875,38.354838709677416
6112,4143,-11383,13,15,28,46.43,-0.013107142857142857,31.75
6115,3582,-312,7,8,15,46.67,-0.007826666666666664,84.0
6116,1755,12095,21,6,27,77.78,0.046400000000000004,30.48148148148148
6117,3061,2439,14,11,25,56.0,0.005968,45.88
6120,3806,-11916,11,16,27,40.74,-0.02472962962962963,28.074074074074073
6128,4021,-1061,12,11,23,52.17,0.002900000000000001,76.1304347826087
6133,2926,4014,17,14,31,54.84,0.0030451612903225813,43.354838709677416
6136,3599,9941,13,9,22,59.09,0.012377272727272725,97.77272727272727
6139,5634,18796,15,9,24,62.5,0.019070833333333332,52.25
6141,4321,18349,15,11,26,57.69,0.009403846153846157,31.23076923076923
6142,3447,-3317,22,15,37,59.46,0.011778378378378378,33.0
6152,4187,9093,16,12,28,57.14,0.0074749999999999955,28.071428571428573
6153,6805,-18855,15,21,36,41.67,-0.022519444444444443,19.305555555555557
6155,5118,3572,17,17,34,50.0,-0.003520588235294117,43.3235294117647
6164,2604,20076,20,6,26,76.92,0.04735769230769231,25.23076923076923
6165,3424,-564,17,15,32,53.12,-0.0005562499999999977,24.625
6166,7973,5757,15,14,29,51.72,-0.0024103448275862058,47.793103448275865
6168,5107,22933,20,12,32,62.5,0.022178125,23.71875
6176,10392,568,15,10,25,60.0,0.014060000000000001,33.24
6177,3400,-28670,8,17,25,32.0,-0.042224000000000005,34.72
6183,2995,-13565,6,14,20,30.0,-0.046134999999999995,103.9
6184,5261,14659,13,9,22,59.09,0.01627727272727273,130.9090909090909
6189,4309,3121,13,11,24,54.17,0.002395833333333333,92.16666666666667
6191,3180,-11050,10,11,21,47.62,-0.01118571428571428,40.23809523809524
6192,8822,-2432,14,13,27,51.85,0.0007851851851851854,61.25925925925926
6196,9923,-39083,16,22,38,42.11,-0.021752631578947367,35.39473684210526
6197,9262,-2462,14,16,30,46.67,-0.012529999999999993,43.733333333333334
6201,4072,-4922,10,12,22,45.45,-0.011190909090909086,86.5909090909091
6202,9838,4932,18,13,31,58.06,0.008458064516129035,43.87096774193548
6205,4942,5598,15,9,24,62.5,0.019120833333333326,38.666666666666664
6206,16441,-93381,12,21,33,36.36,-0.03312727272727273,54.57575757575758
6209,8225,-81115,11,20,31,35.48,-0.03478064516129032,22.29032258064516
6213,10165,-56665,14,16,30,46.67,-0.012596666666666664,28.966666666666665
6214,7570,-7520,14,14,28,50.0,-0.0031214285714285693,50.07142857142857
6215,3642,-1322,13,13,26,50.0,-0.005892307692307692,28.846153846153847
6216,5209,25451,15,11,26,57.69,0.009450000000000002,62.53846153846154
6224,8512,-39982,11,16,27,40.74,-0.024411111111111113,45.81481481481482
6225,2166,8734,12,9,21,57.14,0.006047619047619045,15.333333333333334
6226,2715,-155,18,18,36,50.0,-0.006902777777777777,31.916666666666668
6230,12871,18059,15,9,24,62.5,0.019191666666666666,24.208333333333332
6235,3005,-795,11,10,21,52.38,-0.001861904761904763,36.19047619047619
6239,8172,23678,11,7,18,61.11,0.013772222222222227,68.5
6243,6943,-33193,10,16,26,38.46,-0.028934615384615378,21.73076923076923
6257,4283,6657,16,10,26,61.54,0.017046153846153846,37.34615384615385
6269,10063,62407,17,9,26,65.38,0.021265384615384617,22.384615384615383
6271,16191,-103161,9,13,22,40.91,-0.023977272727272722,30.5
6277,9082,15488,12,9,21,57.14,0.012071428571428575,101.47619047619048
6278,9634,47506,19,9,28,67.86,0.029814285714285713,48.535714285714285
6281,4779,-9939,9,8,17,52.94,-7.058823529411477e-05,117.58823529411765
6282,3198,13112,15,9,24,62.5,0.0190875,41.583333333333336
6283,4050,7810,17,13,30,56.67,0.006570000000000002,19.766666666666666
6285,11817,15003,15,13,28,53.57,0.001267857142857145,39.392857142857146
6288,0,0,0,0,0,0.0,,
6405,1091,-12961,2,5,7,28.57,-0.038542857142857136,22.285714285714285
6409,69221,-170571,7,9,16,43.75,-0.018331249999999993,32.375
6412,3494,-31814,3,8,11,27.27,-0.044481818181818185,108.27272727272727
6414,24963,77437,9,6,15,60.0,0.013940000000000008,23.4
6415,80031,561519,10,5,15,66.67,0.027373333333333336,20.866666666666667
6416,10616,35094,10,7,17,58.82,0.011723529411764707,22.294117647058822
6431,1099,-9079,3,6,9,33.33,-0.039377777777777775,34.55555555555556
6438,5209,-1989,5,6,11,45.45,-0.007336363636363632,41.18181818181818
6442,3407,-4437,6,7,13,46.15,-0.013469230769230772,48.46153846153846
6443,2086,9094,8,8,16,50.0,-0.007025,26.9375
6449,2674,-214,5,5,10,50.0,-0.005849999999999999,27.6
6451,6329,3391,6,5,11,54.55,0.003309090909090913,25.727272727272727
6456,12960,-18810,6,8,14,42.86,-0.02471428571428571,29.5
6464,2728,-5998,2,2,4,50.0,-0.005699999999999997,230.75
6477,1578,722,4,5,9,44.44,-0.01707777777777778,23.88888888888889
6491,13284,-40944,5,4,9,55.56,0.005088888888888891,34.22222222222222
6504,9594,27056,6,5,11,54.55,0.009609090909090913,44.18181818181818
6505,10679,4481,11,11,22,50.0,-0.005877272727272723,99.31818181818181
6515,10272,31078,3,2,5,60.0,0.014299999999999998,14.8
6525,2767,-11607,3,4,7,42.86,-0.03034285714285714,70.14285714285714
6531,17346,-34086,8,6,14,57.14,0.00841428571428572,23.142857142857142
6533,10144,-70194,5,6,11,45.45,-0.015009090909090906,11.090909090909092
6541,4997,6913,5,6,11,45.45,-0.014963636363636366,21.545454545454547
6552,4316,5314,6,5,11,54.55,0.0032545454545454583,21.545454545454547
6558,1277,-557,3,3,6,50.0,0.0017000000000000012,18.333333333333332
6573,874,5816,3,2,5,60.0,0.014059999999999998,37.4
6579,1728,28562,3,0,3,100.0,0.0943,106.66666666666667
6581,4241,-11261,4,4,8,50.0,-0.005849999999999994,50.25
6582,4589,25051,4,4,8,50.0,-0.005787500000000001,63.0
6591,2952,-22802,3,6,9,33.33,-0.03458888888888889,15.222222222222221
6592,1461,-8601,1,2,3,33.33,-0.03923333333333332,149.33333333333334
6598,1635,3985,4,3,7,57.14,0.008414285714285721,16.428571428571427
6605,7556,-34006,5,11,16,31.25,-0.04333125,75.0
6625,1833,1867,4,5,9,44.44,-0.006355555555555553,53.55555555555556
6641,2264,5306,3,3,6,50.0,0.01131666666666667,62.166666666666664
6655,1898,-27298,1,5,6,16.67,-0.07241666666666666,50.166666666666664
6666,2531,-6451,2,2,4,50.0,-0.005850000000000001,41.0
6668,3709,-6139,5,5,10,50.0,-0.005719999999999996,29.0
6669,32754,-117554,3,4,7,42.86,-0.02015714285714285,19.428571428571427
6670,3140,16260,2,1,3,66.67,0.027333333333333334,54.333333333333336
6671,752,-5002,1,2,3,33.33,-0.03883333333333333,142.66666666666666
6672,3965,-38175,2,5,7,28.57,-0.04868571428571428,32.57142857142857
6674,669,11041,4,0,4,100.0,0.09425,39.25
6698,1665,3845,4,3,7,57.14,0.008400000000000001,26.571428571428573
6706,1559,25741,2,0,2,100.0,0.0943,24.0
6715,3221,5229,3,2,5,60.0,0.013940000000000004,19.6
6743,1590,-13110,1,2,3,33.33,-0.03943333333333333,11.666666666666666
6754,257,-4997,0,1,1,0.0,-0.1053,52.0
6756,1438,-25438,0,1,1,0.0,-0.106,10.0
8011,3351,5839,10,9,19,52.63,-0.0010263157894736823,35.578947368421055
8016,16525,57125,16,11,27,59.26,0.01421111111111111,27.037037037037038
8021,4050,-14050,11,13,24,45.83,-0.014179166666666665,49.416666666666664
8028,0,0,0,0,0,0.0,,
8033,2281,4629,13,12,25,52.0,-0.0026239999999999987,25.32
8039,8119,-14719,14,15,29,48.28,-0.009262068965517236,38.48275862068966
8046,15653,39987,14,13,27,51.85,-0.0021999999999999984,33.55555555555556
8070,10768,-37688,8,12,20,40.0,-0.025875,39.1
8072,7165,61365,11,5,16,68.75,0.031568750000000007,109.5625
8081,16633,-47833,8,13,21,38.1,-0.029638095238095234,42.904761904761905
8101,2193,5697,12,10,22,54.55,0.0001272727272727303,28.181818181818183
8103,4911,15849,14,8,22,63.64,0.021431818181818177,35.81818181818182
8104,0,0,0,0,0,0.0,,
8105,2975,16555,19,11,30,63.33,0.020346666666666666,25.033333333333335
8110,1779,-2069,11,12,23,47.83,-0.008208695652173912,27.130434782608695
8112,4146,-8216,16,17,33,48.48,-0.009212121212121211,35.93939393939394
8114,13223,-6983,12,10,22,54.55,0.00333636363636364,64.31818181818181
8131,3822,-3892,10,10,20,50.0,-0.005859999999999999,55.0
8150,3604,-30214,6,14,20,30.0,-0.045799999999999993,35.35
8163,5141,-2891,12,13,25,48.0,-0.012968,25.32
8201,2194,886,9,10,19,47.37,-0.011526315789473683,41.421052631578945
8210,7018,-18628,12,16,28,42.86,-0.020182142857142853,34.964285714285715
8213,4885,-4255,10,10,20,50.0,-0.005919999999999997,49.8
8215,1684,-9034,6,9,15,40.0,-0.025946666666666666,28.2
8222,950,-1210,4,5,9,44.44,-0.017111111111111108,54.55555555555556
8249,4557,2393,14,14,28,50.0,-0.005903571428571426,42.17857142857143
8261,7989,4051,17,15,32,53.12,0.0003031249999999996,16.71875
8271,2755,6925,8,5,13,61.54,0.017076923076923076,52.84615384615385
8341,11101,27269,5,5,10,50.0,-0.0059700000000000005,34.6
8367,1571,-15601,1,6,7,14.29,-0.07717142857142857,26.857142857142858
8374,4742,8558,16,12,28,57.14,0.008400000000000003,45.857142857142854
8404,3505,-28605,6,10,16,37.5,-0.03675625,41.0
8411,2112,6828,4,4,8,50.0,-0.005937499999999998,55.375
8422,9907,-12007,4,5,9,44.44,-0.017044444444444435,153.55555555555554
8429,4400,36310,11,4,15,73.33,0.04073333333333335,48.8
8442,2335,-9735,3,5,8,37.5,-0.0309,80.5
8443,1171,8789,8,3,11,72.73,0.03931818181818182,80.36363636363636
8454,32498,-318598,4,8,12,33.33,-0.03918333333333333,55.833333333333336
8462,14656,45784,9,7,16,56.25,0.003037500000000003,32.875
8463,2101,-11521,5,6,11,45.45,-0.014827272727272718,40.36363636363637
8464,12688,-70588,3,5,8,37.5,-0.030812499999999996,24.375
8466,2550,-10,4,2,6,66.67,0.020066666666666674,52.333333333333336
8467,1712,-10522,3,4,7,42.86,-0.020242857142857142,56.285714285714285
8473,1248,-2428,2,3,5,40.0,-0.025619999999999997,100.2
8478,3301,28979,8,2,10,80.0,0.0541,23.7
8480,2220,35280,3,0,3,100.0,0.0941,75.66666666666667
8481,2019,-2729,3,3,6,50.0,-0.005766666666666666,92.83333333333333
8482,1856,-27476,0,4,4,0.0,-0.07959999999999999,97.5
8488,764,9456,5,1,6,83.33,0.06068333333333334,66.83333333333333
8499,10058,51082,11,5,16,68.75,0.02898125,37.1875
8926,2675,8495,14,7,21,66.67,0.029971428571428566,105.42857142857143
8940,2170,-13010,6,13,19,31.58,-0.04276842105263158,92.3157894736842
8996,6866,-45756,10,15,25,40.0,-0.025911999999999998,26.12
9802,4181,29269,7,2,9,77.78,0.04945555555555556,22.22222222222222
9902,0,0,0,0,0,0.0,,
9904,4451,9739,14,10,24,58.33,0.011466666666666668,55.375
9905,2769,131,11,9,20,55.0,0.002225000000000007,109.2
9906,2937,-25287,6,12,18,33.33,-0.04601666666666667,35.666666666666664
9907,1890,820,11,12,23,47.83,-0.011117391304347827,70.34782608695652
9908,1898,252,8,8,16,50.0,-0.00115,145.5
9910,7559,-53269,7,7,14,50.0,-0.005964285714285708,102.0
9911,3575,-2645,10,13,23,43.48,-0.0194304347826087,57.26086956521739
9912,1229,4361,11,7,18,61.11,0.014516666666666669,49.111111111111114
9914,14944,-16854,14,9,23,60.87,0.01569130434782609,51.82608695652174
9917,5912,3758,9,8,17,52.94,0.003382352941176474,204.7058823529412
9918,2205,-55,6,6,12,50.0,-0.002333333333333335,146.16666666666666
9919,2427,-2457,12,12,24,50.0,-0.006045833333333333,74.45833333333333
9921,27016,-148026,11,19,30,36.67,-0.032536666666666665,53.333333333333336
9924,3990,2000,10,10,20,50.0,-0.006364999999999998,84.65
9925,2890,-1200,9,9,18,50.0,-0.008066666666666666,126.44444444444444
9926,3528,-8258,8,11,19,42.11,-0.025836842105263155,140.21052631578948
9927,5669,21411,20,9,29,68.97,0.032031034482758625,45.758620689655174
9928,2446,-3166,15,14,29,51.72,-0.003737931034482756,34.37931034482759
9929,1262,938,12,9,21,57.14,0.002933333333333336,52.095238095238095
9930,5769,11541,13,10,23,56.52,0.009160869565217394,151.65217391304347
9931,2578,-16898,5,11,16,31.25,-0.04364375,110.1875
9933,4665,-4865,10,12,22,45.45,-0.014936363636363637,62.09090909090909
9934,4340,-640,16,15,31,51.61,0.0006612903225806459,36.483870967741936
9935,2925,8725,15,12,27,55.56,0.004081481481481479,41.77777777777778
9937,2032,-16742,3,8,11,27.27,-0.046590909090909086,175.1818181818182
9938,11783,27927,20,16,36,55.56,0.005194444444444448,28.444444444444443
9939,7406,13574,15,10,25,60.0,0.010708000000000006,70.68
9940,8713,5777,12,14,26,46.15,-0.013526923076923075,64.26923076923077
9941,12761,80469,21,8,29,72.41,0.037689655172413794,66.20689655172414
9942,7292,-18642,11,10,21,52.38,-0.001199999999999996,101.52380952380952
9943,5607,8813,15,11,26,57.69,0.0074653846153846185,66.73076923076923
9944,3030,900,10,9,19,52.63,-0.0006631578947368414,65.47368421052632
9945,6838,31482,21,9,30,70.0,0.03359999999999999,38.1
9946,1170,3620,9,5,14,64.29,0.02227857142857143,45.57142857142857
9955,4353,-3813,11,11,22,50.0,-0.005927272727272726,36.54545454545455
9958,6074,36156,15,9,24,62.5,0.015675,45.166666666666664
1312A,1663,-2963,8,6,14,57.14,0.008292857142857142,119.21428571428571
2002A,3064,-664,7,7,14,50.0,-0.0059999999999999975,173.92857142857142
2836A,133,-833,0,1,1,0.0,-0.0358,526.0
2838A,0,0,0,0,0,0.0,,
2881A,360,340,1,0,1,100.0,0.0055,896.0
2881B,353,-253,0,1,1,0.0,-0.0042,896.0
2882A,354,-3154,0,1,1,0.0,-0.0502,1702.0
2882B,352,-1552,0,1,1,0.0,-0.0254,1428.0
2887E,303,-2203,0,1,1,0.0,-0.0414,1388.0
2887F,293,-2043,0,1,1,0.0,-0.0398,1304.0
2888A,233,-1983,0,1,1,0.0,-0.0481,366.0
2888B,245,3205,1,0,1,100.0,0.075,686.0
2891B,363,-3963,0,1,1,0.0,-0.0612,1105.0
2891C,354,-54,0,1,1,0.0,-0.0009,897.0
2897A,70,-220,0,1,1,0.0,-0.0215,853.0
3702A,285,-1035,0,1,1,0.0,-0.021,850.0
5871A,574,-2274,0,1,1,0.0,-0.0233,680.0
9941A,298,-1298,0,1,1,0.0,-0.0251,1330.0
1240,1824,-9184,2,4,6,33.33,-0.030616666666666667,53.833333333333336
1258,2685,-10055,7,9,16,43.75,-0.018499999999999996,43.9375
1259,5262,33948,7,4,11,63.64,0.026863636363636367,214.45454545454547
1264,8021,24029,4,2,6,66.67,0.0123,169.83333333333334
1268,2324,16476,2,1,3,66.67,0.027733333333333332,129.33333333333334
1336,2213,6627,12,7,19,63.16,0.020131578947368424,47.8421052631579
1565,40029,-2729,14,9,23,60.87,0.015817391304347835,30.08695652173913
1569,5151,-2121,12,15,27,44.44,-0.017111111111111108,29.62962962962963
1570,2241,7839,14,8,22,63.64,0.020454545454545458,42.22727272727273
1580,7484,-15184,6,8,14,42.86,-0.02007142857142857,78.71428571428571
1584,2486,1904,11,12,23,47.83,-0.01075217391304348,39.17391304347826
1586,2484,19146,9,3,12,75.0,0.044108333333333326,55.083333333333336
1591,950,-4180,2,4,6,33.33,-0.039316666666666666,28.833333333333332
1593,3319,-8839,5,6,11,45.45,-0.01506363636363636,115.0909090909091
1595,3859,20171,9,4,13,69.23,0.03255384615384616,50.07692307692308
1599,3927,-15377,6,9,15,40.0,-0.019213333333333336,41.06666666666667
1742,3231,-6211,10,11,21,47.62,-0.010819047619047614,36.76190476190476
1752,2774,15086,9,4,13,69.23,0.03256153846153846,67.23076923076923
1777,6170,24990,11,7,18,61.11,0.016233333333333336,88.38888888888889
1781,4616,29874,18,9,27,66.67,0.027385185185185183,26.074074074074073
1784,7710,-13240,12,16,28,42.86,-0.02013214285714286,25.25
1785,11228,34302,19,15,34,55.88,0.005855882352941178,26.294117647058822
1788,7953,69207,11,3,14,78.57,0.04726428571428572,98.71428571428571
1796,3504,29786,9,3,12,75.0,0.04397500000000001,66.25
1799,2325,-14995,5,11,16,31.25,-0.04359375,28.625
1813,2033,17257,9,3,12,75.0,0.04401666666666667,87.91666666666667
1815,3142,19598,20,9,29,68.97,0.03193793103448275,42.44827586206897
2035,2672,4028,8,6,14,57.14,0.008392857142857145,36.642857142857146
2061,1330,-1250,7,6,13,53.85,0.0013615384615384611,40.15384615384615
2063,2081,16979,8,3,11,72.73,0.039645454545454546,91.18181818181819
2064,849,-1719,3,4,7,42.86,-0.020257142857142862,65.42857142857143
2065,1933,6067,5,3,8,62.5,0.01895,101.875
2066,8277,-68027,5,10,15,33.33,-0.03911333333333333,53.4
2067,1194,-374,5,6,11,45.45,-0.015209090909090905,25.90909090909091
2070,1717,-19657,2,6,8,25.0,-0.0558125,117.5
2221,3167,-12267,8,13,21,38.1,-0.029757142857142857,28.476190476190474
2230,1638,-578,10,8,18,55.56,0.004905555555555555,60.833333333333336
2235,2743,-21703,2,6,8,25.0,-0.0559375,59.125
2596,2110,8790,11,7,18,61.11,0.01627777777777778,68.5
2640,7428,22452,10,7,17,58.82,0.014235294117647061,55.529411764705884
2641,1064,2646,8,5,13,61.54,0.015061538461538461,37.15384615384615
2643,3359,4371,6,5,11,54.55,0.003172727272727274,22.363636363636363
2718,1301,-3811,4,3,8,50.0,0.007500000000000007,67.5
2719,1611,5989,7,6,13,53.85,0.001592307692307691,44.61538461538461
2724,1342,1848,4,5,9,44.44,-0.018811111111111112,29.555555555555557
2726,2940,7720,5,4,9,55.56,0.005188888888888886,42.666666666666664
2729,13847,-98697,3,7,10,30.0,-0.045849999999999995,162.1
2732,6914,18996,7,5,12,58.33,0.010841666666666666,39.25
2734,1519,-12549,3,6,9,33.33,-0.03911111111111111,18.0
2736,1072,4988,5,3,8,62.5,0.018987500000000008,55.875
2740,701,-13671,0,4,4,0.0,-0.1054,40.75
2743,2538,-4548,7,6,13,53.85,0.0017846153846153888,20.23076923076923
2745,1152,2128,5,3,8,62.5,0.019025,53.625
2752,1846,-32646,0,2,2,0.0,-0.106,57.0
2754,1225,-7065,1,2,3,33.33,-0.039233333333333335,80.0
2755,634,-11794,0,2,2,0.0,-0.10569999999999999,57.5
2916,1190,6550,7,3,10,70.0,0.03393,123.7
2924,1229,19571,3,0,3,100.0,0.0941,64.33333333333333
2926,9031,-3561,6,4,10,60.0,0.014300000000000002,94.4
2937,1003,-8223,2,4,6,33.33,-0.03928333333333333,41.0
3064,9264,33616,21,8,29,72.41,0.036820689655172406,23.724137931034484
3066,2220,-9720,9,15,24,37.5,-0.032287500000000004,32.75
3067,971,-14831,1,7,8,12.5,-0.0813,73.0
3071,2428,242,14,10,24,58.33,0.0071958333333333345,34.75
3073,2277,-20477,7,13,20,35.0,-0.03766499999999999,13.65
3078,3935,8155,15,11,26,57.69,0.00928846153846154,32.23076923076923
3081,26992,-250792,4,12,16,25.0,-0.0558125,20.0625
3083,15236,19134,13,20,33,39.39,-0.027057575757575756,27.03030303030303
3085,3472,26978,20,8,28,71.43,0.03505714285714285,15.142857142857142
3086,3680,28390,15,8,23,65.22,0.024347826086956525,18.52173913043478
3088,6882,6308,14,11,25,56.0,0.006020000000000005,59.08
3089,2572,1768,14,11,25,56.0,0.005028,20.48
3092,3123,8617,11,4,15,73.33,0.040680000000000015,35.733333333333334
3093,6054,25176,11,7,18,61.11,0.016288888888888894,92.5
3095,3474,29016,15,11,26,57.69,0.005288461538461539,13.423076923076923
3105,13297,-70047,4,8,12,33.33,-0.039016666666666665,23.416666666666668
3114,3234,-1464,15,14,29,51.72,-0.00282413793103448,38.93103448275862
3115,1512,-10992,5,10,15,33.33,-0.03962666666666667,42.53333333333333
3118,4201,239,11,10,21,52.38,-0.005061904761904763,94.66666666666667
3122,1892,13598,8,5,13,61.54,0.01683076923076923,27.846153846153847
3128,2324,-2774,9,11,20,45.0,-0.016035,27.6
3131,20688,149862,14,4,18,77.78,0.04955555555555556,31.72222222222222
3141,5238,37992,11,5,16,68.75,0.031549999999999995,26.75
3147,2056,12584,6,3,9,66.67,0.027344444444444442,47.77777777777778
3152,27342,188328,14,6,20,70.0,0.03409,29.1
3162,2333,2337,11,10,21,52.38,-0.001871428571428573,30.333333333333332
3163,4866,9394,11,8,19,57.89,0.00985263157894737,20.526315789473685
3169,3798,20192,9,5,14,64.29,0.02270714285714286,56.0
3171,1197,7663,9,4,13,69.23,0.03240769230769231,39.23076923076923
3176,7868,1412,10,7,17,58.82,0.01186470588235294,24.0
3178,5357,35163,19,9,28,67.86,0.029392857142857137,17.464285714285715
3188,2558,19452,13,8,21,61.9,0.017290476190476193,27.952380952380953
3191,3568,33282,23,6,29,79.31,0.05209310344827586,21.379310344827587
3202,0,0,0,0,0,0.0,,
3205,6301,-3561,7,6,13,53.85,0.001969230769230768,27.76923076923077
3206,3685,14255,18,11,29,62.07,0.018337931034482755,52.55172413793103
3207,1408,-8638,7,8,15,46.67,-0.013326666666666664,34.666666666666664
3211,6986,-7496,9,9,18,50.0,-0.0033333333333333305,35.611111111111114
3213,8215,16595,15,10,25,60.0,0.014148000000000003,45.92
3217,4416,24694,12,10,22,54.55,0.005313636363636367,22.318181818181817
3218,8047,77553,17,6,23,73.91,0.04186086956521739,22.17391304347826
3219,2568,11302,9,6,15,60.0,0.012966666666666666,17.466666666666665
3221,5338,-20618,14,17,31,45.16,-0.015616129032258067,21.096774193548388
3224,3472,-4662,10,9,19,52.63,-0.001647368421052632,30.0
3226,4279,14491,13,7,20,65.0,0.023925000000000002,41.65
3227,19889,-50209,10,12,22,45.45,-0.01484545454545454,20.272727272727273
3228,12324,13286,16,16,32,50.0,-0.005862499999999998,19.625
3230,2785,-16795,12,19,31,38.71,-0.030396774193548384,29.35483870967742
3232,3653,-5513,15,17,32,46.88,-0.012556250000000001,20.78125
3234,4380,-14060,8,9,17,47.06,-0.011623529411764706,25.058823529411764
3236,2882,-3482,13,13,26,50.0,-0.00619230769230769,27.923076923076923
3252,1893,3237,8,8,16,50.0,-0.007087499999999999,22.6875
3259,2755,14925,12,6,18,66.67,0.027555555555555552,24.833333333333332
3260,9454,11366,18,10,28,64.29,0.024671428571428573,28.142857142857142
3264,4216,-17096,11,14,25,44.0,-0.021607999999999995,49.84
3265,3996,14064,15,13,28,53.57,0.0007750000000000029,25.071428571428573
3268,5728,-10828,16,14,30,53.33,0.0006233333333333354,21.3
3272,4414,-3364,8,7,15,53.33,0.0008933333333333377,14.466666666666667
3276,1669,-5629,8,12,20,40.0,-0.026749999999999996,32.4
3284,1800,2220,11,10,21,52.38,-0.0018476190476190482,70.57142857142857
3285,1485,-1975,5,5,10,50.0,-0.005939999999999996,19.8
3287,2144,-4404,13,11,24,54.17,0.0015583333333333328,29.083333333333332
3288,3873,467,12,11,23,52.17,-0.002465217391304348,17.304347826086957
3289,9419,-29179,14,15,29,48.28,-0.009310344827586204,25.06896551724138
3290,2264,3296,13,8,21,61.9,0.017590476190476184,31.857142857142858
3293,39672,-250322,12,13,25,48.0,-0.009855999999999997,29.12
3294,3384,27006,16,9,25,64.0,0.022788,24.8
3297,3835,215,10,14,24,41.67,-0.022662500000000002,29.75
3303,2404,-554,7,8,15,46.67,-0.012506666666666668,102.53333333333333
3306,4905,-18265,11,14,25,44.0,-0.017799999999999996,17.56
3310,1987,-3347,7,6,13,53.85,0.005338461538461544,36.0
3313,3064,-7374,12,9,21,57.14,0.0030999999999999977,21.238095238095237
3317,6512,-8772,16,12,28,57.14,0.008200000000000004,19.464285714285715
3322,1190,7930,11,3,14,78.57,0.05019285714285715,23.5
3323,7466,-4756,17,17,34,50.0,-0.0032735294117647038,32.794117647058826
3324,12083,70237,18,9,27,66.67,0.027429629629629634,13.148148148148149
3325,2155,2245,8,7,15,53.33,0.0007333333333333358,39.06666666666667
3332,2704,23856,9,3,12,75.0,0.04408333333333334,61.166666666666664
3339,2205,9465,13,9,22,59.09,0.010963636363636363,14.136363636363637
3354,1923,6947,12,9,21,57.14,0.00785714285714286,26.666666666666668
3360,2497,-6207,14,14,28,50.0,-0.00642857142857143,37.857142857142854
3362,6206,-19036,11,16,27,40.74,-0.024481481481481476,21.74074074074074
3363,3614,-7544,9,11,20,45.0,-0.0159,39.75
3372,2257,2833,19,10,29,65.52,0.0236448275862069,24.275862068965516
3373,2457,1653,7,7,14,50.0,-0.005928571428571427,22.0
3374,4028,-68,6,5,11,54.55,0.003263636363636366,15.818181818181818
3379,2535,-9265,4,11,15,26.67,-0.049053333333333324,34.333333333333336
3388,8957,18483,12,7,19,63.16,0.020378947368421056,85.36842105263158
3390,4298,2162,14,13,27,51.85,-0.002225925925925925,45.81481481481482
3402,2692,-2372,7,10,17,41.18,-0.023541176470588236,42.294117647058826
3426,462,-5482,0,2,2,0.0,-0.07064999999999999,329.0
3434,805,-515,5,5,10,50.0,-0.00643,42.9
3438,14944,816,18,11,29,62.07,0.018244827586206894,29.413793103448278
3441,3423,-11853,8,10,18,44.44,-0.01699444444444444,19.61111111111111
3444,2508,-11578,7,10,17,41.18,-0.023505882352941175,55.705882352941174
3455,5663,17037,13,10,23,56.52,0.007186956521739133,30.82608695652174
3465,3565,-535,6,3,9,66.67,0.02704444444444445,22.555555555555557
3466,3657,-7717,11,9,20,55.0,0.004154999999999999,48.05
3479,5864,7736,10,9,19,52.63,-0.0006684210526315799,55.26315789473684
3483,8200,49850,17,10,27,62.96,0.020059259259259263,23.22222222222222
3484,3941,33329,12,4,16,75.0,0.047162499999999996,43.0625
3489,1755,3515,9,9,18,50.0,-0.006516666666666665,39.5
3490,5589,-7359,11,9,20,55.0,0.0040349999999999995,22.95
3491,8740,-54240,8,14,22,36.36,-0.03311363636363636,23.545454545454547
3492,1789,-3739,6,6,12,50.0,-0.005933333333333335,26.75
3498,6869,32721,17,8,25,68.0,0.030219999999999993,22.44
3499,2427,2923,11,11,22,50.0,-0.006113636363636364,33.77272727272727
3508,6606,13384,14,10,24,58.33,0.010687500000000003,13.583333333333334
3511,4911,-1731,14,13,27,51.85,-0.0021518518518518497,18.62962962962963
3512,3304,7146,10,10,20,50.0,-0.006379999999999999,37.0
3516,1575,-55,9,9,18,50.0,-0.006372222222222217,38.22222222222222
3520,3394,17076,12,8,20,60.0,0.013740000000000002,23.3
3521,2223,4027,11,11,22,50.0,-0.0062318181818181795,34.22727272727273
3522,1811,-6581,7,10,17,41.18,-0.02425882352941176,22.88235294117647
3523,4370,-19180,10,15,25,40.0,-0.026107999999999992,31.48
3526,5893,3097,10,8,18,55.56,0.005205555555555558,26.666666666666668
3527,14560,39870,15,9,24,62.5,0.0190625,28.375
3529,29534,50936,11,7,18,61.11,0.01630555555555556,31.88888888888889
3531,2562,13388,12,6,18,66.67,0.02744444444444444,56.27777777777778
3537,3320,-15030,8,12,20,40.0,-0.025775000000000003,37.3
3540,3850,18880,10,10,20,50.0,-0.005844999999999998,26.95
3541,8743,34067,11,10,21,52.38,-0.001076190476190478,46.42857142857143
3546,20801,93709,16,11,27,59.26,0.012774074074074075,18.555555555555557
3548,7664,20296,17,9,26,65.38,0.024876923076923078,26.192307692307693
3551,4548,12052,10,7,17,58.82,0.011700000000000004,26.941176470588236
3552,17475,-19875,10,13,23,43.48,-0.018886956521739124,18.391304347826086
3555,2380,15070,7,5,12,58.33,0.009666666666666665,13.083333333333334
3556,6809,-43919,7,13,20,35.0,-0.03584,32.3
3558,8221,-72511,2,8,10,20.0,-0.06582,57.6
3564,3588,2672,9,7,16,56.25,0.006650000000000001,29.625
3567,2433,-2553,8,9,17,47.06,-0.012017647058823529,38.294117647058826
3570,8311,43009,14,8,22,63.64,0.024177272727272735,47.95454545454545
3577,6111,11859,15,10,25,60.0,0.014176000000000001,31.84
3580,4185,26275,16,7,23,69.57,0.03265652173913044,25.304347826086957
3581,853,-8353,2,6,8,25.0,-0.055975,49.125
3587,7670,21490,10,6,16,62.5,0.019112500000000004,19.1875
3594,3104,15836,12,7,19,63.16,0.020442105263157897,25.63157894736842
3597,0,0,0,0,0,0.0,,
3609,2299,10791,10,7,17,58.82,0.01174705882352941,21.705882352941178
3611,28950,-49950,11,13,24,45.83,-0.014245833333333333,42.958333333333336
3615,6277,3113,16,11,27,59.26,0.012637037037037035,14.333333333333334
3623,2116,-186,6,8,14,42.86,-0.02012142857142857,26.0
3624,3771,26319,13,5,18,72.22,0.03846666666666666,24.77777777777778
3625,3172,15828,16,10,26,61.54,0.016811538461538465,25.76923076923077
3628,8474,-13974,9,12,21,42.86,-0.02016190476190476,43.42857142857143
3629,1803,-15593,4,9,13,30.77,-0.04471538461538461,23.153846153846153
3630,7218,762,11,9,20,55.0,0.004105000000000002,20.05
3631,3792,-20382,8,14,22,36.36,-0.03309090909090909,24.181818181818183
3632,1889,-3139,9,5,14,64.29,0.022350000000000002,26.357142857142858
3642,2555,10225,11,7,18,61.11,0.01626111111111111,24.944444444444443
3646,1520,-630,6,5,11,54.55,-0.0025999999999999955,55.18181818181818
3652,3317,-14527,10,14,24,41.67,-0.022462499999999996,39.75
3663,2119,-23709,3,12,15,20.0,-0.06587333333333333,33.733333333333334
3664,2336,-1886,9,11,20,45.0,-0.01608,24.5
3666,1052,-1242,3,4,7,42.86,-0.027642857142857136,24.0
3672,1838,13662,7,3,10,70.0,0.03417,26.3
3675,6718,-2758,10,5,15,66.67,0.027413333333333338,36.46666666666667
3680,11302,53938,10,7,17,58.82,0.01174117647058824,21.058823529411764
3684,2623,5927,6,5,11,54.55,-0.00017272727272727264,92.54545454545455
3685,5399,1621,12,11,23,52.17,-0.001504347826086955,22.26086956521739
3687,8330,-41450,7,11,18,38.89,-0.028005555555555554,36.22222222222222
3689,3897,10753,10,8,18,55.56,0.003416666666666665,38.44444444444444
3691,39198,-43738,11,8,19,57.89,0.008000000000000005,22.94736842105263
3693,8585,20365,11,6,17,64.71,0.02344705882352941,18.58823529411765
3707,4048,20102,10,9,19,52.63,-0.0010157894736842125,18.736842105263158
3709,1151,-2381,4,4,8,50.0,-0.005862499999999998,55.0
3710,496,834,4,3,7,57.14,0.006557142857142859,42.285714285714285
3713,723,-3103,1,2,3,33.33,-0.03896666666666667,33.666666666666664
4102,3525,-8015,14,12,26,53.85,0.0017807692307692284,40.15384615384615
4105,14965,2245,18,16,34,52.94,-1.4705882352941597e-05,48.26470588235294
4107,11716,-14036,17,13,30,56.67,0.007343333333333339,44.13333333333333
4109,2857,6853,14,11,25,56.0,0.006084000000000001,45.84
4111,3785,-17625,14,17,31,45.16,-0.015609677419354836,64.51612903225806
4113,1540,-1210,7,9,16,43.75,-0.01895,55.4375
4114,4598,3922,14,11,25,56.0,0.0025720000000000022,43.64
4116,3047,12123,8,4,12,66.67,0.027583333333333335,58.083333333333336
4120,6032,-24222,9,13,22,40.91,-0.021522727272727263,42.68181818181818
4121,3352,-292,13,13,26,50.0,-0.00603076923076923,23.26923076923077
4123,6939,-5579,11,9,20,55.0,0.004195000000000003,39.3
4126,10738,45232,20,8,28,71.43,0.034178571428571426,58.785714285714285
4127,2311,2739,13,10,23,56.52,0.006730434782608696,32.30434782608695
4128,4532,-8552,12,12,24,50.0,-0.005866666666666666,37.541666666666664
4129,7234,6286,16,13,29,55.17,0.004537931034482758,43.44827586206897
4130,2351,5159,7,5,12,58.33,0.010750000000000001,35.75
4131,2558,782,7,12,19,36.84,-0.033668421052631584,30.0
4138,7826,34094,11,6,17,64.71,0.02342941176470589,57.411764705882355
4139,4466,14304,9,5,14,64.29,0.022828571428571427,66.21428571428571
4147,8908,58152,6,4,10,60.0,0.014300000000000002,46.7
4153,4961,45479,12,6,18,66.67,0.027499999999999997,31.77777777777778
4154,2675,25865,13,3,16,81.25,0.0566,36.75
4157,1491,2039,7,4,11,63.64,0.02140909090909091,39.18181818181818
4160,2013,-13083,4,8,12,33.33,-0.03924999999999999,55.583333333333336
4161,3871,-2011,8,7,15,53.33,0.0008333333333333397,65.53333333333333
4162,14507,-38817,7,8,15,46.67,-0.012486666666666662,24.266666666666666
4163,10373,64787,11,4,15,73.33,0.040806666666666665,67.26666666666667
4167,1696,-1386,6,6,12,50.0,-0.005858333333333333,37.0
4168,3740,16090,9,6,15,60.0,0.0142,32.333333333333336
4171,3919,-19299,7,5,12,58.33,0.01089166666666667,21.833333333333332
4173,2019,6911,8,6,14,57.14,0.008507142857142857,40.214285714285715
4174,18286,175294,9,5,14,64.29,0.02280714285714286,25.285714285714285
4175,4389,-7489,5,5,10,50.0,-0.0059700000000000005,130.3
4183,961,-2531,3,5,8,37.5,-0.0309875,74.375
4188,1473,7227,6,3,9,66.67,0.027544444444444444,67.88888888888889
4192,3581,-801,8,7,15,53.33,0.0007466666666666649,37.4
4198,1077,13203,8,2,10,80.0,0.05219999999999999,25.9
4205,4817,28943,12,5,17,70.59,0.03514705882352942,124.82352941176471
4207,1716,-5706,10,12,22,45.45,-0.015363636363636364,59.45454545454545
4303,2771,-22361,13,14,27,48.15,-0.017788888888888885,22.59259259259259
4304,814,-1824,7,6,13,53.85,-0.001284615384615383,19.153846153846153
4305,1554,-5274,4,6,10,40.0,-0.025889999999999996,144.9
4401,6993,-19943,14,12,26,53.85,0.0013576923076923087,50.23076923076923
4402,1485,-2095,12,12,24,50.0,-0.010525,17.583333333333332
4406,1137,1403,10,7,17,58.82,0.0099,48.705882352941174
4413,653,437,5,4,9,55.56,0.0025888888888888906,19.444444444444443
4416,6004,2066,7,6,13,53.85,0.001623076923076931,51.61538461538461
4417,3512,23268,16,8,24,66.67,0.030879166666666662,54.791666666666664
4419,2710,10670,14,7,21,66.67,0.025580952380952378,18.238095238095237
4420,3271,1399,11,11,22,50.0,-0.005922727272727271,80.36363636363636
4430,2475,11015,8,4,12,66.67,0.027308333333333334,50.5
4432,3245,9385,7,4,11,63.64,0.021490909090909092,23.545454545454547
4433,2771,14269,10,5,15,66.67,0.027526666666666665,41.6
4502,5071,22509,18,15,33,54.55,0.0003787878787878787,43.96969696969697
4503,3182,2258,15,11,26,57.69,0.008680769230769233,19.423076923076923
4506,3233,12317,15,10,25,60.0,0.013484000000000001,72.96
4510,2222,7578,15,9,24,62.5,0.018491666666666667,48.75
4513,1740,-3550,11,12,23,47.83,-0.01116521739130435,43.56521739130435
4523,3974,-9404,13,14,27,48.15,-0.009692592592592595,52.77777777777778
4527,3248,562,14,11,25,56.0,0.0024160000000000028,79.08
4528,5537,30983,18,9,27,66.67,0.02724814814814815,28.14814814814815
4529,3054,-3254,13,15,28,46.43,-0.01348214285714286,30.285714285714285
4530,1672,-8552,10,15,25,40.0,-0.029039999999999996,33.76
4533,1833,-3363,10,10,20,50.0,-0.006114999999999998,54.4
4534,2452,-10392,12,12,24,50.0,-0.006624999999999998,38.75
4535,5964,-25674,10,11,21,47.62,-0.010609523809523807,105.95238095238095
4538,796,3994,6,2,8,75.0,0.0354625,116.625
4541,2313,1177,6,7,13,46.15,-0.013423076923076923,50.92307692307692
4542,1627,-3237,4,7,11,36.36,-0.023918181818181818,37.45454545454545
4543,1441,1699,6,5,11,54.55,0.003245454545454546,52.72727272727273
4549,7962,-882,8,8,16,50.0,-0.005887499999999997,52.0
4550,1173,8837,7,2,9,77.78,0.049611111111111106,40.666666666666664
4554,2510,-13880,5,9,14,35.71,-0.03452142857142857,30.285714285714285
4556,1386,8694,5,2,7,71.43,0.036885714285714286,121.28571428571429
4561,1591,-3871,5,5,10,50.0,-0.013959999999999997,90.4
4563,2126,5434,6,2,8,75.0,0.0441375,63.625
4568,1966,15934,4,1,5,80.0,0.03806,78.6
4580,1098,-278,1,1,2,50.0,-0.005850000000000001,227.5
4609,1436,2114,8,9,17,47.06,-0.01337647058823529,32.588235294117645
4702,1982,-14232,9,17,26,34.62,-0.040003846153846154,24.846153846153847
4706,1221,-711,8,7,15,53.33,6.666666666668708e-06,62.06666666666667
4707,2273,-21193,7,16,23,30.43,-0.04821739130434782,71.0
4711,1143,10817,9,2,11,81.82,0.0575,126.45454545454545
4712,2921,8739,17,10,27,62.96,0.01877777777777778,23.62962962962963
4714,2065,-455,13,11,24,54.17,0.002141666666666668,37.125
4716,3056,-2276,14,16,30,46.67,-0.012983333333333331,39.6
4721,6821,-56091,10,16,26,38.46,-0.028946153846153844,36.11538461538461
4726,2599,-13409,5,8,13,38.46,-0.029030769230769228,29.46153846153846
4728,5128,30072,9,6,15,60.0,0.01412666666666667,26.866666666666667
4729,2430,-1100,12,9,21,57.14,0.008285714285714289,34.04761904761905
4735,3373,-21973,3,9,12,25.0,-0.05585833333333332,34.333333333333336
4736,12294,31236,10,7,17,58.82,0.011717647058823529,40.94117647058823
4741,6220,67050,14,3,17,82.35,0.05879411764705883,47.588235294117645
4743,5197,20873,6,4,10,60.0,0.014140000000000003,25.8
4744,3611,-4321,12,11,23,52.17,-0.0015391304347826063,46.04347826086956
4745,4448,-5848,8,6,14,57.14,0.008471428571428572,42.07142857142857
4747,1898,14552,5,2,7,71.43,0.037071428571428575,198.71428571428572
4754,773,4177,2,1,3,66.67,0.0273,101.33333333333333
4760,2937,-40307,1,7,8,12.5,-0.08071249999999999,27.75
4767,433,-2943,1,2,3,33.33,-0.03943333333333333,19.333333333333332
4804,1992,-6532,7,6,13,53.85,0.0036923076923076922,19.153846153846153
4806,2268,6222,8,3,11,72.73,0.03368181818181818,13.090909090909092
4903,2398,6472,17,14,31,54.84,5.1612903225806587e-05,23.451612903225808
4905,4309,7991,15,10,25,60.0,0.016064000000000002,53.88
4907,1605,13245,14,5,19,73.68,0.042173684210526315,44.89473684210526
4908,5880,-15610,17,13,30,56.67,0.007493333333333333,24.3
4909,6516,14404,18,15,33,54.55,0.0032030303030303026,35.93939393939394
4911,5502,6388,7,5,12,58.33,0.010841666666666671,36.5
4924,1077,463,5,6,11,45.45,-0.016481818181818184,41.45454545454545
4931,923,-9533,3,5,8,37.5,-0.0333875,26.0
4933,3689,37471,10,3,13,76.92,0.04781538461538461,31.53846153846154
4939,2326,-10546,9,13,22,40.91,-0.02442727272727273,26.954545454545453
4944,2034,5656,9,5,14,64.29,0.022435714285714285,14.785714285714286
4945,2087,-24627,1,5,6,16.67,-0.07251666666666666,21.166666666666668
4946,5307,25113,13,6,19,68.42,0.030963157894736845,35.05263157894737
4950,1641,-8201,5,9,14,35.71,-0.034864285714285716,28.357142857142858
4953,4060,32100,9,3,12,75.0,0.043966666666666675,21.666666666666668
4966,50500,33200,8,8,16,50.0,-0.005812499999999998,25.625
4971,6868,-16218,7,9,16,43.75,-0.01841875,23.3125
4972,1676,-3276,4,5,9,44.44,-0.016966666666666668,83.88888888888889
4973,1330,4490,6,3,9,66.67,0.027433333333333337,47.0
4974,3310,-15150,5,8,13,38.46,-0.029076923076923073,62.07692307692308
4979,4438,24012,12,8,20,60.0,0.014110000000000001,16.2
4987,4602,41978,8,2,10,80.0,0.05395000000000001,63.6
4991,3988,-3998,6,5,11,54.55,-0.004799999999999995,26.09090909090909
4995,2937,11353,9,5,14,64.29,0.022821428571428572,81.28571428571429
5009,3762,-932,13,10,23,56.52,0.007000000000000001,34.608695652173914
5011,1519,7301,8,3,11,72.73,0.03954545454545454,54.18181818181818
5013,2968,-14478,11,13,24,45.83,-0.014329166666666665,73.70833333333333
5014,2186,-1716,13,12,25,52.0,-0.0026560000000000004,22.44
5015,3917,6233,14,10,24,58.33,0.01072083333333334,89.25
5016,3647,-14977,10,13,23,43.48,-0.018913043478260866,65.6086956521739
5201,2442,-10812,9,11,20,45.0,-0.016499999999999997,46.75
5202,2689,-11429,15,17,32,46.88,-0.014143749999999998,28.125
5205,1569,14011,10,3,13,76.92,0.04561538461538461,16.307692307692307
5206,1605,5575,12,10,22,54.55,0.0011136363636363633,33.54545454545455
5209,4510,9190,9,7,16,56.25,0.006618750000000003,87.0625
5210,1647,7253,16,7,23,69.57,0.03590434782608696,42.04347826086956
5211,4681,3259,17,14,31,54.84,0.0038225806451612923,37.774193548387096
5212,2369,471,7,7,14,50.0,-0.005949999999999995,44.07142857142857
5213,2166,-10396,8,10,18,44.44,-0.017044444444444442,60.55555555555556
5220,2866,21824,10,4,14,71.43,0.03693571428571429,43.07142857142857
5223,816,-12326,0,3,3,0.0,-0.08573333333333333,28.0
5227,1451,6479,6,5,11,54.55,0.0031000000000000016,32.36363636363637
5230,3668,-19038,7,6,13,53.85,0.001807692307692305,52.23076923076923
5245,5783,-42983,3,7,10,30.0,-0.045799999999999993,22.6
5251,1971,-231,6,9,15,40.0,-0.026333333333333334,42.733333333333334
5263,10666,-30766,4,7,11,36.36,-0.033272727272727266,38.45454545454545
5272,5643,-19853,11,13,24,45.83,-0.014183333333333333,23.708333333333332
5274,43567,-561467,4,9,13,30.77,-0.044230769230769226,20.153846153846153
5276,1026,-10146,3,7,10,30.0,-0.045939999999999995,47.2
5278,14139,151,10,7,17,58.82,0.009288235294117653,21.235294117647058
5281,3124,38916,10,2,12,83.33,0.060924999999999986,32.833333333333336
5287,26598,-169098,6,11,17,35.29,-0.03527058823529411,58.35294117647059
5289,7105,-13015,4,5,9,44.44,-0.016977777777777776,33.44444444444444
5291,1646,1114,5,5,10,50.0,0.0009099999999999997,31.4
5299,5933,-34413,5,6,11,45.45,-0.015263636363636358,46.36363636363637
5301,3114,40276,16,5,21,76.19,0.04514285714285714,24.761904761904763
5302,2626,3774,23,12,35,65.71,0.023811428571428577,28.114285714285714
5306,15809,57011,25,12,37,67.57,0.026270270270270277,33.91891891891892
5309,2789,-13629,12,19,31,38.71,-0.026835483870967743,33.645161290322584
5310,5171,-10151,18,17,35,51.43,-0.003988571428571429,24.457142857142856
5312,8087,-3757,13,13,26,50.0,-0.007980769230769229,51.84615384615385
5314,1482,978,13,10,23,56.52,0.0042695652173913015,21.91304347826087
5315,1721,-3481,10,13,23,43.48,-0.02132608695652174,29.52173913043478
5321,1667,-14367,8,8,16,50.0,-0.011174999999999997,22.5625
5324,2320,-4400,14,9,23,60.87,0.010356521739130438,61.34782608695652
5328,1600,-1210,13,11,24,54.17,-9.58333333333326e-05,28.791666666666668
5340,2710,-8140,15,14,29,51.72,-0.005306896551724137,19.551724137931036
5344,1626,-476,9,11,20,45.0,-0.017515000000000003,33.75
5345,1401,2209,13,8,21,61.9,0.015442857142857144,21.714285714285715
5347,5853,-57363,9,15,24,37.5,-0.030983333333333335,37.333333333333336
5348,1060,3750,7,5,12,58.33,0.010224999999999998,45.5
5351,5054,-6804,20,20,40,50.0,-0.0062675000000000005,22.65
5353,2242,4318,16,12,28,57.14,0.007360714285714288,42.92857142857143
5355,2272,3438,19,12,31,61.29,0.011580645161290324,28.483870967741936
5356,4922,-1372,14,14,28,50.0,-0.006657142857142857,48.07142857142857
5364,1676,-3786,9,7,16,56.25,0.0008000000000000021,16.125
5371,5420,34070,18,8,26,69.23,0.0325576923076923,42.15384615384615
5381,1785,4805,19,12,31,61.29,0.010151612903225802,18.548387096774192
5383,2556,2934,16,10,26,61.54,0.013388461538461533,29.46153846153846
5386,3144,24576,9,6,15,60.0,0.01367333333333333,33.53333333333333
5392,10846,3334,16,15,31,51.61,-0.0028064516129032244,36.03225806451613
5398,3089,14111,14,8,22,63.64,0.02023636363636364,37.72727272727273
5403,2868,8492,11,5,16,68.75,0.034612500000000004,68.9375
5410,2563,-5243,13,14,27,48.15,-0.014551851851851852,54.25925925925926
5425,6777,-5667,18,18,36,50.0,-0.006216666666666665,18.25
5426,2428,4132,17,13,30,56.67,0.006796666666666669,61.666666666666664
5432,2217,613,11,8,19,57.89,0.008573684210526318,19.42105263157895
5438,3384,2196,12,11,23,52.17,-0.001660869565217392,67.04347826086956
5439,5495,31355,23,9,32,71.88,0.041103125,42.75
5443,4314,3836,18,18,36,50.0,-0.00629722222222222,24.694444444444443
5450,2478,-1088,13,11,24,54.17,0.0018250000000000048,31.75
5452,2902,5998,19,13,32,59.38,0.014503124999999997,33.96875
5455,1548,-2288,8,10,18,44.44,-0.016477777777777775,14.833333333333334
5457,8551,-34471,25,23,48,52.08,-0.0026208333333333305,24.604166666666668
5460,1665,-785,9,10,19,47.37,-0.006626315789473683,60.73684210526316
5464,3889,18471,16,9,25,64.0,0.022128000000000002,32.36
5465,1868,2642,15,8,23,65.22,0.023169565217391302,28.52173913043478
5468,1860,1780,13,10,23,56.52,0.005108695652173915,10.782608695652174
5474,11904,120256,19,9,28,67.86,0.029782142857142865,20.892857142857142
5475,2486,5694,20,12,32,62.5,0.016215625,22.75
5478,15068,51412,21,12,33,63.64,0.02136666666666667,29.242424242424242
5481,2717,-2577,13,12,25,52.0,-0.0018279999999999963,41.44
5483,14382,41558,20,11,31,64.52,0.02303548387096774,23.516129032258064
5487,2473,6037,13,6,19,68.42,0.031005263157894734,39.421052631578945
5488,1771,-8591,8,13,21,38.1,-0.031433333333333334,33.57142857142857
5489,4677,-1217,8,12,20,40.0,-0.025775,52.35
5490,9276,-19796,20,21,41,48.78,-0.008246341463414634,27.21951219512195
5493,3262,-12662,9,11,20,45.0,-0.015864999999999997,69.75
5498,2685,-565,20,17,37,54.05,0.0007891891891891908,27.7027027027027
5508,4643,6617,11,7,18,61.11,0.01622222222222222,93.88888888888889
5511,2506,-10756,7,14,21,33.33,-0.03535238095238095,103.76190476190476
5512,2006,13734,16,7,23,69.57,0.03702173913043477,67.8695652173913
5514,2738,592,17,14,31,54.84,0.0027258064516129028,57.225806451612904
5516,1139,1101,8,7,15,53.33,-0.00022666666666666392,43.2
5520,3612,-6542,12,10,22,54.55,0.006568181818181823,108.0909090909091
5523,1431,-3801,7,9,16,43.75,-0.019556249999999997,46.25
5529,2596,-4116,15,12,27,55.56,0.0038333333333333353,36.0
5530,6125,-34545,6,11,17,35.29,-0.03570588235294117,104.94117647058823
5536,10322,1728,7,6,13,53.85,0.001899999999999999,85.15384615384616
5543,842,1128,2,1,3,66.67,0.027333333333333334,56.0
5601,1184,-8824,3,7,10,30.0,-0.04622,73.5
5603,3237,17113,23,10,33,69.7,0.03277575757575757,45.36363636363637
5604,3447,-7177,7,12,19,36.84,-0.029099999999999997,106.84210526315789
5609,3801,12389,15,9,24,62.5,0.0190625,57.208333333333336
5701,1343,-5193,10,10,20,50.0,-0.010830000000000001,46.45
5703,1888,2262,7,5,12,58.33,0.010708333333333334,58.833333333333336
5704,2244,-1174,7,7,14,50.0,-0.0058857142857142875,40.92857142857143
5820,1758,512,15,12,27,55.56,0.0035851851851851865,96.33333333333333
5864,1257,-417,9,8,17,52.94,-0.0014647058823529407,64.17647058823529
5878,1667,-18507,1,5,6,16.67,-0.061766666666666664,274.0
5902,1371,-6851,6,12,18,33.33,-0.04056111111111111,35.611111111111114
5903,14722,-35702,9,9,18,50.0,-0.005983333333333327,166.61111111111111
5904,16638,86632,14,7,21,66.67,0.027457142857142857,69.33333333333333
5905,1920,-8990,9,14,23,39.13,-0.028334782608695656,35.130434782608695
6015,2474,-1184,18,18,36,50.0,-0.008902777777777779,43.666666666666664
6016,2559,-59,20,17,37,54.05,0.000494594594594593,45.567567567567565
6020,1609,-5509,7,9,16,43.75,-0.018443750000000002,75.6875
6021,0,0,0,0,0,0.0,,
6023,3694,6326,9,6,15,60.0,0.009373333333333338,169.66666666666666
6026,604,1866,5,3,8,62.5,0.018162499999999998,45.5
6101,5049,23971,24,12,36,66.67,0.025758333333333334,15.11111111111111
6103,2458,-5658,10,10,20,50.0,-0.009054999999999999,16.7
6104,10231,-109501,11,15,26,42.31,-0.02113461538461538,19.153846153846153
6109,1130,6880,10,4,14,71.43,0.03629285714285716,27.642857142857142
6111,9236,1294,16,13,29,55.17,0.004179310344827591,23.551724137931036
6113,2016,6174,16,10,26,61.54,0.01552307692307692,36.53846153846154
6114,4315,-4275,10,9,19,52.63,-0.0013894736842105253,25.68421052631579
6118,2115,495,12,14,26,46.15,-0.014696153846153847,26.846153846153847
6121,18990,-122730,7,13,20,35.0,-0.03589499999999999,55.15
6122,1718,-4218,9,11,20,45.0,-0.01652,38.55
6123,3790,-3200,11,12,23,47.83,-0.010408695652173913,38.869565217391305
6124,4345,8375,14,11,25,56.0,0.006124000000000002,38.12
6125,3706,-3276,13,13,26,50.0,-0.006223076923076925,41.73076923076923
6126,3216,1584,13,13,26,50.0,-0.0061153846153846145,26.346153846153847
6127,2478,1992,14,12,26,53.85,0.0013000000000000015,24.5
6129,3804,5516,15,12,27,55.56,0.004251851851851851,29.88888888888889
6130,3391,-3371,8,9,17,47.06,-0.012241176470588236,17.058823529411764
6134,5502,6898,18,20,38,47.37,-0.011647368421052632,20.473684210526315
6138,9021,-31901,14,18,32,43.75,-0.018390624999999997,22.71875
6140,1603,-1193,11,10,21,52.38,0.0010238095238095254,55.57142857142857
6143,4834,12996,13,7,20,65.0,0.023855,33.45
6144,1076,-5246,5,10,15,33.33,-0.03727333333333333,51.733333333333334
6146,15272,22348,11,11,22,50.0,-0.005936363636363634,60.0
6147,7541,-9121,13,14,27,48.15,-0.005822222222222217,38.25925925925926
6148,2236,-5906,15,19,34,44.12,-0.021379411764705883,28.61764705882353
6150,5059,22801,15,8,23,65.22,0.024239130434782603,19.130434782608695
6151,3689,17971,14,7,21,66.67,0.02724761904761905,45.666666666666664
6154,3908,-20878,8,13,21,38.1,-0.0297047619047619,138.8095238095238
6156,3077,11413,16,13,29,55.17,0.005868965517241378,22.275862068965516
6158,5612,-442,16,16,32,50.0,-0.003049999999999997,28.3125
6160,5882,-41432,11,16,27,40.74,-0.024448148148148146,37.370370370370374
6161,2905,6235,17,10,27,62.96,0.02202592592592593,35.925925925925924
6163,2404,-5194,12,15,27,44.44,-0.015148148148148148,24.333333333333332
6167,1152,1648,11,7,18,61.11,0.012416666666666668,30.166666666666668
6169,5350,12640,17,16,33,51.52,-0.0030999999999999986,25.272727272727273
6170,3974,30416,20,10,30,66.67,0.027069999999999997,52.166666666666664
6171,1630,2260,11,9,20,55.0,0.003130000000000003,31.8
6173,4985,-31685,16,17,33,48.48,-0.009439393939393938,23.515151515151516
6174,2772,-862,15,14,29,51.72,-0.0039034482758620653,36.275862068965516
6175,2364,1976,8,13,21,38.1,-0.03081428571428571,28.857142857142858
6179,3260,1710,8,11,19,42.11,-0.01664736842105264,33.05263157894737
6180,7027,-47,15,15,30,50.0,-0.002846666666666666,28.666666666666668
6182,9972,1598,21,16,37,56.76,0.007540540540540541,24.756756756756758
6185,5343,7667,22,15,37,59.46,0.01296486486486487,30.2972972972973
6186,3667,6203,15,12,27,55.56,0.006870370370370368,56.333333333333336
6187,8402,-42572,11,17,28,39.29,-0.02728928571428571,19.571428571428573
6188,12536,20204,20,21,41,48.78,-0.006373170731707316,33.707317073170735
6190,3708,25092,29,8,37,78.38,0.04988648648648649,26.56756756756757
6194,5182,16018,15,9,24,62.5,0.019154166666666667,78.625
6195,5829,-3709,11,9,20,55.0,0.00364,51.2
6198,1699,2551,9,7,16,56.25,0.005500000000000001,23.4375
6199,1493,-983,8,8,16,50.0,-0.0064312499999999995,24.4375
6203,7196,-39636,11,12,23,47.83,-0.010204347826086953,57.869565217391305
6204,6917,38823,21,11,32,65.62,0.025340625,55.03125
6207,5023,-15173,11,15,26,42.31,-0.021450000000000004,32.30769230769231
6208,4824,6906,19,14,33,57.58,0.009060606060606059,30.666666666666668
6210,2564,8186,6,6,12,50.0,-0.006058333333333332,47.0
6212,2501,26829,14,5,19,73.68,0.04040000000000001,51.526315789473685
6217,7512,-16412,19,20,39,48.72,-0.008784615384615384,22.692307692307693
6218,2894,7046,12,9,21,57.14,0.008376190476190476,71.19047619047619
6219,1501,-691,10,9,19,52.63,-0.0031105263157894737,31.42105263157895
6220,2443,24807,13,4,17,76.47,0.04658823529411765,26.529411764705884
6221,4424,-17064,8,18,26,30.77,-0.041115384615384616,36.73076923076923
6222,2012,-1972,14,12,26,53.85,0.0003499999999999978,30.807692307692307
6223,14397,3753,18,14,32,56.25,0.006665625000000004,21.0625
6227,4146,-8666,14,16,30,46.67,-0.012709999999999997,40.36666666666667
6228,2380,-3580,16,16,32,50.0,-0.007365624999999997,26.03125
6229,3108,7062,14,10,24,58.33,0.010666666666666666,34.708333333333336
6231,12514,8046,19,16,35,54.29,0.002648571428571432,19.34285714285714
6233,3856,10314,13,10,23,56.52,0.006739130434782608,19.130434782608695
6234,7568,-21338,16,19,35,45.71,-0.01446,32.714285714285715
6236,1221,6779,6,3,9,66.67,0.02685555555555556,12.88888888888889
6237,11498,-44058,12,22,34,35.29,-0.03528529411764707,21.647058823529413
6240,2634,21196,14,5,19,73.68,0.0391842105263158,21.31578947368421
6241,2361,-11191,8,13,21,38.1,-0.030500000000000003,36.38095238095238
6242,2744,22526,9,7,16,56.25,0.005024999999999998,36.8125
6244,21996,-242676,9,20,29,31.03,-0.04383793103448276,21.517241379310345
6245,8833,1757,20,15,35,57.14,0.008405714285714287,39.6
6246,4044,15796,29,14,43,67.44,0.026567441860465113,25.372093023255815
6247,2109,4011,14,8,22,63.64,0.021027272727272724,90.63636363636364
6248,1925,1055,10,8,18,55.56,0.009055555555555553,25.166666666666668
6259,2147,1253,12,10,22,54.55,0.0013681818181818183,20.181818181818183
6261,7403,25737,12,8,20,60.0,0.009850000000000003,43.85
6263,6803,20347,15,11,26,57.69,0.00945769230769231,70.15384615384616
6264,1959,-449,9,11,20,45.0,-0.01776,37.55
6265,2052,-13412,9,16,25,36.0,-0.035164,36.96
6266,2763,-1273,16,14,30,53.33,0.00022666666666666392,44.9
6270,3201,-2211,11,12,23,47.83,-0.010352173913043475,43.47826086956522
6274,8227,-14287,14,19,33,42.42,-0.021257575757575753,21.96969696969697
6275,2699,-9899,11,12,23,47.83,-0.010365217391304348,19.565217391304348
6276,3179,-18329,14,18,32,43.75,-0.019696875,30.75
6279,12322,-39282,14,14,28,50.0,-0.005899999999999996,37.714285714285715
6284,6122,14468,15,10,25,60.0,0.014096,25.52
6287,1367,-267,12,11,23,52.17,-0.006004347826086957,20.0
6290,6002,23908,20,10,30,66.67,0.02892,34.06666666666667
6291,2238,3152,12,9,21,57.14,0.004319047619047618,15.19047619047619
6292,3836,-25906,8,15,23,34.78,-0.03645652173913043,63.34782608695652
6294,5667,78503,11,4,15,73.33,0.03809333333333333,40.53333333333333
6404,1291,7929,3,5,8,37.5,-0.0318875,20.875
6411,8594,-354,9,7,16,56.25,0.006525000000000003,29.625
6417,1537,1073,3,2,5,60.0,0.014180000000000002,58.4
6418,552,6308,4,1,5,80.0,0.05402,30.0
6419,766,8824,4,1,5,80.0,0.05428000000000001,30.2
6425,2944,326,8,5,13,61.54,0.017323076923076924,39.61538461538461
6426,6121,32159,7,4,11,63.64,0.0213,23.545454545454547
6432,2406,-2036,7,7,14,50.0,-0.005921428571428569,27.785714285714285
6435,6302,22138,6,4,10,60.0,0.014000000000000002,28.1
6441,8299,16741,10,8,18,55.56,0.005261111111111113,31.166666666666668
6446,11177,45183,7,5,12,58.33,0.010791666666666672,37.583333333333336
6457,5552,-1982,9,6,15,60.0,0.01414666666666667,49.06666666666667
6461,3058,-1798,7,7,14,50.0,-0.0057785714285714315,36.357142857142854
6462,8089,-105929,2,7,9,22.22,-0.06142222222222222,17.11111111111111
6465,1995,-15105,3,6,9,33.33,-0.03912222222222222,44.77777777777778
6469,1399,7101,2,1,3,66.67,0.027533333333333337,87.33333333333333
6470,3294,6476,7,5,12,58.33,0.010816666666666674,29.333333333333332
6472,10033,-8053,6,6,12,50.0,-0.0057333333333333325,26.5
6482,1159,971,2,2,4,50.0,-0.005675000000000003,16.25
6485,2545,40685,7,0,7,100.0,0.09419999999999999,42.42857142857143
6486,3086,-2326,5,4,9,55.56,0.00514444444444445,41.888888888888886
6488,35257,-130667,7,8,15,46.67,-0.012526666666666663,15.0
6492,4069,50711,7,1,8,87.5,0.0691875,58.875
6494,5010,26280,11,4,15,73.33,0.04071333333333334,27.533333333333335
6496,2381,-10101,3,4,7,42.86,-0.020128571428571433,103.57142857142857
6499,3942,10148,5,4,9,55.56,0.005344444444444443,32.22222222222222
6506,1773,8357,10,6,16,62.5,0.02449375,54.875
6508,3605,115,11,10,21,52.38,-0.0011904761904761908,127.47619047619048
6509,2899,-16639,7,15,22,31.82,-0.04232272727272726,30.318181818181817
6510,45209,184641,6,4,10,60.0,0.014000000000000002,19.4
6512,977,5083,4,3,7,57.14,0.008414285714285721,62.42857142857143
6514,4146,-5056,7,7,14,50.0,-0.005871428571428569,35.214285714285715
6516,5358,39232,4,2,6,66.67,0.027633333333333333,175.5
6523,7585,3645,5,5,10,50.0,-0.005849999999999999,37.4
6527,546,574,1,1,2,50.0,-0.006149999999999996,559.5
6530,1198,6362,8,3,11,72.73,0.03947272727272728,68.36363636363636
6532,1796,6044,4,4,8,50.0,-0.006162500000000001,51.125
6535,1866,10524,6,3,9,66.67,0.02746666666666667,37.888888888888886
6538,5029,55451,5,2,7,71.43,0.037014285714285715,45.0
6542,2092,-8472,2,3,5,40.0,-0.025880000000000004,40.8
6547,8666,45244,6,7,13,46.15,-0.013692307692307688,56.23076923076923
6548,10914,43506,4,2,6,66.67,0.027233333333333335,34.666666666666664
6556,2385,9725,6,3,9,66.67,0.02748888888888889,73.88888888888889
6560,3710,14580,6,3,9,66.67,0.0275,21.333333333333332
6561,12164,-189214,1,6,7,14.29,-0.07712857142857142,37.857142857142854
6568,11234,38016,7,4,11,63.64,0.021409090909090912,32.27272727272727
6569,10076,-28726,5,6,11,45.45,-0.014954545454545453,61.54545454545455
6570,1204,-1144,3,3,6,50.0,-0.005583333333333329,87.5
6574,3308,-18068,2,3,5,40.0,-0.025759999999999998,64.6
6576,5951,-29061,5,7,12,41.67,-0.02239166666666666,19.416666666666668
6577,2160,-7730,2,4,6,33.33,-0.02355,52.166666666666664
6578,1130,-3550,3,5,8,37.5,-0.030837499999999997,131.875
6588,1355,-2175,2,2,4,50.0,-0.0057,29.25
6589,2047,-7927,3,4,7,42.86,-0.020242857142857142,21.571428571428573
6590,2621,17829,6,3,9,66.67,0.03634444444444444,54.333333333333336
6593,1305,5325,4,3,7,57.14,0.008400000000000001,33.142857142857146
6594,1530,12410,6,2,8,75.0,0.0441375,26.375
6596,4517,2583,8,6,14,57.14,0.0031857142857142887,41.857142857142854
6603,1924,1816,12,10,22,54.55,0.002813636363636364,30.5
6609,3459,-15749,9,12,21,42.86,-0.018404761904761906,83.57142857142857
6612,2008,-23138,1,4,5,20.0,-0.06593999999999998,109.6
6613,5354,-76254,1,5,6,16.67,-0.07251666666666666,101.66666666666667
6615,1045,6435,2,1,3,66.67,0.02753333333333333,17.0
6616,698,-2888,3,2,5,60.0,0.01396,32.8
6624,690,-1220,1,2,3,33.33,-0.0393,53.0
6629,1046,2694,2,1,3,66.67,0.027566666666666666,55.666666666666664
6640,2839,-16969,3,5,8,37.5,-0.0309125,62.625
6642,2370,7430,4,3,7,57.14,0.008485714285714286,22.714285714285715
6643,5665,-50365,1,2,3,33.33,-0.03923333333333333,39.0
6649,363,1137,1,1,2,50.0,-0.005850000000000001,39.0
6651,986,-7946,1,1,2,50.0,-0.038599999999999995,5.5
6654,2549,1101,4,3,7,57.14,0.008271428571428572,35.142857142857146
6661,300,4730,2,0,2,100.0,0.094,127.5
6662,1240,7820,4,2,6,66.67,0.038766666666666665,127.16666666666667
6664,2246,-31736,1,4,5,20.0,-0.08442,54.2
6667,1734,14456,3,1,4,75.0,0.044075,21.25
6679,8042,-67642,1,3,4,25.0,-0.055924999999999996,12.0
6680,1711,23849,5,0,5,100.0,0.08008,43.4
6683,6528,3622,2,2,4,50.0,-0.005850000000000001,33.5
6690,5358,62542,6,1,7,85.71,0.0656,31.714285714285715
6697,473,3627,1,1,2,50.0,0.039549999999999995,22.5
6703,0,0,0,0,0,0.0,,
6712,3381,-59781,0,3,3,0.0,-0.106,22.666666666666668
6716,827,-14627,0,1,1,0.0,-0.106,7.0
6727,3129,-28269,2,6,8,25.0,-0.055862499999999995,19.125
6728,2797,43023,4,0,4,100.0,0.09385,23.75
6732,14438,-158538,1,3,4,25.0,-0.055925,29.25
6733,570,-5890,1,3,4,25.0,-0.055825,30.0
6747,7233,48867,4,1,5,80.0,0.03964,27.2
6751,1204,-874,2,2,4,50.0,-0.005874999999999998,33.5
6752,671,-12491,0,2,2,0.0,-0.10569999999999999,71.5
6762,1443,-28143,0,1,1,0.0,-0.1054,86.0
6767,172,-3032,0,1,1,0.0,-0.106,40.0
6803,7131,5769,4,3,7,57.14,0.008285714285714287,321.57142857142856
7402,3026,22244,7,2,9,77.78,0.039344444444444446,36.77777777777778
7556,599,-10599,0,1,1,0.0,-0.106,6.0
8024,2572,-102,9,11,20,45.0,-0.01617,43.45
8027,2768,-12818,6,6,12,50.0,-0.005833333333333335,19.083333333333332
8032,3990,-5550,15,13,28,53.57,0.001207142857142861,46.535714285714285
8034,2534,-3594,14,20,34,41.18,-0.025185294117647056,27.705882352941178
8038,3278,19332,8,3,11,72.73,0.03958181818181819,43.45454545454545
8040,3633,4427,11,12,23,47.83,-0.011082608695652174,21.217391304347824
8042,4968,-1148,12,13,25,48.0,-0.009867999999999998,41.88
8043,3890,14690,14,9,23,60.87,0.015656521739130437,63.73913043478261
8044,22997,-101847,8,15,23,34.78,-0.03628260869565216,22.47826086956522
8047,1434,2306,11,8,19,57.89,0.006257894736842106,47.21052631578947
8048,3027,-13337,7,12,19,36.84,-0.03232105263157894,42.36842105263158
8049,2713,3027,19,14,33,57.58,0.008260606060606062,28.96969696969697
8050,10891,52719,19,12,31,61.29,0.01678064516129032,31.548387096774192
8054,4811,-9101,11,10,21,52.38,-0.0010523809523809529,45.714285714285715
8059,731,409,4,5,9,44.44,-0.018322222222222222,45.111111111111114
8064,3513,8407,17,11,28,60.71,0.015250000000000001,29.892857142857142
8066,3687,-10867,6,6,12,50.0,-0.011683333333333329,37.5
8067,1693,2617,13,9,22,59.09,0.011004545454545453,30.772727272727273
8068,3244,13976,12,8,20,60.0,0.013489999999999999,15.9
8069,3553,-32153,6,14,20,30.0,-0.04575,21.55
8071,2923,3297,11,11,22,50.0,-0.007377272727272726,29.363636363636363
8074,2747,19763,18,7,25,72.0,0.037968,52.72
8076,16264,39776,18,14,32,56.25,0.006653125000000001,24.03125
8077,1096,-4596,6,5,11,54.55,-0.0006363636363636356,25.0
8080,3756,14704,20,14,34,58.82,0.011414705882352938,24.470588235294116
8083,11172,83528,13,6,19,68.42,0.030931578947368428,88.0
8084,2476,1104,10,9,19,52.63,-0.0008421052631578933,48.10526315789474
8085,2221,-391,14,15,29,48.28,-0.012341379310344824,21.93103448275862
8086,4612,-2582,9,4,13,69.23,0.03256153846153847,16.692307692307693
8087,1632,-11822,7,14,21,33.33,-0.04050476190476191,34.666666666666664
8088,4417,2853,19,17,36,52.78,-0.0006999999999999977,19.52777777777778
8089,0,0,0,0,0,0.0,,
8091,9641,9909,19,12,31,61.29,0.019545161290322587,35.74193548387097
8092,1986,-5956,9,15,24,37.5,-0.03205,32.583333333333336
8093,2277,-8367,13,12,25,52.0,-0.0034880000000000015,29.52
8096,3640,-7210,13,15,28,46.43,-0.015839285714285715,25.785714285714285
8097,1620,-5180,8,14,22,36.36,-0.036113636363636355,19.545454545454547
8099,4440,-3510,16,14,30,53.33,0.0008266666666666663,31.833333333333332
8107,2182,11558,10,7,17,58.82,0.01121764705882353,36.76470588235294
8109,8119,-29339,10,16,26,38.46,-0.029057692307692302,65.57692307692308
8111,3252,11598,19,10,29,65.52,0.02353793103448276,25.379310344827587
8121,3110,4350,11,9,20,55.0,0.004015000000000001,15.8
8147,3330,-10410,6,8,14,42.86,-0.02014285714285714,39.714285714285715
8155,5681,19469,7,4,11,63.64,0.021300000000000006,14.181818181818182
8171,1817,-2497,7,7,14,50.0,-0.0064500000000000035,29.428571428571427
8176,1039,-3829,5,9,14,35.71,-0.03562857142857144,29.714285714285715
8182,2634,-7444,8,10,18,44.44,-0.017172222222222217,35.94444444444444
8183,2539,14261,18,7,25,72.0,0.036732,33.08
8234,4010,600,14,12,26,53.85,0.001676923076923078,47.38461538461539
8240,7898,-20318,10,16,26,38.46,-0.028988461538461532,38.61538461538461
8255,13849,-71399,9,12,21,42.86,-0.020071428571428566,46.476190476190474
8277,3226,-3246,17,12,29,58.62,0.013851724137931036,19.379310344827587
8279,8461,-36581,5,7,12,41.67,-0.022541666666666668,34.25
8284,2076,17444,6,2,8,75.0,0.04425,107.75
8289,1746,-14906,4,13,17,23.53,-0.05923529411764705,46.11764705882353
8291,464,-264,4,4,8,50.0,-0.010412499999999998,32.5
8299,41938,151712,17,10,27,62.96,0.02002592592592593,38.0
8342,1389,-10129,2,3,5,40.0,-0.04244,175.8
8349,4655,40175,10,5,15,66.67,0.027573333333333335,75.4
8354,1947,4873,12,8,20,60.0,0.018585000000000004,81.45
8358,2630,3340,9,5,14,64.29,0.016414285714285715,29.714285714285715
8383,3932,-27372,7,13,20,35.0,-0.035910000000000004,48.0
8390,3952,-1602,9,10,19,47.37,-0.006889473684210526,23.63157894736842
8401,1892,4078,10,6,16,62.5,0.019218750000000003,50.5625
8403,4433,-3363,10,10,20,50.0,-0.005825,62.55
8409,1025,-18165,0,5,5,0.0,-0.1061,52.0
8410,4120,8220,12,9,21,57.14,0.008395238095238093,46.714285714285715
8415,1388,-10698,3,5,8,37.5,-0.030837499999999997,85.25
8416,6818,-55168,3,7,10,30.0,-0.04591,86.4
8418,2036,-9256,4,9,13,30.77,-0.04436153846153846,62.07692307692308
8420,1483,517,5,3,8,62.5,0.018924999999999997,39.0
8421,1057,-687,6,6,12,50.0,-0.006258333333333334,38.916666666666664
8423,1106,-10566,2,6,8,25.0,-0.055674999999999995,69.625
8424,3684,-14,7,6,13,53.85,-0.004692307692307692,77.0
8426,2028,-2648,5,5,10,50.0,-0.005899999999999997,25.1
8431,5724,6326,9,7,16,56.25,0.0036062499999999983,19.5625
8432,4680,-35330,4,8,12,33.33,-0.03919999999999999,50.166666666666664
8433,3046,-29766,3,5,8,37.5,-0.030787499999999995,45.125
8435,3528,-17178,5,7,12,41.67,-0.022449999999999998,165.66666666666666
8436,26767,221743,16,5,21,76.19,0.04643809523809525,22.476190476190474
8437,8444,55556,6,2,8,75.0,0.044075,61.625
8440,2341,-11871,8,8,16,50.0,-0.0058687499999999955,54.5
8444,2008,5462,2,2,4,50.0,-0.0057,73.25
8446,4381,34349,5,2,7,71.43,0.046657142857142855,64.28571428571429
8450,5213,2017,9,5,14,64.29,0.020571428571428574,53.142857142857146
8455,1888,-18668,3,8,11,27.27,-0.05134545454545454,44.72727272727273
8472,1468,18852,6,1,7,85.71,0.06559999999999999,55.0
8476,2183,9607,6,4,10,60.0,0.024490000000000005,36.3
8477,1948,-1248,4,4,8,50.0,-0.005887500000000004,54.75
8489,7014,111966,11,0,11,100.0,0.09417272727272728,25.363636363636363
8905,2094,7076,11,9,20,55.0,0.0036650000000000016,68.25
8906,995,-6085,5,11,16,31.25,-0.046312500000000006,53.1875
8908,2174,3936,5,8,13,38.46,-0.029799999999999997,101.3076923076923
8916,3928,-8618,13,10,23,56.52,0.00694782608695653,85.95652173913044
8917,2619,-10459,3,5,8,37.5,-0.0310375,246.375
8921,350,-1610,2,3,5,40.0,-0.027360000000000002,45.6
8923,942,-1492,5,5,10,50.0,-0.006210000000000002,159.7
8924,6767,-11457,13,12,25,52.0,-0.0018999999999999983,62.12
8927,1967,7693,14,7,21,66.67,0.027090476190476193,99.28571428571429
8928,2998,9622,16,10,26,61.54,0.016519230769230772,52.96153846153846
8929,5211,-1361,15,14,29,51.72,-0.0027758620689655143,38.689655172413794
8930,1520,-1560,10,9,19,52.63,-0.0014421052631578945,47.578947368421055
8931,2372,20958,17,5,22,77.27,0.048081818181818184,84.45454545454545
8932,1357,-6937,7,12,19,36.84,-0.033326315789473676,30.31578947368421
8933,2498,8822,18,12,30,60.0,0.013199999999999998,39.666666666666664
8935,1387,-5037,8,13,21,38.1,-0.033052380952380944,40.476190476190474
8936,5552,11938,18,16,34,52.94,-0.0001382352941176441,28.235294117647058
8937,2281,-9461,9,14,23,39.13,-0.027747826086956525,44.82608695652174
8938,9498,2362,17,15,32,53.12,0.003456250000000001,55.96875
8941,4559,5101,10,7,17,58.82,0.011482352941176471,59.294117647058826
8942,8602,81158,20,6,26,76.92,0.04553846153846154,57.76923076923077
9949,2094,12816,10,5,15,66.67,0.027313333333333332,41.6
9950,1604,-9544,6,9,15,40.0,-0.0306,81.2
9951,7196,8684,9,8,17,52.94,-0.001152941176470583,51.294117647058826
9960,2476,-7096,8,9,17,47.06,-0.010141176470588232,43.88235294117647
9962,1894,5616,11,7,18,61.11,0.010833333333333337,35.5
8916A,582,-9522,0,2,2,0.0,-0.09209999999999999,567.5
4148,3365,18875,5,4,9,55.56,0.005344444444444445,28.333333333333332
6781,23057,207943,3,1,4,75.0,0.044075,22.5
6776,493,277,1,1,2,50.0,-0.005949999999999997,16.5
2211,990,15240,3,0,3,100.0,0.09393333333333333,19.333333333333332
6768,441,6559,1,0,1,100.0,0.0937,255.0
3357,3014,16356,6,3,9,66.67,0.027366666666666668,260.77777777777777
6741,4198,-14448,1,2,3,33.33,-0.03923333333333333,9.666666666666666
2250,2351,20129,3,1,4,75.0,0.043925000000000006,21.0
5236,2399,39651,3,0,3,100.0,0.0943,29.666666666666668
1522A,253,-2353,0,1,1,0.0,-0.055,374.0
6684,2022,33398,3,0,3,100.0,0.0943,5.666666666666667
2753,785,12965,1,0,1,100.0,0.0943,105.0
2348A,217,-367,0,1,1,0.0,-0.0099,22.0
6790,276,4564,1,0,1,100.0,0.0942,76.0
6788,720,11880,1,0,1,100.0,0.0943,5.0
2947,591,909,1,0,1,100.0,0.009,6.0
4440,253,4167,1,0,1,100.0,0.0943,31.0
5222,1525,21045,3,1,4,75.0,0.044075,28.0
2881C,0,0,0,0,0,0.0,,
6761,1195,-1995,1,1,2,50.0,-0.005850000000000001,25.5
6806,1129,-2369,1,1,2,50.0,-0.005850000000000001,72.5
2945,730,12060,2,0,2,100.0,0.0943,13.0
6770,192,3168,1,0,1,100.0,0.0944,5.0
6792,665,10985,1,0,1,100.0,0.0943,8.0
4770,1495,24705,1,0,1,100.0,0.0943,5.0
2883B,0,0,0,0,0,0.0,,
6691,1059,-20659,0,1,1,0.0,-0.1054,40.0
3592,5999,53891,7,4,11,63.64,0.021381818181818186,193.63636363636363
6719,10775,3675,2,2,4,50.0,-0.005850000000000001,6.5
2756,565,-9985,0,1,1,0.0,-0.106,28.0
5244,706,-3146,2,5,7,28.57,-0.04951428571428571,58.0
6693,493,-8733,0,1,1,0.0,-0.106,33.0
8112A,244,-1644,0,1,1,0.0,-0.0397,141.0
8438,688,-5058,1,3,4,25.0,-0.05564999999999999,162.0
6829,431,-8401,0,1,1,0.0,-0.1054,24.0
4923,0,0,0,0,0,0.0,,
6763,5889,38111,1,1,2,50.0,0.032799999999999996,14.0
4558,525,5585,2,1,3,66.67,0.027766666666666665,23.0
3349,0,0,0,0,0,0.0,,
6804,288,-5108,0,1,1,0.0,-0.1061,2.0
4768,1277,-22597,0,2,2,0.0,-0.106,8.5
6807,0,0,0,0,0,0.0,,
6721,0,0,0,0,0,0.0,,
6735,395,-7695,0,1,1,0.0,-0.1054,13.0
4583,0,0,0,0,0,0.0,,
6799,0,0,0,0,0,0.0,,
6585,384,3716,1,0,1,100.0,0.0559,58.0
5228,790,3180,3,2,5,60.0,0.014240000000000003,34.4
6546,499,821,3,2,5,60.0,0.014059999999999994,393.0
6796,0,0,0,0,0,0.0,,
6550,1322,8848,3,1,4,75.0,0.044375,19.25
4577,168,-2968,0,1,1,0.0,-0.1062,7.0
6789,0,0,0,0,0,0.0,,
6823,633,9417,1,0,1,100.0,0.0937,14.0
2887Z1,0,0,0,0,0,0.0,,
6811,0,0,0,0,0,0.0,,
6854,0,0,0,0,0,0.0,,
