代號,總成本,總損益(淨),獲利次數,損失次數,總交易次數,勝率%,平均報酬,平均持倉時間(日)
1101,11455,48545,55,26,81,67.9,0.03245432098765432,36.53086419753087
1102,9746,26104,45,27,72,62.5,0.02098055555555555,42.05555555555556
1103,3512,7588,26,17,43,60.47,0.018706976744186043,57.06976744186046
1104,7291,7649,50,37,87,57.47,0.011264367816091954,32.44827586206897
1108,4590,7880,47,28,75,62.67,0.0206,32.333333333333336
1109,3193,8467,30,16,46,65.22,0.021430434782608695,67.28260869565217
1110,8388,2172,68,53,121,56.2,0.007285950413223138,24.793388429752067
1201,11231,2909,58,45,103,56.31,0.011091262135922332,24.475728155339805
1203,7832,26398,55,36,91,60.44,0.022456043956043954,29.043956043956044
1210,4824,30726,32,14,46,69.57,0.035797826086956516,61.21739130434783
1213,7818,-3188,57,50,107,53.27,0.0034457943925233644,28.299065420560748
1215,7463,4297,57,43,100,57.0,0.010798,29.89
1216,15433,2867,53,37,90,58.89,0.010565555555555555,34.56666666666667
1217,2510,10860,27,13,40,67.5,0.04529999999999999,59.5
1218,7574,2226,62,54,116,53.45,0.00810948275862069,23.801724137931036
1219,7217,-2837,57,51,108,52.78,0.0010027777777777776,29.666666666666668
1220,5032,3658,45,36,81,55.56,0.009716049382716049,40.91358024691358
1225,8420,9190,72,56,128,56.25,0.014288281250000002,21.8125
1227,14365,59135,50,25,75,66.67,0.0302,41.82666666666667
1229,8499,9101,57,42,99,57.58,0.009371717171717172,29.282828282828284
1231,7381,26489,46,33,79,58.23,0.02043417721518987,37.87341772151899
1232,8075,17825,27,19,46,58.7,0.017123913043478264,72.95652173913044
1233,7411,34339,26,16,42,61.9,0.030688095238095237,78.4047619047619
1234,9140,13470,52,38,90,57.78,0.011375555555555555,34.87777777777778
1235,6892,23208,36,19,55,65.45,0.022774545454545454,52.872727272727275
1236,4586,24174,31,16,47,65.96,0.0314468085106383,61.53191489361702
1256,33471,206129,25,12,37,67.57,0.04371891891891892,22.62162162162162
1301,15996,50404,28,18,46,60.87,0.01995217391304348,73.73913043478261
1303,17292,44858,39,23,62,62.9,0.018306451612903223,48.03225806451613
1304,5966,16624,48,28,76,63.16,0.02150921052631579,31.63157894736842
1305,9657,10093,77,58,135,57.04,0.013002222222222222,19.6
1307,7978,25222,36,24,60,60.0,0.023956666666666664,46.46666666666667
1308,6532,13368,38,23,61,62.3,0.020468852459016397,38.721311475409834
1309,6065,12905,57,33,90,63.33,0.02055,26.877777777777776
1310,7890,-7060,50,40,90,55.56,0.0022077777777777755,30.61111111111111
1312,8489,2901,62,52,114,54.39,0.00533421052631579,21.36842105263158
1313,5218,14022,43,25,68,63.24,0.024261764705882354,37.1764705882353
1314,6977,1883,62,43,105,59.05,0.015829523809523807,26.0
1315,10284,31946,62,37,99,62.63,0.021763636363636363,27.636363636363637
1316,8809,1671,83,70,153,54.25,0.006416339869281047,17.88888888888889
1319,16033,18817,54,39,93,58.06,0.012188172043010752,27.27956989247312
1321,11764,15576,68,48,116,58.62,0.012752586206896553,25.06896551724138
1323,7175,23345,50,35,85,58.82,0.020316470588235293,34.4
1324,3810,28140,35,17,52,67.31,0.05334230769230768,59.38461538461539
1325,7277,29483,50,38,88,56.82,0.027429545454545456,34.26136363636363
1326,20154,57446,36,25,61,59.02,0.018811475409836066,47.459016393442624
1337,3173,-13153,24,27,51,47.06,-0.018852941176470583,32.372549019607845
1338,14231,-14631,21,18,39,53.85,0.001584615384615383,39.97435897435897
1339,5861,35589,18,7,25,72.0,0.04350399999999999,54.56
1340,3719,-26619,17,23,40,42.5,-0.016024999999999998,34.675
1341,1365,4535,3,1,4,75.0,0.025425,76.5
1342,310,4590,1,0,1,100.0,0.0931,11.0
1402,9142,37358,46,27,73,63.01,0.026338356164383563,38.917808219178085
1409,7079,5781,67,48,115,58.26,0.010236521739130432,24.704347826086956
1410,10026,4544,73,56,129,56.59,0.006669767441860465,22.007751937984494
1413,7347,-4237,73,72,145,50.34,-0.0017227586206896546,19.63448275862069
1414,7433,9827,77,59,136,56.62,0.018527941176470587,20.154411764705884
1416,9847,6143,96,68,164,58.54,0.011295731707317073,17.75
1417,4609,3621,50,29,79,63.29,0.015053164556962026,30.746835443037973
1418,6255,-6135,58,63,121,47.93,-0.010149586776859502,19.380165289256198
1419,16457,29743,68,52,120,56.67,0.011797499999999999,21.691666666666666
1423,4901,11899,54,29,83,65.06,0.02499156626506024,35.89156626506024
1432,10701,-5621,89,83,172,51.74,0.0047168604651162795,14.837209302325581
1434,6572,23078,35,21,56,62.5,0.019126785714285714,50.035714285714285
1435,4748,15682,52,32,84,61.9,0.03959285714285714,27.464285714285715
1436,6556,7124,56,43,99,56.57,0.01618989898989899,31.575757575757574
1437,7127,45233,62,25,87,71.26,0.04424597701149425,30.724137931034484
1438,9605,-7265,112,102,214,52.34,-0.009742990654205608,10.649532710280374
1439,5779,3561,40,35,75,53.33,0.008384,41.18666666666667
1440,6573,31177,64,29,93,68.82,0.03683225806451613,27.892473118279568
1441,7734,5296,75,68,143,52.45,0.012441258741258746,17.622377622377623
1442,9687,37793,69,52,121,57.02,0.027949586776859506,23.03305785123967
1443,7854,-1624,85,72,157,54.14,0.0020942675159235655,17.828025477707005
1444,6290,9050,64,45,109,58.72,0.013825688073394493,24.137614678899084
1445,5541,5399,52,44,96,54.17,0.010826041666666666,29.708333333333332
1446,8547,2463,66,66,132,50.0,0.0025295454545454553,20.916666666666668
1447,5555,12075,55,37,92,59.78,0.016348913043478262,23.445652173913043
1449,8386,-4806,84,90,174,48.28,-0.002508045977011495,15.614942528735632
1451,5832,12308,33,23,56,58.93,0.017189285714285716,56.035714285714285
1452,6973,7547,69,42,111,62.16,0.012770270270270268,26.315315315315317
1453,8798,7102,83,82,165,50.3,0.012929696969696975,12.333333333333334
1454,4997,3883,50,36,86,58.14,0.008994186046511626,34.093023255813954
1455,5500,3620,49,37,86,56.98,0.0062220930232558145,31.74418604651163
1456,8130,-6270,86,82,168,51.19,-0.011585714285714286,15.619047619047619
1457,6456,4354,67,47,114,58.77,0.011466666666666667,26.342105263157894
1459,4562,9618,42,30,72,58.33,0.022230555555555555,40.55555555555556
1460,6101,2809,56,45,101,55.45,0.009825742574257421,28.11881188118812
1463,8546,-366,77,65,142,54.23,0.0037091549295774646,20.091549295774648
1464,5974,10206,59,37,96,61.46,0.016763541666666666,28.614583333333332
1465,4857,10633,41,27,68,60.29,0.01785735294117647,43.779411764705884
1466,9052,24298,86,62,148,58.11,0.020537837837837837,18.39864864864865
1467,5178,12762,44,31,75,58.67,0.018205333333333334,30.573333333333334
1468,2497,19073,23,11,34,67.65,0.05683529411764706,83.05882352941177
1470,7309,9351,65,57,122,53.28,0.014004918032786882,22.016393442622952
1471,7345,3605,62,66,128,48.44,0.004914843749999999,22.15625
1472,7718,10402,60,71,131,45.8,0.010242748091603056,21.15267175572519
1473,6771,-10521,23,23,46,50.0,-0.0028630434782608715,68.30434782608695
1474,4309,4781,39,26,65,60.0,0.014901538461538464,47.98461538461538
1475,9132,128,63,61,124,50.81,0.013635483870967741,17.830645161290324
1476,10341,33259,44,29,73,60.27,0.022664383561643835,43.945205479452056
1477,17979,6921,31,22,53,58.49,0.007852830188679244,57.56603773584906
1503,11743,30107,42,25,67,62.69,0.019867164179104477,43.88059701492537
1504,7626,4114,52,39,91,57.14,0.009971428571428572,34.13186813186813
1506,5265,13005,40,28,68,58.82,0.02078676470588235,41.029411764705884
1512,5053,4147,48,41,89,53.93,0.010092134831460674,28.269662921348313
1513,5868,25782,43,21,64,67.19,0.028646875,45.328125
1514,4033,3807,37,28,65,56.92,0.00764307692307692,39.6
1515,6121,-1181,50,43,93,53.76,0.005047311827956988,29.827956989247312
1516,11058,6772,90,87,177,50.85,0.00782316384180791,14.711864406779661
1517,5718,8312,48,38,86,55.81,0.014525581395348836,30.372093023255815
1519,5331,16439,41,22,63,65.08,0.022950793650793656,49.84126984126984
1521,16909,23601,51,40,91,56.04,0.009062637362637363,32.23076923076923
1522,10034,23366,53,33,86,61.63,0.02108255813953488,31.337209302325583
1524,4006,7914,36,24,60,60.0,0.01850333333333333,55.25
1525,15462,28688,45,36,81,55.56,0.013258024691358025,36.75308641975309
1526,9292,-12182,73,75,148,49.32,0.000506756756756758,18.445945945945947
1527,14623,-25773,38,31,69,55.07,0.001744927536231884,41.768115942028984
1528,5082,36098,55,16,71,77.46,0.05375492957746479,35.436619718309856
1529,9058,9322,78,93,172,45.35,0.03563023255813953,14.906976744186046
1530,10820,37830,39,25,64,60.94,0.029956249999999997,44.875
1531,6233,26867,40,22,62,64.52,0.02645161290322581,49.08064516129032
1532,9045,20255,36,22,58,62.07,0.02101551724137931,44.58620689655172
1533,14138,53422,59,42,101,58.42,0.02423960396039604,23.900990099009903
1535,15106,63594,53,31,84,63.1,0.029251190476190476,37.535714285714285
1536,11331,-3941,48,48,96,50.0,0.0038177083333333314,32.46875
1537,17334,29666,54,40,94,57.45,0.01201595744680851,33.07446808510638
1538,9897,-8887,70,87,157,44.59,0.004129936305732484,20.764331210191084
1539,6502,4588,57,40,97,58.76,0.010172164948453606,26.927835051546392
1540,3965,13385,27,14,41,65.85,0.028626829268292686,68.92682926829268
1541,7924,436,47,48,95,49.47,0.007421052631578947,25.83157894736842
1558,28084,117916,35,21,56,62.5,0.03115714285714286,34.80357142857143
1560,20487,20063,45,38,83,54.22,0.00988433734939759,26.012048192771083
1568,4079,2921,19,16,35,54.29,0.012925714285714283,31.34285714285714
1582,18913,40387,37,25,62,59.68,0.01942741935483871,34.983870967741936
1583,16131,-19081,37,32,69,53.62,-0.003468115942028985,30.652173913043477
1587,2618,-2258,13,12,25,52.0,0.0013720000000000004,53.24
1589,20952,11798,33,24,57,57.89,0.013677192982456142,24.649122807017545
1590,80339,-33839,40,32,72,55.56,0.0011124999999999985,20.305555555555557
1597,11286,-3936,26,24,50,52.0,0.0013099999999999993,27.14
1598,3193,-5643,7,7,14,50.0,-0.0036142857142857183,49.285714285714285
1603,8265,13215,83,52,135,61.48,0.01586814814814815,19.37037037037037
1604,7812,-5352,67,59,126,53.17,0.00488015873015873,22.952380952380953
1605,5546,17254,50,27,77,64.94,0.02571688311688312,33.285714285714285
1608,5564,12876,56,33,89,62.92,0.01972247191011236,28.84269662921348
1609,3772,11378,38,20,58,65.52,0.028613793103448276,51.51724137931034
1611,4044,626,34,24,58,58.62,0.010363793103448276,50.206896551724135
1612,3169,10591,31,15,46,67.39,0.029276086956521733,60.30434782608695
1614,5952,52048,32,14,46,69.57,0.0499804347826087,55.130434782608695
1615,5028,9032,41,30,71,57.75,0.01703943661971831,42.45070422535211
1616,3682,8518,40,24,64,62.5,0.028845312499999998,42.171875
1617,3667,8603,32,22,54,59.26,0.02259074074074074,47.01851851851852
1618,4679,10261,42,29,71,59.15,0.02021830985915493,37.95774647887324
1626,4809,-10609,16,21,37,43.24,-0.0068405405405405385,36.891891891891895
1701,8614,29066,63,36,99,63.64,0.02274949494949495,26.595959595959595
1702,11767,29603,78,63,141,55.32,0.013500709219858156,19.382978723404257
1707,14104,4836,59,44,103,57.28,0.01147281553398058,30.49514563106796
1708,10223,34007,58,29,87,66.67,0.027998850574712644,32.206896551724135
1709,3379,6101,24,18,42,57.14,0.015738095238095235,67.38095238095238
1710,10027,9473,47,33,80,58.75,0.008561249999999998,34.6875
1711,7646,27174,55,30,85,64.71,0.023639999999999998,28.32941176470588
1712,7414,786,61,46,107,57.01,0.0064252336448598155,27.700934579439252
1713,7014,15826,58,39,97,59.79,0.01896907216494845,27.84536082474227
1714,3642,2318,31,23,54,57.41,0.016590740740740743,57.77777777777778
1717,6710,1640,30,21,51,58.82,0.004698039215686275,52.549019607843135
1718,6485,8115,63,41,104,60.58,0.01307596153846154,22.89423076923077
1720,10031,26069,47,26,73,64.38,0.020063013698630137,38.657534246575345
1721,7688,6122,64,58,122,52.46,0.016140163934426233,21.28688524590164
1722,9879,7221,27,19,46,58.7,0.0183804347826087,63.15217391304348
1723,25162,168788,42,18,60,70.0,0.03881333333333334,51.233333333333334
1725,3818,20632,28,12,40,70.0,0.03227,75.55
1726,13443,27957,29,22,51,56.86,0.016633333333333333,65.05882352941177
1727,4906,44504,45,15,60,75.0,0.061086666666666664,44.63333333333333
1730,6742,1478,41,41,82,50.0,0.007937804878048783,35.59756097560975
1731,3446,19884,28,15,43,65.12,0.039158139534883715,56.27906976744186
1732,4928,13372,38,29,67,56.72,0.02077910447761194,40.46268656716418
1733,11522,6478,30,22,52,57.69,0.011284615384615383,53.96153846153846
1734,7767,17183,34,22,56,60.71,0.02171607142857143,41.982142857142854
1735,3420,6730,25,19,44,56.82,0.018234090909090908,67.52272727272727
1736,27611,62089,63,39,102,61.76,0.01947745098039216,26.34313725490196
1737,9819,9681,42,37,79,53.16,0.009118987341772149,34.734177215189874
1760,5641,17459,30,22,52,57.69,0.021055769230769232,47.28846153846154
1762,10933,38167,29,18,47,61.7,0.024455319148936165,34.48936170212766
1773,7827,37523,24,10,34,70.59,0.03707941176470588,52.205882352941174
1776,1592,6008,9,6,15,60.0,0.027106666666666668,55.13333333333333
1783,5192,43858,21,8,29,72.41,0.06369655172413792,20.448275862068964
1786,9987,-33287,14,19,33,42.42,-0.014021212121212122,35.63636363636363
1789,7427,-4977,24,19,43,55.81,0.00041162790697674785,40.72093023255814
1795,17834,44216,41,30,71,57.75,0.021859154929577466,20.64788732394366
1802,7901,13459,42,31,73,57.53,0.01338219178082192,40.986301369863014
1805,8562,-9082,76,95,171,44.44,-0.029098245614035085,13.140350877192983
1806,3879,6951,41,22,63,65.08,0.022328571428571434,44.04761904761905
1808,13786,64564,71,53,124,57.26,0.024283870967741938,19.39516129032258
1809,5822,9948,49,35,84,58.33,0.014578571428571427,29.214285714285715
1810,4571,15239,50,21,71,70.42,0.029401408450704224,36.7887323943662
1817,2175,13825,8,3,11,72.73,0.037936363636363636,117.72727272727273
1903,10313,18487,36,24,60,60.0,0.0163,48.05
1904,5200,12150,44,28,72,61.11,0.01982638888888889,36.541666666666664
1905,3923,2637,30,22,52,57.69,0.015213461538461537,54.44230769230769
1906,8368,1992,79,68,147,53.74,0.008580272108843538,18.517006802721088
1907,5356,26624,50,21,71,70.42,0.03470140845070423,35.76056338028169
1909,6439,8681,55,38,93,59.14,0.01453655913978495,30.655913978494624
2002,3517,8833,17,10,27,62.96,0.020985185185185187,122.07407407407408
2006,5309,27491,35,18,53,66.04,0.034877358490566036,49.132075471698116
2007,5105,14385,60,33,93,64.52,0.040707526881720434,22.913978494623656
2008,8032,-5102,62,65,128,48.44,-0.0014679687499999988,19.1953125
2009,4959,16721,51,26,77,66.23,0.033631168831168824,34.23376623376623
2010,3102,14418,29,11,40,72.5,0.0364025,69.825
2012,8599,-3609,64,60,124,51.61,0.005097580645161286,24.032258064516128
2013,7388,29062,41,25,66,62.12,0.02759242424242424,45.81818181818182
2014,6562,5898,52,44,96,54.17,0.01137604166666667,28.645833333333332
2015,16900,83750,60,28,88,68.18,0.03100454545454545,32.52272727272727
2017,4835,5185,46,35,81,56.79,0.018764197530864196,30.88888888888889
2020,3253,20097,25,10,35,71.43,0.042151428571428576,90.4
2022,4438,8662,49,29,78,62.82,0.025346153846153848,33.82051282051282
2023,4623,19947,38,21,59,64.41,0.023557627118644068,50.067796610169495
2024,8420,4110,81,69,150,54.0,0.008882666666666665,17.106666666666666
2025,7587,-6317,69,86,155,44.52,-0.009305161290322583,17.580645161290324
2027,9591,21209,59,38,97,60.82,0.022181443298969074,27.567010309278352
2028,7290,-650,67,67,134,50.0,0.0036119402985074637,20.940298507462686
2029,4873,55727,30,6,36,83.33,0.06970555555555556,59.97222222222222
2030,5700,30280,51,22,73,69.86,0.03932876712328768,40.26027397260274
2031,9814,14186,45,29,74,60.81,0.017002702702702707,36.45945945945946
2032,5003,25947,43,23,66,65.15,0.03612424242424243,42.93939393939394
2033,4114,4486,30,27,57,52.63,0.01716666666666667,52.50877192982456
2034,9849,34131,52,31,83,62.65,0.02584457831325301,38.493975903614455
2038,3372,2588,25,19,44,56.82,0.02080227272727273,41.56818181818182
2049,54391,212409,42,20,62,67.74,0.03375322580645161,22.741935483870968
2059,92231,34169,54,42,96,56.25,0.006862499999999998,26.927083333333332
2062,8552,11998,25,21,46,54.35,0.014743478260869561,44.30434782608695
2069,1911,-511,10,9,19,52.63,0.0023421052631578967,35.63157894736842
2101,10870,50430,47,24,71,66.2,0.029981690140845067,38.57746478873239
2102,7406,2304,43,34,77,55.84,0.004996103896103897,35.41558441558441
2103,10135,33515,53,25,78,67.95,0.031176923076923078,35.35897435897436
2104,7440,37360,42,22,64,65.62,0.027315625000000003,47.8125
2105,23771,66929,54,37,91,59.34,0.01585164835164835,31.835164835164836
2106,15758,8592,59,49,108,54.63,0.0074675925925925925,24.36111111111111
2107,9084,40556,63,35,98,64.29,0.02801530612244898,31.653061224489797
2108,5570,5030,31,25,56,55.36,0.008866071428571426,53.660714285714285
2109,5971,6729,49,36,85,57.65,0.011945882352941178,30.011764705882353
2114,15266,66184,34,21,55,61.82,0.025416363636363636,42.10909090909091
2115,4817,14883,12,9,21,57.14,0.022090476190476188,58.95238095238095
2201,11540,33910,40,36,76,52.63,0.015392105263157894,35.85526315789474
2204,9475,75465,42,26,68,61.76,0.03738970588235295,34.25
2206,8712,17968,62,45,107,57.94,0.011531775700934579,25.813084112149532
2207,31311,131989,43,23,66,65.15,0.03201818181818182,48.40909090909091
2208,4928,-2028,22,20,42,52.38,0.011611904761904763,45.785714285714285
2227,53672,73328,41,42,83,49.4,0.0048891566265060245,31.481927710843372
2228,16980,-76980,15,18,33,45.45,-0.019506060606060603,44.121212121212125
2231,39451,291349,41,25,66,62.12,0.030871212121212122,25.37878787878788
2233,16192,-3792,21,20,41,51.22,0.0053073170731707305,35.26829268292683
2236,4223,-2923,18,16,34,52.94,0.002835294117647059,28.205882352941178
2239,17333,-56333,18,20,38,47.37,-0.011057894736842107,24.657894736842106
2241,4577,6223,8,7,15,53.33,0.006893333333333326,25.933333333333334
2243,3930,15020,25,20,45,55.56,0.02994666666666666,15.022222222222222
2247,1210,-6710,0,1,1,0.0,-0.0318,264.0
2301,11100,10750,31,24,55,56.36,0.009472727272727272,48.945454545454545
2302,6649,10421,70,54,124,56.45,0.02179516129032258,19.120967741935484
2303,6179,10681,38,27,65,58.46,0.01622923076923077,41.323076923076925
2305,7330,10390,79,56,135,58.52,0.0192037037037037,19.133333333333333
2308,35098,25802,42,34,76,55.26,0.007768421052631576,38.93421052631579
2312,5575,20735,53,25,78,67.95,0.030097435897435895,37.03846153846154
2313,10633,-7183,72,61,133,54.14,0.0034413533834586466,20.49624060150376
2314,6563,26997,50,31,81,61.73,0.030504938271604932,23.580246913580247
2316,10626,-1166,75,60,135,55.56,0.001684444444444444,20.85925925925926
2317,28068,42432,33,26,59,55.93,0.013072881355932205,54.86440677966102
2321,9466,-16706,86,107,193,44.56,-0.010423834196891196,15.481865284974093
2323,4939,-2719,43,40,83,51.81,0.0017686746987951815,37.45783132530121
2324,5807,6443,28,19,47,59.57,0.01265531914893617,67.27659574468085
2327,9894,-2454,72,59,131,54.96,0.007735877862595419,21.282442748091604
2328,9518,25032,49,30,79,62.03,0.021443037974683547,35.0
2329,8423,-693,80,72,152,52.63,0.00224013157894737,15.789473684210526
2330,19307,9443,34,25,59,57.63,0.009418644067796607,54.13559322033898
2331,10253,10517,68,50,118,57.63,0.007199152542372884,22.627118644067796
2332,7857,-8577,46,41,87,52.87,0.0012114942528735637,38.88505747126437
2337,8500,-5420,66,71,137,48.18,0.0014065693430656957,21.401459854014597
2338,4972,12348,36,20,56,64.29,0.023255357142857144,48.82142857142857
2340,7654,5776,61,42,103,59.22,0.007159223300970873,24.864077669902912
2342,9934,14016,85,89,174,48.85,0.03159080459770115,15.195402298850574
2344,7381,10859,65,46,111,58.56,0.015207207207207207,20.324324324324323
2345,12756,-18426,68,57,125,54.4,0.004822400000000004,22.968
2347,10503,-15503,24,20,44,54.55,0.0024795454545454526,67.1590909090909
2348,12397,2293,102,104,206,49.51,0.01037330097087378,12.048543689320388
2349,6129,2841,50,55,105,47.62,0.005322857142857145,28.266666666666666
2351,15255,70555,73,41,114,64.04,0.029212280701754384,21.017543859649123
2352,8458,24932,57,29,86,66.28,0.028091860465116282,32.74418604651163
2353,8713,4837,39,35,74,52.7,0.006732432432432434,44.013513513513516
2354,19891,92709,34,17,51,66.67,0.035656862745098036,53.96078431372549
2355,9463,4307,44,31,75,58.67,0.008361333333333332,40.053333333333335
2356,6694,17926,39,26,65,60.0,0.018801538461538456,47.95384615384615
2357,49729,167071,49,41,90,54.44,0.043675555555555565,32.75555555555555
2358,9003,5657,69,68,137,50.36,0.005004379562043794,14.897810218978103
2359,8261,7539,63,56,119,52.94,0.006734453781512604,22.285714285714285
2360,26599,92701,69,39,108,63.89,0.020920370370370363,24.333333333333332
2362,13443,74877,64,33,97,65.98,0.025855670103092785,28.54639175257732
2363,7194,17256,61,40,101,60.4,0.01871782178217822,27.831683168316832
2364,5009,-1929,52,50,102,50.98,0.00893725490196079,21.69607843137255
2365,5374,-314,41,33,74,55.41,0.005497297297297299,46.2972972972973
2367,7587,7053,56,45,101,55.45,0.010480198019801983,24.81188118811881
2368,7140,22660,64,36,100,64.0,0.02780100000000001,26.02
2369,6638,35902,62,29,91,68.13,0.03992857142857143,24.9010989010989
2371,6805,22295,62,40,102,60.78,0.034440196078431386,24.745098039215687
2373,12918,31482,49,36,85,57.65,0.02348352941176471,34.188235294117646
2374,6272,18648,36,24,60,60.0,0.021839999999999995,45.63333333333333
2375,9082,-2992,78,68,146,53.42,0.004333561643835616,18.513698630136986
2376,15745,-2045,54,40,94,57.45,0.007607446808510639,31.02127659574468
2377,20088,-66188,60,57,117,51.28,-0.0048025641025641035,24.76923076923077
2379,36747,146003,65,47,112,58.04,0.02207589285714286,22.651785714285715
2380,6439,8281,54,45,99,54.55,0.017058585858585856,31.22222222222222
2382,24937,69213,46,32,78,58.97,0.019392307692307695,31.897435897435898
2383,11633,4687,80,63,143,55.94,0.007674825174825174,19.48951048951049
2385,29841,31759,60,44,104,57.69,0.011147115384615384,28.067307692307693
2387,8299,3751,40,30,70,57.14,0.006954285714285713,41.357142857142854
2388,12230,50880,60,46,106,56.6,0.03410471698113208,20.160377358490567
2390,7720,1900,65,49,114,57.02,0.007065789473684209,24.92982456140351
2392,17221,27779,39,33,72,54.17,0.01249861111111111,40.65277777777778
2393,16802,38498,38,26,64,59.38,0.019387500000000002,41.90625
2395,29088,-88,41,31,72,56.94,0.00588888888888889,44.875
2397,11981,77369,45,20,65,69.23,0.03716307692307692,39.10769230769231
2399,6317,23853,47,33,80,58.75,0.03014,29.5625
2401,10517,35783,62,31,93,66.67,0.032936559139784945,34.075268817204304
2402,10170,18210,70,41,111,63.06,0.01707207207207207,27.126126126126128
2404,13473,4877,47,36,83,56.63,0.008971084337349397,36.68674698795181
2405,7106,2374,55,42,97,56.7,0.01321546391752577,27.237113402061855
2406,10752,47928,90,58,148,60.81,0.03367635135135135,15.121621621621621
2408,13607,44393,76,73,149,51.01,0.05683221476510067,18.86577181208054
2409,6539,-3649,44,41,85,51.76,0.0012529411764705882,36.588235294117645
2412,9894,83206,19,8,27,70.37,0.05274074074074075,126.11111111111111
2413,8620,28190,67,45,112,59.82,0.027093749999999996,20.241071428571427
2414,6962,16918,48,33,81,59.26,0.018776543209876543,32.97530864197531
2415,8399,23801,56,41,97,57.73,0.02235257731958763,24.216494845360824
2417,8856,16784,51,41,92,55.43,0.009757608695652174,33.79347826086956
2419,9813,13897,79,55,134,58.96,0.011988805970149254,20.05223880597015
2420,13495,10805,63,46,109,57.8,0.007290825688073399,25.256880733944953
2421,7118,-2018,36,33,69,52.17,0.0035710144927536217,41.927536231884055
2423,5720,34130,37,17,54,68.52,0.037664814814814825,53.629629629629626
2424,10138,-138,71,72,143,49.65,0.007325174825174827,17.6993006993007
2425,14024,10086,101,102,203,49.75,0.010003448275862066,12.87192118226601
2426,7218,21422,56,40,96,58.33,0.02379791666666667,24.625
2427,3183,12987,35,14,49,71.43,0.035932653061224486,47.857142857142854
2428,13201,19249,51,38,89,57.3,0.013261797752808982,31.741573033707866
2429,10537,-6597,90,104,194,46.39,-0.0027252577319587593,11.778350515463918
2430,7879,29721,35,21,56,62.5,0.029962500000000003,52.339285714285715
2431,7367,18573,62,37,99,62.63,0.026180808080808082,25.2020202020202
2433,9479,13271,51,44,95,53.68,0.013753684210526314,31.063157894736843
2434,6490,21330,44,54,98,44.9,0.03895714285714286,29.908163265306122
2436,11001,12699,60,41,101,59.41,0.013166336633663362,24.722772277227723
2438,7833,167,69,82,151,45.7,0.009407947019867548,16.29801324503311
2439,36607,117243,62,37,99,62.63,0.02583434343434343,24.818181818181817
2440,6213,9737,61,48,109,55.96,0.017100917431192658,20.568807339449542
2441,11881,45969,45,23,68,66.18,0.026310294117647057,41.48529411764706
2442,5005,19105,52,27,79,65.82,0.03475949367088608,27.063291139240505
2443,7877,-9697,73,80,153,47.71,-0.012916993464052288,17.18954248366013
2444,9645,34435,84,54,138,60.87,0.02833695652173913,16.847826086956523
2449,10648,-6788,57,48,105,54.29,0.003024761904761907,23.580952380952382
2450,16261,142889,48,24,72,66.67,0.041525000000000006,38.083333333333336
2451,27857,132493,44,23,67,65.67,0.03281194029850746,40.23880597014925
2453,6852,30358,62,32,94,65.96,0.03165744680851063,23.21276595744681
2454,106795,458205,41,22,63,65.08,0.026414285714285713,33.44444444444444
2455,20089,50001,82,62,144,56.94,0.01604375,17.868055555555557
2457,8335,16785,55,33,88,62.5,0.023590909090909093,26.988636363636363
2458,15908,-2408,56,45,101,55.45,0.0006762376237623742,24.03960396039604
2459,10125,27635,38,25,63,60.32,0.01660952380952381,40.36507936507937
2460,6421,25989,45,30,75,60.0,0.023785333333333335,39.57333333333333
2461,7001,21949,48,24,72,66.67,0.026405555555555557,36.666666666666664
2462,9505,6185,45,40,85,52.94,0.009084705882352943,30.51764705882353
2464,9727,26773,42,23,65,64.62,0.018949230769230774,39.10769230769231
2465,8733,-3353,69,63,132,52.27,0.0058613636363636385,18.272727272727273
2466,8353,42687,49,34,83,59.04,0.022345783132530123,36.27710843373494
2467,9574,27456,57,36,93,61.29,0.02286021505376344,30.795698924731184
2468,4509,23881,44,20,64,68.75,0.039732812500000006,43.875
2471,7540,6840,55,46,101,54.46,0.007988118811881191,27.396039603960396
2472,12885,-6565,77,62,139,55.4,0.004841726618705038,19.93525179856115
2474,97879,328121,84,51,135,62.22,0.018985925925925927,17.622222222222224
2476,6189,52411,39,12,51,76.47,0.05298039215686275,44.8235294117647
2477,10186,34174,53,36,89,59.55,0.028519101123595503,27.280898876404493
2478,9874,11876,43,30,73,58.9,0.015052054794520549,36.67123287671233
2480,10439,4961,47,32,79,59.49,0.012205063291139242,35.45569620253165
2481,10439,14281,57,41,98,58.16,0.01379591836734694,26.683673469387756
2482,6593,24897,48,30,78,61.54,0.026250000000000002,38.03846153846154
2483,6144,38806,44,21,65,67.69,0.040083076923076916,40.63076923076923
2484,7911,31289,56,30,86,65.12,0.0247406976744186,27.069767441860463
2485,12503,-22803,45,37,82,54.88,0.002493902439024388,35.84146341463415
2486,7756,-10726,46,48,94,48.94,-0.0023776595744680884,30.340425531914892
2488,7989,6101,40,30,70,57.14,0.01002285714285714,44.357142857142854
2489,7152,1658,44,37,81,54.32,0.005851851851851849,37.888888888888886
2491,9716,-926,83,100,183,45.36,0.004037704918032787,13.251366120218579
2492,13977,-7367,65,53,118,55.08,0.005998305084745766,22.93220338983051
2493,11261,8109,71,56,127,55.91,0.010159842519685039,23.74015748031496
2495,6987,-5937,37,34,71,52.11,0.0025098591549295784,48.91549295774648
2496,11986,9234,113,112,225,50.22,0.024558666666666666,11.231111111111112
2497,9487,59213,55,24,79,69.62,0.03768860759493671,28.39240506329114
2498,78630,-364530,69,71,140,49.29,-0.008542857142857138,23.107142857142858
2501,7675,21795,55,40,95,57.89,0.022502105263157886,27.705263157894738
2504,4123,5197,42,25,67,62.69,0.01887164179104478,41.059701492537314
2505,8143,27817,75,45,120,62.5,0.03225583333333334,18.216666666666665
2506,10229,-4519,109,94,203,53.69,0.003939408866995076,13.334975369458128
2509,9065,27665,67,50,117,57.26,0.0222982905982906,23.128205128205128
2511,6975,13805,66,37,103,64.08,0.017283495145631066,24.29126213592233
2514,7581,5849,61,44,105,58.1,0.015635238095238094,27.6
2515,4455,9515,53,26,79,67.09,0.02208860759493671,32.65822784810127
2516,6688,5902,65,57,123,52.85,0.007868292682926825,21.235772357723576
2520,13450,11650,91,67,158,57.59,0.01144746835443038,15.221518987341772
2524,10320,63130,59,28,87,67.82,0.035804597701149424,29.93103448275862
2527,9257,26153,79,67,146,54.11,0.012453424657534245,15.801369863013699
2528,11440,14890,95,145,240,39.58,-0.0031100000000000017,10.208333333333334
2530,10877,-3067,100,90,190,52.63,-0.0007968421052631578,13.326315789473684
2534,11180,23790,76,50,126,60.32,0.018032539682539685,20.49206349206349
2535,9420,4460,72,52,124,58.06,0.011055645161290317,23.508064516129032
2536,6120,38010,43,17,60,71.67,0.05071333333333334,38.05
2537,8980,6670,79,90,169,46.75,0.0036923076923076944,14.431952662721894
2538,8878,6212,68,56,124,54.84,0.012924193548387098,21.161290322580644
2539,12887,14493,75,79,154,48.7,0.025181818181818184,16.305194805194805
2540,9528,2712,92,105,197,46.7,0.06436294416243657,12.441624365482234
2542,22802,75618,96,60,156,61.54,0.019326282051282055,14.512820512820513
2543,5169,3891,51,36,87,58.62,0.013517241379310346,31.45977011494253
2545,16224,101666,73,30,103,70.87,0.04481650485436893,21.058252427184467
2546,10765,23475,94,65,159,59.12,0.017796855345911952,16.60377358490566
2547,6841,6579,46,36,82,56.1,0.013190243902439025,30.74390243902439
2548,22269,75101,68,42,110,61.82,0.028220000000000005,18.972727272727273
2597,6147,15253,18,12,30,60.0,0.017713333333333334,56.6
2601,7042,-17882,49,49,98,50.0,-0.0007316326530612273,29.316326530612244
2603,7303,26687,47,23,70,67.14,0.027167142857142862,38.1
2605,5702,2248,34,23,57,59.65,0.011635087719298248,54.50877192982456
2606,9861,52089,43,21,64,67.19,0.036328125,41.515625
2607,3933,9167,29,18,47,61.7,0.020719148936170214,61.53191489361702
2608,14746,724,85,67,152,55.92,0.0034309210526315796,20.5
2609,7006,16304,55,37,92,59.78,0.017850000000000005,28.73913043478261
2610,4455,-1665,34,30,64,53.12,0.0029187499999999977,45.71875
2611,3102,-2412,25,22,47,53.19,0.002025531914893617,61.46808510638298
2612,11324,-10624,50,39,89,56.18,0.007624719101123595,34.68539325842696
2613,6922,26828,63,33,96,65.62,0.03091354166666667,21.78125
2614,6849,28351,69,42,111,62.16,0.0379864864864865,21.09009009009009
2615,6659,18391,36,23,59,61.02,0.018027118644067794,46.016949152542374
2616,5417,5013,33,26,59,55.93,0.011279661016949152,54.610169491525426
2617,5543,557,30,23,53,56.6,0.009832075471698114,58.39622641509434
2618,6355,815,42,41,83,50.6,0.008883132530120484,32.855421686746986
2630,2186,14164,14,8,22,63.64,0.04359090909090909,31.181818181818183
2633,1054,7346,5,2,7,71.43,0.04367142857142857,82.0
2634,2115,4285,7,5,12,58.33,0.01796666666666667,106.58333333333333
2636,5197,19453,24,15,39,61.54,0.024705128205128206,48.794871794871796
2637,4496,-1146,14,12,26,53.85,0.006265384615384615,67.42307692307692
2642,2714,5936,8,6,14,57.14,0.014414285714285715,67.07142857142857
2701,3528,8262,28,18,46,60.87,0.017489130434782608,65.56521739130434
2702,4709,2491,31,26,57,54.39,0.010164912280701759,49.473684210526315
2704,3999,23001,27,10,37,72.97,0.039924324324324335,87.70270270270271
2705,3835,10135,31,24,55,56.36,0.024507272727272725,48.30909090909091
2706,1911,5789,12,8,20,60.0,0.020465,164.05
2707,45432,304468,29,20,49,59.18,0.07978571428571428,69.08163265306122
2712,1770,9130,9,4,13,69.23,0.03300769230769231,92.92307692307692
2722,7641,-4441,23,20,43,53.49,0.0029046511627906983,42.16279069767442
2723,53647,-92547,30,34,64,46.88,-0.007890624999999998,23.46875
2727,38108,-31008,32,24,56,57.14,0.0025339285714285737,28.875
2731,13549,15101,18,12,30,60.0,0.011396666666666666,35.86666666666667
2739,2745,-4745,10,9,19,52.63,-0.004278947368421055,55.05263157894737
2748,3666,-18516,5,9,14,35.71,-0.018971428571428573,70.5
2801,4126,25874,30,14,44,68.18,0.03652045454545454,69.1590909090909
2809,7453,1457,56,49,105,53.33,0.007041904761904762,28.552380952380954
2812,5481,11819,54,34,88,61.36,0.022262500000000005,39.40909090909091
2816,7291,45469,52,48,100,52.0,0.08591800000000002,23.84
2820,3345,3175,30,21,51,58.82,0.008000000000000002,63.666666666666664
2832,4227,22373,28,12,40,70.0,0.037154999999999994,80.425
2834,3369,12441,33,19,52,63.46,0.03564807692307692,68.3076923076923
2836,1916,5384,18,10,28,64.29,0.022860714285714283,126.5
2838,3900,14360,38,23,61,62.3,0.03160000000000001,44.19672131147541
2841,6050,10570,63,50,113,55.75,0.015412389380530973,25.442477876106196
2845,3222,7598,29,20,49,59.18,0.022167346938775506,61.714285714285715
2849,8664,6386,69,59,128,53.91,0.014956250000000003,22.0703125
2850,9291,18959,59,39,98,60.2,0.019782653061224485,31.489795918367346
2851,3563,12187,30,16,46,65.22,0.02519565217391305,62.97826086956522
2852,4417,20113,37,22,59,62.71,0.032240677966101694,56.54237288135593
2855,3390,23800,31,11,42,73.81,0.0464904761904762,65.64285714285714
2867,1435,-3005,8,12,20,40.0,-0.014764999999999997,70.9
2880,1625,14975,12,3,15,80.0,0.06069333333333333,219.73333333333332
2881,10790,12060,38,27,65,58.46,0.011741538461538463,44.95384615384615
2882,9450,51750,28,13,41,68.29,0.03714390243902439,76.70731707317073
2883,3459,11011,34,17,51,66.67,0.027103921568627457,60.1764705882353
2884,5682,26498,40,23,63,63.49,0.02355873015873016,45.07936507936508
2885,4320,25180,36,17,53,67.92,0.039903773584905655,53.41509433962264
2886,6015,12345,34,24,58,58.62,0.012558620689655171,49.01724137931034
2887,4324,11456,36,24,60,60.0,0.01655166666666667,51.016666666666666
2888,2408,6622,23,13,36,63.89,0.029149999999999992,87.13888888888889
2889,2706,10584,29,13,42,69.05,0.03218095238095238,77.66666666666667
2890,3960,5900,34,23,57,59.65,0.013563157894736845,50.228070175438596
2891,5609,37251,40,15,55,72.73,0.04688909090909091,53.14545454545455
2892,2910,14090,19,8,27,70.37,0.03127777777777777,106.22222222222223
2897,629,2191,7,3,10,70.0,0.028180000000000004,78.1
2901,9177,12423,44,33,77,57.14,0.011555844155844154,37.81818181818182
2903,6608,26242,42,22,64,65.62,0.028584375,40.46875
2904,10261,16099,83,87,170,48.82,0.014781764705882352,16.841176470588234
2905,9343,24417,63,49,112,56.25,0.0148375,21.928571428571427
2906,2222,8698,20,12,32,62.5,0.029,85.0625
2908,5452,15998,31,17,48,64.58,0.019297916666666668,52.104166666666664
2910,13110,32290,57,37,94,60.64,0.018095744680851063,23.670212765957448
2911,4707,-21817,26,30,56,46.43,-0.017050000000000003,53.482142857142854
2912,29146,134454,37,22,59,62.71,0.022806779661016952,55.05084745762712
2913,8415,27865,74,50,124,59.68,0.019683870967741938,19.137096774193548
2915,18129,31271,64,49,113,56.64,0.012028318584070795,23.371681415929203
2923,2832,13518,15,7,22,68.18,0.031127272727272726,39.68181818181818
2929,10840,-62970,22,35,57,38.6,-0.02707368421052632,21.105263157894736
2936,3006,5144,15,9,24,62.5,0.014262500000000003,36.5
2939,7449,-34749,13,19,32,40.62,-0.021446875000000004,16.53125
3002,5224,9946,39,26,65,60.0,0.01986307692307692,48.01538461538462
3003,12723,22327,48,37,85,56.47,0.015445882352941176,31.729411764705883
3004,16406,17934,98,103,201,48.76,0.02648557213930348,13.761194029850746
3005,11398,22712,60,41,101,59.41,0.0153,24.554455445544555
3006,24685,102365,64,30,94,68.09,0.03828404255319149,25.22340425531915
3008,317590,152910,79,63,142,55.63,0.007570422535211265,18.3943661971831
3010,11426,29224,30,18,48,62.5,0.019127083333333336,62.3125
3011,7431,19499,68,40,108,62.96,0.026799074074074072,24.34259259259259
3013,7241,26199,46,33,79,58.23,0.02403037974683544,38.48101265822785
3014,12737,20063,50,35,85,58.82,0.015017647058823531,32.8235294117647
3015,10751,7149,37,28,65,56.92,0.00922,48.0
3016,13456,36024,70,49,119,58.82,0.020952941176470587,20.3781512605042
3017,15129,22511,69,53,122,56.56,0.012004918032786886,20.57377049180328
3018,10118,13192,74,76,150,49.33,0.0014433333333333331,16.593333333333334
3019,47039,-26889,68,56,124,54.84,0.007775806451612904,24.0
3021,8689,12971,69,74,143,48.25,0.04711468531468528,14.622377622377622
3022,14431,92169,52,20,72,72.22,0.03775972222222222,33.75
3023,11201,-20531,38,40,78,48.72,-0.005198717948717951,40.67948717948718
3024,5856,-586,47,43,90,52.22,0.007583333333333332,34.477777777777774
3025,7497,31943,64,30,94,68.09,0.03653617021276597,27.670212765957448
3026,19235,38365,44,29,73,60.27,0.021263013698630137,42.178082191780824
3027,8745,31425,62,38,100,62.0,0.026996,24.86
3028,4385,21425,27,16,43,62.79,0.02772558139534884,61.13953488372093
3029,9155,10805,71,49,120,59.17,0.014499999999999997,24.075
3030,17470,34680,56,36,92,60.87,0.01686195652173913,25.706521739130434
3031,11196,-1706,65,55,120,54.17,0.006654166666666666,26.808333333333334
3032,10737,-467,61,48,109,55.96,0.01101926605504587,26.26605504587156
3033,5265,21685,34,19,53,64.15,0.022909433962264147,53.64150943396226
3034,58456,54094,65,49,114,57.02,0.008457894736842105,23.649122807017545
3035,22332,60768,54,35,89,60.67,0.020488764044943823,26.50561797752809
3036,14075,22275,52,42,94,55.32,0.008710638297872341,31.46808510638298
3037,12177,12823,57,42,99,57.58,0.01089090909090909,26.707070707070706
3038,6579,18621,54,34,88,61.36,0.022092045454545454,29.579545454545453
3040,10526,-17806,53,54,107,49.53,0.0006037383177570103,26.523364485981308
3041,12297,-14317,52,49,101,51.49,-0.002306930693069306,25.663366336633665
3042,14712,18138,59,39,98,60.2,0.013409183673469388,27.510204081632654
3043,11839,-27109,97,127,224,43.3,-0.01544017857142857,13.03125
3044,23913,176037,58,21,79,73.42,0.04382911392405063,32.11392405063291
3045,10803,80897,28,11,39,71.79,0.04107948717948717,87.58974358974359
3046,14236,6044,85,81,166,51.2,0.006761445783132529,16.50602409638554
3047,4912,13148,46,24,70,65.71,0.025641428571428572,37.58571428571429
3048,8686,32334,57,28,85,67.06,0.02682470588235294,34.576470588235296
3049,6181,3079,51,43,94,54.26,0.009158510638297868,21.74468085106383
3050,7384,7766,62,44,106,58.49,0.013929245283018867,24.141509433962263
3051,10947,-13267,91,99,190,47.89,-0.003914736842105263,13.25263157894737
3052,7156,1614,64,51,115,55.65,0.0070060869565217385,22.31304347826087
3054,11865,-18525,60,66,126,47.62,-0.00244761904761905,20.1984126984127
3055,7346,34604,41,21,62,66.13,0.03167580645161291,37.11290322580645
3056,8783,-26973,46,67,113,40.71,-0.012608849557522122,22.61946902654867
3057,8840,28740,59,41,100,59.0,0.025390000000000003,25.29
3058,4766,-1206,39,29,68,57.35,0.0061147058823529405,36.86764705882353
3059,19381,-2131,62,50,112,55.36,0.0066124999999999995,24.848214285714285
3060,26049,8801,72,61,133,54.14,0.003767669172932329,23.05263157894737
3062,11251,22649,58,41,99,58.59,0.015437373737373737,24.08080808080808
3090,10402,46898,41,23,64,64.06,0.022826562500000005,32.171875
3094,9785,665,42,31,73,57.53,0.011606849315068495,25.17808219178082
3130,31608,53192,29,24,53,54.72,0.012454716981132076,48.471698113207545
3138,2681,-1931,23,20,43,53.49,-0.002613953488372095,40.18604651162791
3149,10394,18616,49,39,88,55.68,0.019010227272727272,17.579545454545453
3164,7890,13610,31,24,55,56.36,0.019219999999999998,36.8
3167,5523,23777,17,11,28,60.71,0.029125,43.607142857142854
3189,32027,104623,60,32,92,65.22,0.02411195652173913,22.543478260869566
3209,6805,22395,37,21,58,63.79,0.02491551724137931,43.05172413793103
3229,7504,5216,49,53,102,48.04,0.014056862745098039,24.69607843137255
3231,10497,-7497,41,40,81,50.62,0.0026654320987654304,33.50617283950617
3257,12608,45042,34,22,56,60.71,0.022275,22.357142857142858
3266,5074,16356,33,25,58,56.9,0.023270689655172417,48.672413793103445
3296,9709,-1059,52,46,98,53.06,0.004558163265306121,25.540816326530614
3305,11142,7958,34,27,61,55.74,0.009426229508196719,43.885245901639344
3308,5366,6954,41,37,78,52.56,0.022289743589743588,26.115384615384617
3311,12135,-12735,43,43,86,50.0,0.003447674418604652,35.5
3312,4974,-2664,42,32,74,56.76,0.001981081081081082,29.39189189189189
3321,2137,8493,17,12,29,58.62,0.03182758620689655,18.413793103448278
3338,6431,15869,23,18,41,56.1,0.016895121951219512,24.5609756097561
3346,10320,10230,22,25,47,46.81,0.008934042553191489,17.80851063829787
3356,22201,-10201,44,45,89,49.44,-0.003026966292134831,30.584269662921347
3376,37452,-31552,40,34,74,54.05,0.0006067567567567557,30.43243243243243
3380,8632,37668,50,26,76,65.79,0.027189473684210524,25.526315789473685
3383,7153,-8803,56,79,135,41.48,0.007040000000000005,16.11111111111111
3406,73968,782,83,72,155,53.55,0.009044516129032258,14.141935483870968
3413,21898,104902,21,13,34,61.76,0.0277764705882353,19.705882352941178
3416,9972,30028,19,12,31,61.29,0.023512903225806445,70.16129032258064
3419,8941,18929,59,38,97,60.82,0.019828865979381445,20.75257731958763
3432,2945,5965,22,16,38,57.89,0.01866052631578947,25.57894736842105
3437,5837,-12937,24,26,50,48.0,-0.007508000000000002,21.44
3443,79795,-15995,49,38,87,56.32,0.009108045977011496,22.195402298850574
3450,31116,-1856,75,59,134,55.97,0.005306716417910446,17.619402985074625
3454,36838,-5238,59,47,106,55.66,0.008194339622641506,18.160377358490567
3481,6063,-1253,38,32,70,54.29,2.4285714285716568e-05,32.27142857142857
3494,5153,-163,41,41,82,50.0,0.004531707317073171,26.036585365853657
3501,11670,7880,31,20,51,60.78,0.00887450980392157,36.13725490196079
3504,38877,31623,61,52,113,53.98,0.005797345132743362,16.92920353982301
3515,38445,19705,50,41,91,54.95,0.010168131868131869,21.857142857142858
3518,14474,-35924,42,50,92,45.65,-0.007792391304347826,22.141304347826086
3528,3359,14391,12,7,19,63.16,0.027589473684210525,81.52631578947368
3530,7691,-23601,37,36,73,50.68,-0.0014452054794520503,28.383561643835616
3532,29454,-128404,35,47,82,42.68,-0.015695121951219512,23.536585365853657
3533,44309,63941,49,37,86,56.98,0.014341860465116277,23.546511627906977
3535,8184,30266,46,36,82,56.1,0.029052439024390236,21.426829268292682
3536,6136,20814,62,44,106,58.49,0.03876037735849057,17.235849056603772
3543,4567,2243,33,22,55,60.0,0.017514545454545456,31.345454545454544
3545,23739,-59089,50,53,103,48.54,-0.004937864077669905,17.184466019417474
3550,3139,10541,23,13,36,63.89,0.027963888888888892,43.888888888888886
3557,9852,18988,54,47,101,53.47,0.010193069306930693,15.009900990099009
3563,15314,-39464,25,25,50,50.0,-0.007510000000000002,35.36
3576,7034,-9464,39,43,82,47.56,-0.0006536585365853681,26.365853658536587
3583,8500,86650,20,7,27,74.07,0.06456296296296296,30.40740740740741
3588,34303,16897,55,36,91,60.44,0.013007692307692307,21.494505494505493
3591,6855,3735,37,29,66,56.06,0.008519696969696972,26.924242424242426
3593,4933,5697,31,37,68,45.59,0.01555441176470588,27.38235294117647
3596,15305,-24705,29,27,56,51.79,-0.0057125000000000006,30.035714285714285
3605,13257,19793,42,28,70,60.0,0.017525714285714287,27.17142857142857
3607,7851,-38931,31,36,67,46.27,-0.01202238805970149,31.417910447761194
3617,17737,41163,26,21,47,55.32,0.01564042553191489,38.680851063829785
3622,9432,7058,42,29,71,59.15,0.01264225352112676,30.450704225352112
3645,9540,17060,31,19,50,62.0,0.015592,23.08
3653,45624,-102724,38,35,73,52.05,-0.0011863013698630112,19.52054794520548
3661,17007,25493,33,24,57,57.89,0.01465438596491228,15.473684210526315
3665,48514,175486,50,28,78,64.1,0.031885897435897426,18.346153846153847
3669,4336,6064,22,15,37,59.46,0.01960810810810811,36.513513513513516
3673,18604,-74704,26,30,56,46.43,-0.01250178571428571,30.839285714285715
3679,9688,-17288,16,16,32,50.0,-0.004196875000000001,40.65625
3682,2190,-480,18,17,35,51.43,0.008125714285714283,42.25714285714286
3686,5024,1566,36,39,75,48.0,0.020962666666666664,20.813333333333333
3694,4329,6371,24,18,42,57.14,0.016071428571428566,26.761904761904763
3701,7062,4878,68,62,130,52.31,0.013149230769230772,18.392307692307693
3702,11004,74526,48,21,69,69.57,0.044018840579710145,33.30434782608695
3703,1724,3946,14,9,23,60.87,0.01998695652173913,79.82608695652173
3704,3288,32,23,14,37,62.16,0.00795135135135135,34.54054054054054
3705,2017,18783,6,2,8,75.0,0.061375,230.875
3706,3491,4459,14,9,23,60.87,0.013008695652173915,47.26086956521739
3708,8659,30641,12,7,19,63.16,0.026615789473684214,26.68421052631579
3711,4924,-10924,7,6,13,53.85,-0.005861538461538458,30.692307692307693
3712,1347,-5097,6,7,13,46.15,-0.01535384615384615,31.153846153846153
3714,1083,-15483,0,3,3,0.0,-0.07696666666666667,30.666666666666668
4104,15033,29017,38,25,63,60.32,0.016733333333333333,46.23809523809524
4106,13473,35577,52,37,89,58.43,0.02107078651685393,30.97752808988764
4108,10705,17845,41,30,71,57.75,0.01596338028169014,32.45070422535211
4119,23307,84743,51,33,84,60.71,0.02424285714285715,27.607142857142858
4133,14065,-49865,22,30,52,42.31,-0.007584615384615383,33.30769230769231
4137,45178,-91778,23,24,47,48.94,-0.007772340425531916,22.76595744680851
4142,7880,670,24,20,44,54.55,0.010004545454545455,29.568181818181817
4155,7288,-3338,25,19,44,56.82,0.0027068181818181826,32.38636363636363
4164,5424,-1574,13,11,24,54.17,0.0037916666666666654,65.08333333333333
4190,6925,28975,10,6,16,62.5,0.027375,43.125
4306,4498,10392,29,20,49,59.18,0.01884081632653061,66.18367346938776
4414,6854,1786,58,60,118,49.15,0.003399152542372882,24.805084745762713
4426,10977,29463,56,46,102,54.9,0.014680392156862745,21.186274509803923
4438,12260,54740,11,6,17,64.71,0.030776470588235294,43.23529411764706
4439,6894,16606,6,3,9,66.67,0.018200000000000004,29.0
4526,6081,14869,31,22,53,58.49,0.01730943396226415,60.660377358490564
4532,9060,6370,56,51,107,52.34,0.007754205607476633,25.72897196261682
4536,16111,55089,16,8,24,66.67,0.026129166666666665,48.75
4540,4299,85631,10,11,21,47.62,0.14624761904761904,56.333333333333336
4545,4810,20990,17,12,29,58.62,0.031520689655172414,35.793103448275865
4551,22871,110329,22,11,33,66.67,0.030318181818181817,18.727272727272727
4552,4353,-10253,11,11,22,50.0,-0.0034363636363636337,44.72727272727273
4555,5596,8904,11,7,18,61.11,0.014299999999999998,53.55555555555556
4557,2327,9573,4,2,6,66.67,0.029166666666666664,173.16666666666666
4560,2314,2636,4,5,9,44.44,0.008877777777777778,94.33333333333333
4562,3371,-16221,8,18,26,30.77,-0.01835769230769231,41.11538461538461
4564,3879,13671,11,6,17,64.71,0.025664705882352944,12.411764705882353
4566,3672,11178,10,5,15,66.67,0.02306,37.666666666666664
4571,4648,19052,7,6,13,53.85,0.029392307692307693,23.076923076923077
4572,5956,45444,7,4,11,63.64,0.04648181818181819,31.90909090909091
4576,4305,48395,6,4,10,60.0,0.09197999999999999,27.9
4581,596,-546,1,2,3,33.33,-0.0042,112.0
4720,5762,20668,42,29,71,59.15,0.026326760563380274,48.80281690140845
4722,6854,9036,43,35,78,55.13,0.009405128205128205,38.11538461538461
4737,9939,30411,17,12,29,58.62,0.025820689655172407,45.62068965517241
4739,12211,-2411,29,23,52,55.77,0.008161538461538458,30.673076923076923
4746,13587,33213,25,19,44,56.82,0.019799999999999995,34.38636363636363
4755,3461,25639,13,5,18,72.22,0.0404,69.22222222222223
4763,13818,61682,12,8,20,60.0,0.036175,35.8
4764,3582,-6882,5,5,10,50.0,-0.004280000000000001,80.0
4766,6713,-3713,5,4,9,55.56,0.003444444444444446,50.44444444444444
4807,3292,-4642,12,9,21,57.14,-0.0015047619047619015,44.0
4904,9355,26795,27,16,43,62.79,0.01945116279069768,77.65116279069767
4906,12819,1431,53,38,91,58.24,0.00546043956043956,34.89010989010989
4912,20440,63010,34,21,55,61.82,0.026470909090909094,27.70909090909091
4915,7414,39486,22,11,33,66.67,0.03448787878787878,37.21212121212121
4916,6342,26058,26,16,42,61.9,0.03140714285714286,22.571428571428573
4919,8904,-12004,28,24,52,53.85,0.0014480769230769213,31.692307692307693
4927,6304,2046,18,15,33,54.55,0.009342424242424242,36.39393939393939
4930,4690,8050,26,17,43,60.47,0.022455813953488373,35.7906976744186
4934,4848,-2968,31,38,69,44.93,0.002902898550724638,20.318840579710145
4935,7458,-17508,17,14,31,54.84,-0.0035193548387096795,48.0
4938,11013,71087,27,14,41,65.85,0.03218048780487805,36.951219512195124
4942,6012,30188,24,10,34,70.59,0.03247058823529411,32.205882352941174
4943,19806,-109706,17,31,48,35.42,-0.024575,15.229166666666666
4952,5929,16321,21,12,33,63.64,0.019475757575757577,39.696969696969695
4956,6217,423,33,32,65,50.77,0.005884615384615385,20.215384615384615
4958,12020,52580,18,9,27,66.67,0.03334444444444445,45.888888888888886
4960,5129,-10739,35,38,73,47.95,-0.006886301369863014,21.89041095890411
4961,10474,-13114,30,26,56,53.57,0.0012107142857142872,20.089285714285715
4967,2941,-22121,13,23,36,36.11,-0.02715833333333333,36.27777777777778
4968,17838,8212,24,17,41,58.54,0.015797560975609755,15.609756097560975
4976,6463,9287,28,19,47,59.57,0.01779148936170213,24.72340425531915
4977,16092,-28392,20,21,41,48.78,-0.003831707317073174,29.121951219512194
4989,1972,-18232,7,21,28,25.0,-0.04171071428571429,37.214285714285715
4994,22184,13266,34,25,59,57.63,0.009416949152542374,26.372881355932204
4999,6350,38050,16,9,25,64.0,0.0431,56.76
5007,8946,29754,40,23,63,63.49,0.022517460317460315,49.0
5203,20815,74285,28,17,45,62.22,0.022706666666666667,58.08888888888889
5215,6153,-6353,16,15,31,51.61,0.0029645161290322575,47.29032258064516
5225,7280,-11480,26,22,48,54.17,0.0014812500000000034,27.645833333333332
5234,9721,-11321,18,18,36,50.0,-0.0028555555555555595,41.666666666666664
5243,4050,2250,12,8,20,60.0,0.013345000000000001,48.25
5258,4345,30155,20,10,30,66.67,0.04022,22.066666666666666
5269,85833,116117,49,42,91,53.85,0.01485384615384615,12.901098901098901
5283,2650,5340,7,6,13,53.85,0.019276923076923077,82.61538461538461
5284,5453,-13503,12,10,22,54.55,-0.007277272727272724,61.0
5285,4842,23708,13,7,20,65.0,0.025865,57.65
5288,11420,76080,17,7,24,70.83,0.03984583333333333,36.083333333333336
5388,21481,14639,77,56,133,57.89,0.007206015037593982,21.872180451127818
5434,26639,-28489,49,40,89,55.06,0.003382022471910115,31.0561797752809
5469,10753,65687,64,32,96,66.67,0.035124999999999997,26.302083333333332
5471,14853,13797,33,24,57,57.89,0.012396491228070176,49.12280701754386
5484,6983,-8523,50,54,104,48.08,-0.002451923076923077,31.25
5515,2543,2087,21,13,34,61.76,0.008829411764705883,96.8529411764706
5519,6101,37049,40,19,59,67.8,0.033999999999999996,42.76271186440678
5521,6984,2196,62,45,107,57.94,0.00975046728971963,20.757009345794394
5522,10277,10273,36,29,65,55.38,0.016015384615384622,46.52307692307692
5525,4624,34346,35,14,49,71.43,0.044702040816326526,48.734693877551024
5531,5832,-4682,33,35,68,48.53,0.0025441176470588226,45.63235294117647
5533,6248,16102,51,31,82,62.2,0.02249634146341464,44.03658536585366
5534,28470,141980,76,38,114,66.67,0.03142982456140351,20.05263157894737
5538,2072,18928,9,3,12,75.0,0.057716666666666666,94.41666666666667
5546,2169,-34169,0,6,6,0.0,-0.08520000000000001,55.166666666666664
5607,5432,22418,31,19,50,62.0,0.027985999999999997,53.3
5608,4230,-8870,27,31,58,46.55,0.000684482758620687,54.758620689655174
5706,8859,30641,34,23,57,59.65,0.027487719298245613,57.56140350877193
5871,10291,6709,16,11,27,59.26,0.011681481481481475,60.148148148148145
5876,1828,11732,6,3,9,66.67,0.03587777777777777,163.55555555555554
5880,804,-4004,4,5,9,44.44,-0.022466666666666673,204.33333333333334
5906,4005,-15765,26,39,65,40.0,0.017726153846153846,21.384615384615383
5907,4353,-6503,15,17,32,46.88,4.374999999999865e-05,38.9375
6005,3044,11776,29,15,44,65.91,0.03454772727272728,67.27272727272727
6024,2462,-7812,7,8,15,46.67,-0.011266666666666671,147.0
6108,8432,38698,52,28,80,65.0,0.03484,31.95
6112,12973,4287,71,57,128,55.47,0.007288281249999999,23.734375
6115,11670,7130,36,25,61,59.02,0.008537704918032784,56.57377049180328
6116,5157,983,48,36,84,57.14,0.011471428571428572,26.952380952380953
6117,5246,26154,37,21,58,63.79,0.038191379310344824,43.327586206896555
6120,11169,19691,69,49,118,58.47,0.014090677966101696,23.47457627118644
6128,12115,29235,49,31,80,61.25,0.017791249999999998,41.4125
6133,3939,6401,33,24,57,57.89,0.019654385964912282,53.10526315789474
6136,5722,19028,30,20,50,60.0,0.024252,66.6
6139,10328,19722,36,24,60,60.0,0.017565000000000004,52.15
6141,11658,-1998,56,48,104,53.85,0.00637980769230769,31.778846153846153
6142,6068,5312,52,41,93,55.91,0.0111,36.61290322580645
6152,8344,-15264,57,57,114,50.0,-0.0047666666666666664,27.19298245614035
6153,17055,28685,77,45,122,63.11,0.019205737704918034,21.34426229508197
6155,11999,41351,52,36,88,59.09,0.02543068181818182,32.98863636363637
6164,5977,8623,45,30,75,60.0,0.019080000000000003,37.82666666666667
6165,8172,30448,63,39,102,61.76,0.03660686274509804,23.274509803921568
6166,18311,55389,57,32,89,64.04,0.020448314606741572,32.97752808988764
6168,11969,13041,70,51,121,57.85,0.010514876033057853,24.876033057851238
6172,10384,35006,87,60,147,59.18,0.02798231292517007,14.83673469387755
6176,43809,170691,79,46,125,63.2,0.023873600000000002,19.648
6177,11667,44903,67,50,117,57.26,0.021783760683760686,22.00854700854701
6183,6614,1786,41,35,76,53.95,0.007256578947368421,41.44736842105263
6184,6798,28502,20,11,31,64.52,0.024864516129032253,94.16129032258064
6189,6539,14621,27,20,47,57.45,0.015521276595744682,71.87234042553192
6191,8504,26146,56,33,89,62.92,0.018061797752808986,33.82022471910113
6192,16414,46286,37,27,64,57.81,0.0183890625,40.109375
6196,15889,-34159,51,47,98,52.04,-0.0031428571428571447,28.581632653061224
6197,15599,14301,45,37,82,54.88,0.01437926829268293,35.646341463414636
6201,6327,7323,20,17,37,54.05,0.010008108108108111,90.08108108108108
6202,18678,55072,52,30,82,63.41,0.020203658536585366,33.548780487804876
6205,7173,20577,28,18,46,60.87,0.0247695652173913,48.43478260869565
6206,27770,8180,43,31,74,58.11,0.00926216216216216,34.45945945945946
6209,17674,-8284,61,48,109,55.96,0.008593577981651378,21.504587155963304
6213,12830,11920,57,41,98,58.16,0.010123469387755104,25.632653061224488
6214,19495,12355,50,38,88,56.82,0.010940909090909093,33.35227272727273
6215,10970,35110,65,37,102,63.73,0.02602843137254902,24.794117647058822
6216,10147,15053,45,33,78,57.69,0.014216666666666664,44.87179487179487
6224,23035,64115,61,41,102,59.8,0.017658823529411765,25.362745098039216
6225,10508,-7728,88,105,194,45.36,0.005281443298969071,14.041237113402062
6226,6439,8881,53,44,97,54.64,0.014074226804123713,29.77319587628866
6230,31438,-36588,70,69,139,50.36,-0.0005266187050359691,20.611510791366907
6235,11183,24937,73,50,123,59.35,0.01890081300813008,19.934959349593495
6239,25533,48167,44,29,73,60.27,0.014683561643835615,33.56164383561644
6243,13024,40866,68,56,124,54.84,0.025080645161290323,21.60483870967742
6251,3798,17422,27,14,41,65.85,0.0336780487804878,34.75609756097561
6257,12684,-6354,59,49,108,54.63,0.0037287037037037007,24.12037037037037
6269,28383,50667,82,67,149,55.03,0.01045771812080537,17.120805369127517
6271,44443,-5293,54,45,99,54.55,0.002727272727272727,17.01010101010101
6277,21525,13425,33,26,59,55.93,0.00800677966101695,46.08474576271186
6278,16480,51520,44,28,72,61.11,0.021693055555555552,35.43055555555556
6281,10108,41042,26,13,39,66.67,0.02602051282051282,71.87179487179488
6282,10437,26593,59,41,100,59.0,0.017245,22.01
6283,13395,5745,62,61,123,50.41,0.007656910569105691,19.24390243902439
6285,28703,89497,62,37,99,62.63,0.025133333333333334,19.666666666666668
6288,3403,517,23,32,55,41.82,0.02416727272727272,65.47272727272727
6289,8784,-6994,76,112,188,40.43,-0.009360106382978722,14.457446808510639
6405,5639,5021,23,19,42,54.76,0.009304761904761902,23.857142857142858
6409,61526,318974,20,7,27,74.07,0.038511111111111114,39.148148148148145
6412,4758,3192,11,9,20,55.0,0.010770000000000002,56.55
6414,57118,52882,25,16,41,60.98,0.013782926829268294,19.536585365853657
6415,79946,426054,27,12,39,69.23,0.0355025641025641,23.487179487179485
6416,13620,75060,19,12,31,61.29,0.038693548387096786,27.161290322580644
6431,3480,-5910,21,22,43,48.84,-9.999999999999996e-05,20.27906976744186
6438,7095,-10545,11,9,20,55.0,-0.0008499999999999994,22.6
6442,4754,5296,11,12,23,47.83,0.01227391304347826,48.91304347826087
6443,1513,57,10,13,23,43.48,0.027891304347826086,31.217391304347824
6449,5901,1299,21,13,34,61.76,0.01128529411764706,24.205882352941178
6451,17252,89848,22,12,34,64.71,0.03279705882352941,16.764705882352942
6456,15330,36870,16,12,28,57.14,0.016675000000000002,36.142857142857146
6464,4403,-13203,3,4,7,42.86,-0.017942857142857142,136.71428571428572
6477,2495,8755,14,7,21,66.67,0.023961904761904757,27.142857142857142
6491,6925,37615,6,7,13,46.15,0.03856153846153847,114.84615384615384
6504,18986,52514,13,10,23,56.52,0.0213,46.43478260869565
6505,16353,27147,22,15,37,59.46,0.016881081081081075,79.1891891891892
6515,11498,61002,4,1,5,80.0,0.03218,8.2
6525,6239,-5389,9,9,18,50.0,0.001194444444444444,38.94444444444444
6531,8208,22442,11,7,18,61.11,0.030455555555555555,30.166666666666668
6533,20271,-45271,15,15,30,50.0,-0.003443333333333332,14.433333333333334
6541,16989,-9989,27,28,55,49.09,0.00875818181818182,16.163636363636364
6552,6948,-10298,12,11,23,52.17,0.008056521739130436,22.0
6558,4322,5528,15,9,24,62.5,0.02135833333333333,46.041666666666664
6573,6172,1528,26,26,52,50.0,0.006511538461538461,13.557692307692308
6579,4497,3903,6,5,11,54.55,0.013190909090909097,91.27272727272727
6581,4952,4898,8,5,13,61.54,0.014200000000000003,49.53846153846154
6582,6951,-23551,8,9,17,47.06,-0.014823529411764706,46.11764705882353
6591,6309,15441,13,9,22,59.09,0.02300909090909091,27.227272727272727
6592,986,9914,2,0,2,100.0,0.061799999999999994,132.5
6598,5305,17795,11,11,22,50.0,0.018236363636363637,13.045454545454545
6605,21152,-24202,30,30,60,50.0,-0.00026666666666666554,51.45
6625,3269,381,9,8,17,52.94,0.005494117647058823,43.588235294117645
6641,2095,1805,4,2,6,66.67,0.006349999999999999,50.166666666666664
6655,1902,-19052,2,6,8,25.0,-0.0505125,52.5
6666,5812,-26912,5,8,13,38.46,-0.022807692307692307,35.76923076923077
6668,3904,7996,6,7,13,46.15,0.008676923076923075,23.076923076923077
6669,35757,200243,8,2,10,80.0,0.04019,23.2
6670,6974,42026,5,2,7,71.43,0.03682857142857143,38.857142857142854
6671,1352,3548,3,3,6,50.0,0.021816666666666675,107.0
6672,2453,16947,4,1,5,80.0,0.051660000000000005,37.2
6674,2370,-670,8,8,16,50.0,0.008106249999999999,28.875
6698,1603,-10403,2,5,7,28.57,-0.029357142857142856,24.285714285714285
6706,7115,-5115,4,4,8,50.0,-0.00145,6.5
6715,4150,27850,4,2,6,66.67,0.044266666666666656,14.0
6743,4770,-11820,7,6,13,53.85,-0.01273076923076923,17.0
6754,773,7577,2,1,3,66.67,0.0638,45.0
6756,6149,111851,3,0,3,100.0,0.12760000000000002,6.666666666666667
8011,8269,-13989,36,48,84,42.86,0.06569285714285715,48.595238095238095
8016,42583,-59233,58,52,110,52.73,-6.18181818181846e-05,20.318181818181817
8021,9315,16885,43,30,73,58.9,0.013569863013698627,33.52054794520548
8028,5057,26143,35,36,71,49.3,0.1730211267605634,52.605633802816904
8033,6975,8465,51,40,91,56.04,0.010958241758241756,28.252747252747252
8039,19505,3395,56,42,98,57.14,0.008462244897959187,25.96938775510204
8046,34188,30112,51,37,88,57.95,0.015550000000000003,25.75
8070,34626,62124,45,35,80,56.25,0.013823750000000001,32.6125
8072,8179,-49129,18,25,43,41.86,-0.01768372093023256,81.06976744186046
8081,43336,94914,49,34,83,59.04,0.018366265060240965,29.06024096385542
8101,6258,-16358,45,66,111,40.54,-0.0213936936936937,23.756756756756758
8103,12503,-3903,42,35,77,54.55,0.006340259740259739,31.5974025974026
8104,3880,107670,16,34,50,32.0,0.7686700000000001,90.68
8105,7291,16929,54,41,95,56.84,0.02020736842105263,20.36842105263158
8110,4683,26127,46,19,65,70.77,0.03848615384615384,21.984615384615385
8112,11460,-17790,62,59,121,51.24,-0.002838016528925621,19.388429752066116
8114,24832,20218,36,32,68,52.94,0.011241176470588232,38.4264705882353
8131,8696,6554,33,25,58,56.9,0.009251724137931034,35.689655172413794
8150,2717,33233,13,3,16,81.25,0.07075000000000001,30.5
8163,12692,23358,46,35,81,56.79,0.013453086419753079,22.77777777777778
8201,5526,2724,40,32,72,55.56,0.00927916666666667,31.569444444444443
8210,12873,25827,52,38,90,57.78,0.016239999999999997,24.122222222222224
8213,5299,7851,15,12,27,55.56,0.011670370370370367,69.14814814814815
8215,6491,3209,37,31,68,54.41,0.00883676470588235,20.985294117647058
8222,2281,4669,15,11,26,57.69,0.016676923076923082,43.07692307692308
8249,7692,14188,44,30,74,59.46,0.016614864864864864,33.45945945945946
8261,12643,4747,55,47,102,53.92,0.003950980392156862,19.029411764705884
8271,5634,9216,27,18,45,60.0,0.015875555555555552,32.37777777777778
8341,26730,100070,19,11,30,63.33,0.022693333333333336,30.3
8367,787,3963,4,2,6,66.67,0.0325,59.333333333333336
8374,10400,3860,49,37,86,56.98,0.005530232558139534,29.953488372093023
8404,7697,6203,31,26,57,54.39,0.0086,27.719298245614034
8411,4126,424,24,19,43,55.81,0.0027744186046511636,35.93023255813954
8422,14895,84105,12,4,16,75.0,0.03570625,111.4375
8429,4654,-25904,22,30,52,42.31,-0.021326923076923077,29.98076923076923
8442,3732,2468,6,8,14,42.86,0.009650000000000002,61.714285714285715
8443,1303,-2033,10,8,18,55.56,-0.004438888888888889,71.83333333333333
8454,17782,-51282,7,7,14,50.0,-0.008142857142857141,75.92857142857143
8462,14415,40285,13,7,20,65.0,0.0254,33.6
8463,2541,10659,11,9,20,55.0,0.029874999999999995,44.05
8464,39532,285468,18,6,24,75.0,0.048854166666666664,20.833333333333332
8466,3848,1402,6,6,12,50.0,-0.002025000000000001,76.25
8467,3310,7890,9,7,16,56.25,0.017931249999999996,65.4375
8473,3583,-16433,6,9,15,40.0,-0.020506666666666666,62.86666666666667
8478,25012,148238,33,18,51,64.71,0.03944901960784313,16.41176470588235
8480,6298,-9198,5,5,10,50.0,-0.013989999999999994,76.9
8481,2814,18036,8,2,10,80.0,0.04209,54.2
8482,3972,-9772,3,5,8,37.5,-0.0105375,73.375
8488,1988,10712,15,6,21,71.43,0.03815238095238095,32.57142857142857
8499,10303,36197,11,8,19,57.89,0.02691052631578947,25.31578947368421
8926,5398,12802,34,23,57,59.65,0.01913859649122807,52.49122807017544
8940,4763,-7633,26,28,54,48.15,-0.0016666666666666666,61.333333333333336
8996,12795,54005,40,24,64,62.5,0.0261328125,28.828125
9802,9714,60536,25,10,35,71.43,0.03601142857142857,32.82857142857143
9902,7846,12954,69,57,126,54.76,0.01683809523809524,19.07936507936508
9904,10382,-1632,40,30,70,57.14,0.00257857142857143,42.4
9905,8799,27551,45,30,75,60.0,0.018552,38.693333333333335
9906,13134,646,123,153,276,44.57,-0.0003818840579710191,9.405797101449275
9907,5618,14862,50,27,77,64.94,0.0211948051948052,33.311688311688314
9908,4270,7580,28,19,47,59.57,0.016251063829787235,69.42553191489361
9910,6055,-11605,19,21,40,47.5,-0.004025000000000003,81.6
9911,9477,-977,71,57,128,55.47,0.0022437500000000023,22.2421875
9912,7197,5763,61,56,117,52.14,0.010908547008547006,23.188034188034187
9914,23365,59635,61,37,98,62.24,0.018374489795918367,31.96938775510204
9917,13854,21046,29,22,51,56.86,0.014296078431372549,66.17647058823529
9918,3930,9670,19,11,30,63.33,0.022823333333333327,105.13333333333334
9919,3442,20198,29,12,41,70.73,0.04047317073170732,74.1219512195122
9921,28949,70601,40,27,67,59.7,0.016523880597014925,48.38805970149254
9924,8383,-15203,30,35,65,46.15,-0.00804923076923077,48.58461538461538
9925,5276,10574,25,17,42,59.52,0.01947857142857143,78.19047619047619
9926,4391,35209,27,7,34,79.41,0.05015294117647059,97.11764705882354
9927,9980,76020,48,19,67,71.64,0.04420298507462686,41.35820895522388
9928,6602,16398,49,52,101,48.51,0.024702970297029704,30.584158415841586
9929,7160,-10770,60,71,131,45.8,-0.010723664122137403,21.96946564885496
9930,8839,27211,32,16,48,66.67,0.030943750000000003,68.85416666666667
9931,3268,17132,25,12,37,67.57,0.04212162162162161,81.35135135135135
9933,13505,41295,61,36,97,62.89,0.019260824742268038,32.55670103092783
9934,7046,-3046,38,31,69,55.07,0.003860869565217391,45.27536231884058
9935,5155,-9055,33,42,75,44.0,-0.0008893333333333376,31.573333333333334
9937,7636,13964,30,19,49,61.22,0.016528571428571427,63.673469387755105
9938,13947,-8837,53,44,97,54.64,0.003983505154639177,30.938144329896907
9939,18016,51734,55,35,90,61.11,0.015762222222222223,30.555555555555557
9940,7914,16136,25,15,40,62.5,0.0193075,72.575
9941,9258,18042,28,20,48,58.33,0.015245833333333328,64.58333333333333
9942,11829,22471,31,22,53,58.49,0.014516981132075474,59.264150943396224
9943,12718,51132,54,34,88,61.36,0.02350681818181818,33.94318181818182
9944,7917,32183,42,26,68,61.76,0.029914705882352937,43.75
9945,21133,30707,100,63,163,61.35,0.012573619631901836,16.975460122699385
9946,5340,15700,37,31,68,54.41,0.017430882352941178,31.514705882352942
9955,9102,-10552,44,42,86,51.16,-0.0002209302325581388,35.95348837209303
9958,3985,-8735,27,31,58,46.55,-0.011820689655172412,37.63793103448276
1312A,5038,14492,36,22,58,62.07,0.018718965517241386,50.224137931034484
2002A,4617,31483,18,5,23,78.26,0.042447826086956526,187.6086956521739
2836A,138,1012,1,0,1,100.0,0.0444,354.0
2838A,310,1090,1,0,1,100.0,0.0209,1348.0
2881A,370,-570,0,1,1,0.0,-0.009,1393.0
2881B,361,739,1,0,1,100.0,0.0122,1370.0
2882A,365,-265,0,1,1,0.0,-0.0043,1075.0
2882B,364,336,1,0,1,100.0,0.0054,1078.0
2887E,311,1389,1,0,1,100.0,0.0268,1440.0
2887F,298,902,1,0,1,100.0,0.018,816.0
2888A,248,-1348,0,1,1,0.0,-0.0312,427.0
2888B,244,1406,1,0,1,100.0,0.0347,319.0
2891B,368,-268,0,1,1,0.0,-0.0043,1299.0
2891C,356,1544,1,0,1,100.0,0.0259,816.0
2897A,209,21,1,2,3,33.33,0.003166666666666665,261.0
3702A,288,2662,1,0,1,100.0,0.0566,797.0
5871A,0,0,0,0,0,0.0,,
9941A,610,2990,1,1,2,50.0,0.03215,387.0
1240,3237,10063,7,5,12,58.33,0.024341666666666668,29.5
1258,5790,-1260,28,22,50,56.0,0.011358,33.66
1259,3226,33274,6,2,8,75.0,0.0642375,208.625
1264,10644,85356,7,2,9,77.78,0.053255555555555556,117.11111111111111
1268,5787,16213,4,4,8,50.0,0.0194,125.5
1336,4771,-3811,32,26,58,55.17,-0.001313793103448275,34.0
1565,90120,270980,53,30,83,63.86,0.03053855421686747,33.036144578313255
1569,11721,44059,60,32,92,65.22,0.022980434782608705,25.304347826086957
1570,7993,10087,59,45,104,56.73,0.00939326923076923,25.03846153846154
1580,26896,44604,32,22,54,59.26,0.02042592592592593,34.851851851851855
1584,4755,14655,34,24,58,58.62,0.02619310344827586,32.39655172413793
1586,6156,17694,25,16,41,60.98,0.01981707317073171,33.829268292682926
1591,6684,-13984,25,27,52,48.08,-0.0032807692307692334,26.096153846153847
1593,4314,52336,19,2,21,90.48,0.07200476190476192,57.57142857142857
1595,10078,-38728,20,23,43,46.51,-0.01147441860465116,39.16279069767442
1599,6571,39179,18,10,28,64.29,0.03760714285714285,49.5
1742,9901,2789,46,51,97,47.42,0.010058762886597943,25.36082474226804
1752,10410,51340,35,20,55,63.64,0.032639999999999995,32.054545454545455
1777,17283,18067,38,32,70,54.29,0.01187285714285714,37.91428571428571
1781,10576,34144,62,44,106,58.49,0.023597169811320748,18.59433962264151
1784,15268,10732,44,31,75,58.67,0.009602666666666664,30.69333333333333
1785,12864,706,45,41,86,52.33,0.0025779069767441895,32.63953488372093
1788,16566,78334,22,12,34,64.71,0.03044411764705882,46.1764705882353
1796,4698,-5398,12,13,25,48.0,0.002212000000000004,33.16
1799,8976,29744,51,38,89,57.3,0.024664044943820226,19.348314606741575
1813,2897,-5397,10,12,22,45.45,-0.005827272727272729,94.77272727272727
1815,8042,10008,56,46,102,54.9,0.010275490196078435,23.04901960784314
2035,12475,16025,41,32,73,56.16,0.011072602739726026,29.82191780821918
2061,3438,13172,28,15,43,65.12,0.02934418604651163,36.72093023255814
2063,5409,14691,18,14,32,56.25,0.021003125,56.15625
2064,1367,-1167,9,7,16,56.25,-0.0002187500000000002,65.4375
2065,2207,12543,7,4,11,63.64,0.03686363636363637,70.36363636363636
2066,10269,-24819,14,13,27,51.85,-0.005959259259259258,56.925925925925924
2067,2655,4525,19,16,35,54.29,0.021042857142857137,36.94285714285714
2070,3510,24640,11,8,19,57.89,0.049252631578947374,36.89473684210526
2221,8665,-3395,44,44,88,50.0,0.005357954545454545,22.852272727272727
2230,3658,10882,22,19,41,53.66,0.023787804878048775,29.634146341463413
2235,6590,-590,11,10,21,52.38,0.004147619047619048,56.80952380952381
2596,2322,16728,16,6,22,72.73,0.04721363636363636,77.04545454545455
2640,7383,32767,13,7,20,65.0,0.03062,64.05
2641,1241,-1131,11,9,20,55.0,-0.00043000000000000124,44.1
2643,3628,-5678,7,9,16,43.75,-0.004768749999999999,59.25
2718,5678,-26728,20,22,42,47.62,-0.019954761904761902,49.26190476190476
2719,6961,-9101,41,60,101,40.59,0.002930693069306931,14.881188118811881
2724,4574,-4314,35,48,83,42.17,-0.004477108433734934,21.349397590361445
2726,11619,30531,21,18,39,53.85,0.012274358974358973,25.71794871794872
2729,26420,64580,13,7,20,65.0,0.018909999999999996,51.1
2732,12009,36791,14,10,24,58.33,0.020741666666666665,52.041666666666664
2734,8469,4831,33,38,71,46.48,0.005773239436619717,18.535211267605632
2736,2914,9436,19,12,31,61.29,0.024706451612903222,27.967741935483872
2740,5718,3322,22,31,53,41.51,0.01624528301886793,18.67924528301887
2743,3557,33633,18,7,25,72.0,0.061028,14.04
2745,5070,18630,19,14,33,57.58,0.0217030303030303,21.87878787878788
2752,3648,29952,4,2,6,66.67,0.04866666666666667,14.5
2754,778,-1978,0,2,2,0.0,-0.01615,61.5
2755,725,8675,2,0,2,100.0,0.0751,23.5
2916,3543,9127,23,14,37,62.16,0.02143783783783784,73.94594594594595
2924,4365,-33965,9,15,24,37.5,-0.018204166666666664,82.0
2926,7627,-97127,4,12,16,25.0,-0.06306875,101.3125
2937,1750,2800,7,6,13,53.85,0.010046153846153845,66.84615384615384
3064,17526,-26426,60,73,133,45.11,0.007509022556390975,19.30075187969925
3066,5785,11805,47,43,90,52.22,0.020815555555555556,26.633333333333333
3067,5341,53139,30,18,48,62.5,0.05231249999999999,53.541666666666664
3071,7335,7975,58,42,100,58.0,0.014734,19.73
3073,8704,5816,54,52,106,50.94,0.013599999999999998,17.452830188679247
3078,12151,4549,56,47,103,54.37,0.008335922330097086,19.33009708737864
3081,36546,-56546,13,14,27,48.15,-0.007562962962962962,27.555555555555557
3083,26942,-13992,59,58,117,50.43,0.003335042735042735,23.854700854700855
3085,12349,-6889,85,100,185,45.95,0.01649783783783784,12.713513513513513
3086,9679,21341,68,59,127,53.54,0.03288503937007874,18.590551181102363
3088,17407,5843,54,39,93,58.06,0.006544086021505376,25.21505376344086
3089,7943,13027,63,52,115,54.78,0.024925217391304346,19.191304347826087
3092,7959,-19129,36,40,76,47.37,-0.004236842105263156,23.68421052631579
3093,10059,53591,31,15,46,67.39,0.026467391304347828,61.28260869565217
3095,6724,-6354,59,73,132,44.7,-0.006028787878787878,17.742424242424242
3105,12713,16987,30,23,53,56.6,0.009647169811320756,28.62264150943396
3114,5483,7667,35,24,59,59.32,0.016905084745762716,35.220338983050844
3115,6090,7480,41,42,83,49.4,0.011912048192771084,27.3855421686747
3118,5313,40937,22,9,31,70.97,0.04923225806451612,50.03225806451613
3122,3730,5110,27,19,46,58.7,0.016300000000000002,19.32608695652174
3128,8051,15029,52,36,88,59.09,0.01737159090909091,24.295454545454547
3131,30663,103337,27,17,44,61.36,0.016875,28.931818181818183
3141,4890,28260,23,12,35,65.71,0.036514285714285714,22.285714285714285
3147,1535,9365,8,8,16,50.0,0.0610125,291.25
3152,47022,96278,43,32,75,57.33,0.01230933333333333,26.28
3162,4398,10312,36,26,62,58.06,0.02124677419354839,34.82258064516129
3163,11182,-20132,27,22,49,55.1,0.0006775510204081623,20.46938775510204
3169,7892,-5392,24,16,40,60.0,0.011512499999999998,30.225
3171,8656,6674,64,45,109,58.72,0.012627522935779819,21.541284403669724
3176,22744,-32594,33,35,68,48.53,-0.001654411764705888,20.41176470588235
3178,6852,27058,44,47,91,48.35,0.03243626373626374,25.0989010989011
3188,6995,-1605,46,43,89,51.69,0.004779775280898877,31.685393258426966
3191,9223,-723,65,57,122,53.28,0.00048606557377049486,16.778688524590162
3202,7296,5784,43,39,82,52.44,0.011336585365853661,25.73170731707317
3205,13889,24951,72,75,147,48.98,0.023354421768707487,15.156462585034014
3206,6269,4951,32,31,63,50.79,0.011549206349206347,36.26984126984127
3207,6558,542,44,52,96,45.83,0.006222916666666665,23.510416666666668
3211,17888,-11588,28,24,52,53.85,0.00169423076923077,54.78846153846154
3213,13198,49352,33,19,52,63.46,0.025048076923076923,49.30769230769231
3217,9268,17352,51,38,89,57.3,0.016492134831460673,28.629213483146067
3218,15342,17558,44,33,77,57.14,0.016259740259740255,33.1948051948052
3219,9111,7379,50,45,95,52.63,0.03182631578947369,18.05263157894737
3221,12679,6631,56,46,102,54.9,0.009570588235294119,23.58823529411765
3224,9790,-9770,60,68,128,46.88,-0.0051531250000000015,20.5546875
3226,16478,-1048,60,61,121,49.59,0.006087603305785125,21.537190082644628
3227,46655,60145,41,28,69,59.42,0.01627536231884058,25.246376811594203
3228,21970,36130,60,55,115,52.17,0.01726695652173913,20.704347826086956
3230,5648,7872,46,31,77,59.74,0.01883896103896104,29.207792207792206
3232,8873,18017,65,51,116,56.03,0.019577586206896546,18.198275862068964
3234,8824,7526,33,21,54,61.11,0.015138888888888887,26.5
3236,8648,25712,65,44,109,59.63,0.01808807339449541,18.376146788990827
3252,12428,-24348,77,93,170,45.29,-0.014601764705882347,12.735294117647058
3259,9561,12189,46,42,88,52.27,0.009668181818181819,19.261363636363637
3260,34114,140926,84,52,136,61.76,0.02406397058823529,17.86764705882353
3264,11146,15554,52,37,89,58.43,0.012625842696629213,23.370786516853933
3265,8643,23447,53,32,85,62.35,0.01597764705882353,19.75294117647059
3268,8973,34557,53,43,96,55.21,0.020045833333333332,24.614583333333332
3272,7591,-8491,22,19,41,53.66,-9.268292682927293e-05,24.902439024390244
3276,7306,3604,58,50,108,53.7,0.005535185185185184,20.055555555555557
3284,6976,23274,55,39,94,58.51,0.02051276595744681,26.819148936170212
3285,4116,10684,22,14,36,61.11,0.017847222222222226,34.416666666666664
3287,5795,14875,48,33,81,59.26,0.021416049382716053,22.65432098765432
3288,11648,2412,78,92,170,45.88,0.003979411764705883,14.729411764705882
3289,18751,12199,51,43,94,54.26,0.005546808510638295,22.20212765957447
3290,7257,20843,55,42,97,56.7,0.022464948453608247,24.783505154639176
3293,102258,-121608,50,42,92,54.35,-0.0006695652173913065,20.630434782608695
3294,8598,6632,47,37,84,55.95,0.012233333333333334,23.404761904761905
3297,7270,22710,40,29,69,57.97,0.0222,39.6231884057971
3303,6699,15171,39,26,65,60.0,0.01566923076923077,30.923076923076923
3306,9545,29555,46,25,71,64.79,0.02733661971830986,33.12676056338028
3310,9106,11474,54,45,99,54.55,0.022101010101010097,16.707070707070706
3313,8929,1381,58,51,109,53.21,0.007268807339449543,20.6697247706422
3317,13781,22499,53,37,90,58.89,0.0076577777777777755,17.711111111111112
3322,3635,15825,29,18,47,61.7,0.035346808510638296,31.872340425531913
3323,10945,23155,40,25,65,61.54,0.02137692307692307,28.846153846153847
3324,18901,7489,77,67,144,53.47,0.011395138888888889,15.42361111111111
3325,11507,-11897,55,51,106,51.89,0.0017679245283018859,23.235849056603772
3332,5125,32275,18,6,24,75.0,0.041154166666666665,69.45833333333333
3339,12199,291,87,86,173,50.29,0.00991156069364162,13.369942196531792
3354,8271,37819,69,32,101,68.32,0.03321980198019801,22.96039603960396
3360,6334,14646,50,35,85,58.82,0.019267058823529415,22.623529411764707
3362,10114,25446,49,35,84,58.33,0.020342857142857145,22.11904761904762
3363,4841,20609,22,11,33,66.67,0.031109090909090916,31.393939393939394
3372,5711,16159,45,40,85,52.94,0.01978,28.023529411764706
3373,7791,14109,32,27,59,54.24,0.015098305084745762,30.89830508474576
3374,8230,38070,27,14,41,65.85,0.02959512195121951,18.024390243902438
3379,3385,7525,26,18,44,59.09,0.01950909090909091,32.59090909090909
3388,14055,55245,25,16,41,60.98,0.02400731707317073,66.8048780487805
3390,9663,-5323,51,40,91,56.04,0.005851648351648355,27.912087912087912
3402,6008,14392,31,24,55,56.36,0.015276363636363633,30.0
3426,3028,-7878,7,7,14,50.0,-0.009428571428571429,67.92857142857143
3434,3828,8482,33,21,54,61.11,0.019492592592592593,30.037037037037038
3438,26099,33501,60,46,106,56.6,0.015272641509433962,22.028301886792452
3441,7280,4470,29,25,54,53.7,-1.2962962962966676e-05,25.814814814814813
3444,6148,47202,34,13,47,72.34,0.0464531914893617,33.297872340425535
3455,16503,36907,59,43,102,57.84,0.016977450980392158,16.901960784313726
3465,6282,-8622,48,48,96,50.0,0.0028281250000000008,17.552083333333332
3466,7270,18430,39,33,72,54.17,0.02030277777777778,33.388888888888886
3479,10212,18088,26,18,44,59.09,0.015697727272727276,36.25
3483,25085,50795,60,43,103,58.25,0.019079611650485436,19.902912621359224
3484,10579,3121,37,30,67,55.22,0.00891044776119403,29.940298507462686
3489,4386,2504,36,26,62,58.06,0.011288709677419354,33.0
3490,16865,89535,61,37,98,62.24,0.02486224489795919,21.755102040816325
3491,19866,66034,38,25,63,60.32,0.018238095238095237,24.444444444444443
3492,3441,1359,17,15,32,53.12,0.00986875,28.125
3498,16070,-19320,44,45,89,49.44,-0.0009640449438202254,21.146067415730336
3499,8200,21920,59,38,97,60.82,0.02284536082474227,20.690721649484537
3508,22008,-9018,69,64,133,51.88,0.0030932330827067676,16.669172932330827
3511,10634,13916,39,34,73,53.42,0.014058904109589042,18.863013698630137
3512,11465,-8865,59,55,114,51.75,0.002971052631578949,17.57017543859649
3516,3779,7101,34,18,52,65.38,0.02014807692307692,43.01923076923077
3520,12990,78250,64,44,108,59.26,0.03291018518518518,17.12962962962963
3521,4351,8089,30,25,55,54.55,0.013601818181818185,33.0
3522,6418,2752,45,33,78,57.69,0.014782051282051283,23.03846153846154
3523,8400,2320,50,55,105,47.62,0.004180000000000001,20.914285714285715
3526,22670,12130,47,42,89,52.81,0.002987640449438205,21.224719101123597
3527,36378,7122,41,32,73,56.16,0.009316438356164384,23.506849315068493
3529,48762,124938,35,20,55,63.64,0.019283636363636364,24.345454545454544
3531,4485,12715,22,18,40,55.0,0.02003,56.65
3537,7028,19922,31,19,50,62.0,0.019902000000000003,29.74
3540,11060,-28380,38,34,72,52.78,-0.000709722222222218,23.97222222222222
3541,18065,70285,35,21,56,62.5,0.023862500000000002,27.035714285714285
3546,33578,40472,52,40,92,56.52,0.009560869565217395,20.141304347826086
3548,18147,-20997,50,50,100,50.0,-0.0036739999999999984,20.54
3551,9454,6796,26,19,45,57.78,0.009911111111111108,43.28888888888889
3552,40428,137272,50,34,84,59.52,0.02341309523809524,19.333333333333332
3555,11242,22838,55,50,105,52.38,0.02070190476190477,13.571428571428571
3556,15587,50463,39,23,62,62.9,0.018901612903225805,31.0
3558,17897,21303,18,12,30,60.0,0.012940000000000002,39.333333333333336
3564,6690,-15490,21,23,44,47.73,-0.005947727272727274,32.72727272727273
3567,3328,-3388,23,21,44,52.27,0.0005181818181818166,39.63636363636363
3570,17238,24612,41,26,67,61.19,0.020844776119402986,28.791044776119403
3577,8084,20766,28,17,45,62.22,0.019528888888888887,40.4
3580,6311,-18511,35,43,78,44.87,-0.014383333333333335,20.46153846153846
3581,2938,1612,18,14,32,56.25,0.009356250000000002,26.25
3587,13242,-28442,28,25,53,52.83,-0.002839622641509432,32.471698113207545
3594,4289,6861,18,13,31,58.06,0.011670967741935483,37.74193548387097
3597,933,2297,7,4,11,63.64,0.033299999999999996,240.9090909090909
3609,4957,-8857,20,23,43,46.51,0.007932558139534885,36.41860465116279
3611,37273,227427,35,17,52,67.31,0.03160192307692307,33.67307692307692
3615,9241,-5941,40,36,76,52.63,-0.0002223684210526313,26.80263157894737
3623,10411,34549,39,31,70,55.71,0.02495285714285714,23.12857142857143
3624,4891,16159,22,13,35,62.86,0.028185714285714283,28.571428571428573
3625,5992,-422,37,33,70,52.86,0.008398571428571427,21.87142857142857
3628,9193,12507,19,19,38,50.0,0.016978947368421055,51.55263157894737
3629,7935,-16235,38,43,81,46.91,-0.012406172839506171,18.679012345679013
3630,18212,90888,45,24,69,65.22,0.031249275362318835,18.318840579710145
3631,5478,18472,19,10,29,65.52,0.028548275862068973,39.41379310344828
3632,4208,-12188,24,30,54,44.44,-0.009938888888888886,36.074074074074076
3642,5393,-3183,30,31,61,49.18,0.00268032786885246,22.475409836065573
3646,5454,31446,34,15,49,69.39,0.041391836734693876,24.551020408163264
3652,5182,17968,28,15,43,65.12,0.029986046511627906,40.2093023255814
3663,3126,26074,21,6,27,77.78,0.05249259259259259,41.22222222222222
3664,5705,6135,39,30,69,56.52,0.01352028985507246,21.782608695652176
3666,7098,2552,34,26,60,56.67,0.00865,16.616666666666667
3672,5464,8946,29,21,50,58.0,0.01793,21.18
3675,8076,33624,33,18,51,64.71,0.02825882352941176,28.647058823529413
3680,13350,17300,29,19,48,60.42,0.019085416666666667,30.270833333333332
3684,5344,33006,15,8,23,65.22,0.04199565217391304,52.69565217391305
3685,10722,47728,37,23,60,61.67,0.02914333333333333,15.8
3687,25956,57244,40,36,76,52.63,0.015093421052631574,20.92105263157895
3689,10569,33481,33,19,52,63.46,0.02531153846153846,28.423076923076923
3691,101975,-256675,49,52,101,48.51,-0.005004950495049506,17.722772277227723
3693,19323,-9923,35,34,69,50.72,0.00841449275362319,19.26086956521739
3707,3667,-907,24,23,47,51.06,0.001829787234042554,17.80851063829787
3709,945,3905,4,4,8,50.0,0.035449999999999995,68.5
3710,795,3245,9,4,13,69.23,0.03694615384615385,32.69230769230769
3713,852,-6152,2,2,4,50.0,-0.041775,23.25
4102,8783,9817,46,36,82,56.1,0.014945121951219513,34.15853658536585
4105,25495,24455,44,36,80,55.0,0.008981250000000003,37.1125
4107,16311,24409,65,49,114,57.02,0.015724561403508773,24.350877192982455
4109,8429,48171,50,30,80,62.5,0.03817750000000001,31.1625
4111,9154,11396,47,39,86,54.65,0.008855813953488372,33.72093023255814
4113,9717,-9907,70,79,149,46.98,-0.009674496644295302,14.268456375838927
4114,11832,47018,54,33,87,62.07,0.0253264367816092,29.057471264367816
4116,6673,19527,18,13,31,58.06,0.02394516129032258,31.419354838709676
4120,21485,3415,52,43,95,54.74,0.008150526315789471,26.31578947368421
4121,10524,6206,58,53,111,52.25,0.008517117117117114,25.37837837837838
4123,19705,-12105,53,43,96,55.21,0.004777083333333332,27.479166666666668
4126,21474,132626,62,35,97,63.92,0.03180927835051547,28.103092783505154
4127,7843,15167,52,40,92,56.52,0.015553260869565218,25.891304347826086
4128,8984,-11424,28,36,64,43.75,0.0069046874999999985,35.203125
4129,19761,66239,64,42,106,60.38,0.023147169811320752,21.72641509433962
4130,5621,19879,18,13,31,58.06,0.022251612903225814,44.903225806451616
4131,7631,-6871,54,63,117,46.15,0.01001111111111111,21.427350427350426
4138,5429,5521,10,8,18,55.56,0.010744444444444445,111.72222222222223
4139,12544,11256,22,21,43,51.16,0.007137209302325581,43.25581395348837
4147,16629,-44429,14,17,31,45.16,-0.007683870967741938,33.32258064516129
4153,7181,1719,23,20,43,53.49,0.009113953488372094,31.86046511627907
4154,3763,31037,17,6,23,73.91,0.05791304347826087,37.30434782608695
4157,5181,859,27,21,48,56.25,0.006743750000000001,24.4375
4160,2542,33708,14,2,16,87.5,0.084575,70.25
4161,6017,-20367,15,17,32,46.88,-0.011771875000000001,47.09375
4162,34056,-144206,29,37,66,43.94,-0.013328787878787881,23.757575757575758
4163,17165,-17965,16,13,29,55.17,0.0013137931034482753,51.62068965517241
4167,2456,8844,12,9,21,57.14,0.026709523809523808,42.57142857142857
4168,9686,-7286,33,30,63,52.38,0.004087301587301585,22.96825396825397
4171,7018,-43368,13,25,38,34.21,-0.026294736842105263,28.94736842105263
4173,4188,12962,19,15,34,55.88,0.02221176470588235,37.14705882352941
4174,26829,19871,19,20,39,48.72,0.011658974358974358,24.58974358974359
4175,7177,28423,11,6,17,64.71,0.030317647058823533,77.88235294117646
4183,1357,2993,7,6,13,53.85,0.015507692307692306,47.23076923076923
4188,3001,-1201,12,13,25,48.0,0.004184000000000003,43.72
4192,6245,22805,20,13,33,60.61,0.02835151515151516,21.606060606060606
4198,4114,3356,27,43,70,38.57,0.005769999999999999,15.214285714285714
4205,4516,10684,21,15,36,58.33,0.01611388888888889,93.22222222222223
4207,4440,8210,35,27,62,56.45,0.017088709677419357,47.46774193548387
4303,8520,-1700,89,82,171,52.05,-0.0016502923976608175,16.964912280701753
4304,11929,15601,102,102,204,50.0,0.021525490196078433,11.676470588235293
4305,5814,20696,33,26,59,55.93,0.014577966101694914,47.08474576271186
4401,6625,20305,48,28,76,63.16,0.019268421052631577,39.30263157894737
4402,6501,7389,65,62,127,51.18,0.00903779527559055,18.976377952755904
4406,5956,2314,53,48,101,52.48,0.003710891089108914,27.04950495049505
4413,8279,-11259,70,78,148,47.3,-0.004284459459459456,14.85135135135135
4416,19928,72542,58,32,90,64.44,0.03646444444444444,28.255555555555556
4417,7600,1280,46,34,80,57.5,0.01089125,38.1875
4419,7657,-7497,61,67,128,47.66,-0.001714843750000001,17.828125
4420,3584,13816,20,13,33,60.61,0.02644848484848485,95.12121212121212
4430,4192,8308,16,9,25,64.0,0.017444,73.04
4432,7005,-16255,28,28,56,50.0,-0.0010785714285714277,28.053571428571427
4433,2478,-478,6,9,15,40.0,-0.0017866666666666643,55.333333333333336
4502,9508,-17348,66,84,150,44.0,-0.006276000000000003,18.053333333333335
4503,10463,-7123,78,88,166,46.99,0.0025963855421686725,15.433734939759036
4506,5974,-3734,41,37,78,52.56,0.0016384615384615396,41.32051282051282
4510,6637,9593,52,39,91,57.14,0.013262637362637362,35.175824175824175
4513,3290,12840,34,15,49,69.39,0.03516938775510204,43.51020408163265
4523,10230,36510,53,32,85,62.35,0.02470941176470588,31.705882352941178
4527,7292,318,36,33,69,52.17,0.004234782608695652,46.52173913043478
4528,9099,15151,51,39,90,56.67,0.017382222222222223,33.18888888888889
4529,10414,10206,68,72,140,48.57,0.014100714285714286,20.678571428571427
4530,6934,-1234,57,62,119,47.9,0.016073949579831937,21.0
4533,5270,4410,40,28,68,58.82,0.012070588235294116,46.411764705882355
4534,8160,5950,59,58,117,50.43,0.010888888888888887,21.042735042735043
4535,7494,7356,21,15,36,58.33,0.010638888888888889,82.36111111111111
4538,1017,6943,8,4,12,66.67,0.04691666666666667,99.75
4541,3361,339,15,11,26,57.69,0.005450000000000003,44.26923076923077
4542,3775,3625,16,13,29,55.17,0.006858620689655171,38.41379310344828
4543,2163,11287,12,9,21,57.14,0.03567619047619048,47.38095238095238
4549,7417,15683,10,7,17,58.82,0.016494117647058826,54.23529411764706
4550,1812,9488,9,6,15,60.0,0.03513999999999999,66.66666666666667
4554,4744,6656,17,14,31,54.84,0.019493548387096767,20.612903225806452
4556,1510,15540,6,2,8,75.0,0.064875,125.625
4561,797,12353,4,1,5,80.0,0.10398,91.6
4563,3836,-1636,10,10,20,50.0,0.0044049999999999975,37.75
4568,2350,-5050,4,3,7,57.14,-0.009599999999999989,73.85714285714286
4580,529,-4029,0,1,1,0.0,-0.0433,405.0
4609,6215,915,50,47,97,51.55,0.0055154639175257715,26.876288659793815
4702,8137,12643,72,63,135,53.33,0.020626666666666665,17.622222222222224
4706,4818,6622,37,26,63,58.73,0.011382539682539683,47.888888888888886
4707,3733,10457,33,18,51,64.71,0.025876470588235296,62.13725490196079
4711,3520,18080,28,14,42,66.67,0.03625238095238095,70.04761904761905
4712,8328,22942,58,40,98,59.18,0.021046938775510206,25.367346938775512
4714,5242,14888,46,25,71,64.79,0.026709859154929575,34.32394366197183
4716,6358,24242,44,28,72,61.11,0.0308375,37.80555555555556
4721,12780,70670,56,28,84,66.67,0.03620119047619047,28.857142857142858
4726,8106,12494,27,20,47,57.45,0.011423404255319148,24.425531914893618
4728,8979,-4679,26,21,47,55.32,0.003751063829787233,31.93617021276596
4729,6284,-2684,37,40,77,48.05,0.0029974025974025998,26.142857142857142
4735,10172,-3722,42,36,78,53.85,0.0037897435897435924,19.987179487179485
4736,17846,2254,24,20,44,54.55,0.002329545454545456,31.977272727272727
4741,9686,70264,23,14,37,62.16,0.02784864864864865,41.270270270270274
4743,10290,17660,31,23,54,57.41,0.015599999999999996,24.166666666666668
4744,8380,-13450,26,34,60,43.33,0.0012450000000000007,28.016666666666666
4745,6897,-4497,16,16,32,50.0,-0.0014249999999999888,46.5
4747,1747,8403,4,4,8,50.0,0.027012500000000002,157.25
4754,2023,13927,6,2,8,75.0,0.0395875,74.875
4760,1586,10984,7,5,12,58.33,0.05200000000000002,109.33333333333333
4767,388,5062,3,0,3,100.0,0.08183333333333333,82.0
4804,4089,-4169,27,25,52,51.92,-0.0007057692307692344,18.653846153846153
4806,3717,-7237,23,31,54,42.59,-0.004548148148148149,17.77777777777778
4903,10447,-4587,84,91,175,48.0,0.002067428571428574,14.057142857142857
4905,9770,2790,64,55,119,53.78,0.007858823529411767,24.50420168067227
4907,10661,3149,90,92,182,49.45,0.007437362637362637,13.351648351648352
4908,11565,9185,59,51,110,53.64,0.009534545454545454,22.9
4909,11916,-6066,49,42,91,53.85,0.0025934065934065972,31.65934065934066
4911,13360,-42060,24,31,55,43.64,-0.009119999999999994,34.63636363636363
4924,5730,4090,44,31,75,58.67,0.019212000000000003,21.84
4931,5285,-6005,20,23,43,46.51,0.0022348837209302305,21.558139534883722
4933,8564,7536,28,19,47,59.57,0.01467659574468085,31.93617021276596
4939,3482,12408,25,17,42,59.52,0.020402380952380957,27.285714285714285
4944,6892,9738,44,37,81,54.32,0.022119753086419752,13.382716049382717
4945,1187,15313,3,1,4,75.0,0.080825,11.0
4946,11986,51614,35,28,63,55.56,0.03462380952380952,21.41269841269841
4950,4142,-1352,23,25,48,47.92,0.0071791666666666636,25.4375
4953,5548,-17498,16,16,32,50.0,-0.00375,37.96875
4966,111546,-358546,31,35,66,46.97,-0.010903030303030303,22.257575757575758
4971,11220,17380,21,15,36,58.33,0.017152777777777777,28.13888888888889
4972,2608,19192,9,5,14,64.29,0.053250000000000006,85.21428571428571
4973,5674,-3424,22,18,40,55.0,0.005909999999999999,30.55
4974,6882,15518,19,12,31,61.29,0.016241935483870963,44.61290322580645
4979,10919,-18069,44,34,78,56.41,-0.00017948717948717822,19.71794871794872
4987,4294,-8344,8,7,15,53.33,-0.0011733333333333355,111.26666666666667
4991,8712,-1362,16,14,30,53.33,0.002646666666666665,36.266666666666666
4995,4202,31048,16,7,23,69.57,0.05041739130434784,52.73913043478261
5009,9618,41582,65,36,101,64.36,0.032358415841584165,26.178217821782177
5011,7544,-25264,62,76,138,44.93,-0.02745507246376811,18.702898550724637
5013,7687,-4937,45,35,80,56.25,0.004093749999999998,36.0375
5014,5651,14859,48,29,77,62.34,0.03065844155844155,32.64935064935065
5015,6122,15678,33,22,55,60.0,0.021829090909090906,48.96363636363636
5016,8931,9119,44,29,73,60.27,0.011982191780821919,36.6986301369863
5102,3840,8960,29,21,50,58.0,0.018416000000000002,60.82
5201,9791,31849,68,52,120,56.67,0.024203333333333334,21.533333333333335
5202,7679,3391,65,51,116,56.03,0.00657844827586207,22.939655172413794
5205,12449,21,73,77,150,48.67,0.022926666666666668,13.4
5206,11986,6914,113,111,224,50.45,0.0023075892857142865,11.727678571428571
5209,14348,90752,62,41,103,60.19,0.025357281553398055,27.388349514563107
5210,3037,17943,35,13,48,72.92,0.05438958333333333,56.291666666666664
5211,11033,-1633,51,36,87,58.62,0.008378160919540226,28.839080459770116
5212,8931,31819,45,30,75,60.0,0.02968533333333333,32.8
5213,7374,10326,48,53,101,47.52,0.01998217821782178,24.96039603960396
5220,3491,8469,14,12,26,53.85,0.01926153846153846,27.23076923076923
5223,3268,6832,9,6,15,60.0,0.016686666666666673,30.133333333333333
5227,9838,51512,43,38,81,53.09,0.026461728395061727,12.62962962962963
5230,6241,-12691,18,18,36,50.0,-0.005833333333333333,44.5
5245,11214,-7664,27,22,49,55.1,0.0021775510204081637,18.897959183673468
5251,4720,-4480,27,23,50,54.0,0.0034840000000000006,31.48
5263,39032,28168,24,18,42,57.14,0.011797619047619046,27.238095238095237
5272,11623,29077,42,29,71,59.15,0.020069014084507043,18.43661971830986
5274,100501,546999,33,19,52,63.46,0.030198076923076918,21.5
5276,3526,-6016,22,21,43,51.16,-0.003704651162790697,32.116279069767444
5278,15260,-82510,27,34,61,44.26,-0.010347540983606561,20.37704918032787
5281,2559,-3559,10,9,19,52.63,0.00577894736842105,42.63157894736842
5287,31780,149720,15,9,24,62.5,0.0302625,49.625
5289,17673,48627,19,12,31,61.29,0.02101290322580645,37.645161290322584
5291,3477,-5077,15,18,33,45.45,-0.0010999999999999975,30.454545454545453
5299,2717,1673,14,15,29,48.28,0.015075862068965514,43.89655172413793
5301,10963,2437,88,99,187,47.06,0.0055545454545454535,14.171122994652407
5302,5962,3778,52,45,97,53.61,0.011808247422680412,28.649484536082475
5306,11143,4447,92,97,189,48.68,0.0030026455026455,14.984126984126984
5309,7099,21691,67,44,111,60.36,0.02997387387387388,22.864864864864863
5310,14301,16249,84,94,178,47.19,-0.0008617977528089886,13.314606741573034
5312,27809,98041,71,45,116,61.21,0.027173275862068965,24.301724137931036
5314,8454,3156,75,75,150,50.0,0.0035773333333333317,15.693333333333333
5315,9905,845,86,70,156,55.13,0.011125,15.724358974358974
5321,9686,-14786,72,102,174,41.38,-0.001758620689655174,16.2183908045977
5324,10900,32030,72,105,177,40.68,-0.0019666666666666695,13.655367231638419
5328,6383,10627,61,48,109,55.96,0.016892660550458717,22.94495412844037
5340,7339,7031,75,47,122,61.48,0.017109836065573772,22.131147540983605
5344,7596,-3666,68,69,137,49.64,0.000394160583941607,18.56934306569343
5345,8477,33073,85,65,150,56.67,0.047582,14.293333333333333
5347,14503,-19683,76,72,148,51.35,0.0016966216216216204,19.64864864864865
5348,8152,5878,69,73,142,48.59,0.01341056338028169,15.82394366197183
5351,9846,20274,69,53,122,56.56,0.021812295081967217,21.19672131147541
5353,7476,13534,63,49,112,56.25,0.015974999999999996,21.848214285714285
5355,4209,3391,39,30,69,56.52,0.013876811594202898,39.11594202898551
5356,13174,39166,69,54,123,56.1,0.012203252032520324,24.13821138211382
5364,13063,17557,81,90,171,47.37,0.18991520467836256,15.625730994152047
5371,14245,64305,56,27,83,67.47,0.031057831325301204,28.216867469879517
5381,6597,5853,70,60,130,53.85,0.01902307692307692,20.661538461538463
5383,7260,31400,60,36,96,62.5,0.031584375,25.09375
5386,9988,31172,66,64,130,50.77,0.03157692307692307,19.676923076923078
5392,23955,22115,67,49,116,57.76,0.019641379310344827,22.775862068965516
5398,8757,-3437,75,66,141,53.19,0.004695744680851063,20.843971631205672
5403,5691,16859,35,22,57,61.4,0.0196,49.228070175438596
5410,8906,22644,83,66,149,55.7,0.019483892617449667,17.610738255033556
5425,13102,17978,69,53,122,56.56,0.01232377049180328,20.885245901639344
5426,4029,26271,40,14,54,74.07,0.04586481481481482,53.425925925925924
5432,11636,-3276,94,86,180,52.22,-0.0004883333333333319,13.38888888888889
5438,5755,3585,36,30,66,54.55,0.009268181818181818,52.196969696969695
5439,9514,12746,52,45,97,53.61,0.007353608247422679,27.237113402061855
5443,7489,27261,63,32,95,66.32,0.029329473684210523,25.157894736842106
5450,8064,34716,57,35,92,61.96,0.03714782608695653,28.793478260869566
5452,8742,-1152,58,49,107,54.21,0.005201869158878503,27.46728971962617
5455,12864,-6774,112,125,237,47.26,0.016980590717299585,9.924050632911392
5457,12295,-16665,72,74,146,49.32,-0.001486301369863013,19.458904109589042
5460,3327,8643,28,17,45,62.22,0.02092444444444445,70.53333333333333
5464,7255,30935,43,23,66,65.15,0.03132272727272727,43.015151515151516
5465,8210,12270,66,58,124,53.23,0.015713709677419353,19.427419354838708
5468,9955,24055,86,89,175,49.14,0.034632,12.765714285714285
5474,26596,13694,94,88,182,51.65,0.008373076923076922,13.648351648351648
5475,7588,10922,75,58,133,56.39,0.023406766917293233,19.541353383458645
5478,40671,15829,58,48,106,54.72,0.009739622641509432,25.92452830188679
5481,6468,33432,49,28,77,63.64,0.033318181818181816,36.0
5483,27581,85119,79,49,128,61.72,0.02146015625,20.625
5487,10553,11607,57,42,99,57.58,0.010186868686868687,26.565656565656564
5488,4445,4965,43,29,72,59.72,0.017936111111111114,42.59722222222222
5489,11419,1731,42,36,78,53.85,0.011707692307692308,36.61538461538461
5490,16002,47098,64,40,104,61.54,0.01854423076923077,25.115384615384617
5493,13062,30038,70,54,124,56.45,0.017216129032258068,24.129032258064516
5498,6427,-317,53,48,102,51.96,0.0027901960784313716,24.69607843137255
5508,11210,53190,36,21,57,63.16,0.03658596491228071,52.824561403508774
5511,9300,25930,72,39,111,64.86,0.024952252252252248,26.963963963963963
5512,4612,14498,48,24,72,66.67,0.030854166666666665,28.98611111111111
5514,6701,33099,59,33,92,64.13,0.03454565217391305,28.597826086956523
5516,4085,12675,33,25,58,56.9,0.021724137931034483,40.706896551724135
5520,6056,1524,32,26,58,55.17,0.0034396551724137927,52.41379310344828
5523,6473,12957,54,39,93,58.06,0.024801075268817203,29.763440860215052
5529,9943,5537,82,79,161,50.93,0.05229068322981366,16.732919254658384
5530,21769,76581,96,73,169,56.8,0.01604852071005917,14.68639053254438
5536,19989,-84289,16,17,33,48.48,-0.012584848484848485,54.27272727272727
5543,1548,-2848,5,7,12,41.67,-0.003258333333333332,59.083333333333336
5601,6198,19472,45,29,74,60.81,0.0253,37.189189189189186
5603,5181,16599,44,31,75,58.67,0.028254666666666668,37.026666666666664
5604,6778,36672,35,17,52,67.31,0.041413461538461545,64.5
5609,4501,17799,26,16,42,61.9,0.028185714285714286,71.26190476190476
5701,5300,-6050,49,59,108,45.37,-0.008204629629629631,29.75
5703,6187,16813,29,27,56,51.79,0.020214285714285716,48.07142857142857
5704,6984,-3234,30,32,62,48.39,0.005320967741935482,42.11290322580645
5820,4464,7396,43,33,76,56.58,0.018726315789473685,41.68421052631579
5864,2015,2475,17,15,32,53.12,0.013812499999999998,52.71875
5878,1849,5001,4,3,7,57.14,0.018771428571428574,188.71428571428572
5902,6920,6450,55,57,112,49.11,0.02518928571428571,26.732142857142858
5903,21117,171783,36,13,49,73.47,0.04580612244897959,64.18367346938776
5904,11758,-8458,37,32,69,53.62,0.0012405797101449293,45.95652173913044
5905,5951,1439,46,38,84,54.76,0.007680952380952384,32.20238095238095
6015,5036,10754,56,33,89,62.92,0.025585393258426965,23.303370786516854
6016,2758,8782,29,15,44,65.91,0.03239772727272727,59.77272727272727
6020,2282,23478,20,7,27,74.07,0.06424444444444444,92.11111111111111
6021,4789,9251,39,26,65,60.0,0.021773846153846154,34.46153846153846
6023,5760,2190,13,11,24,54.17,0.009575,97.125
6026,860,1950,8,5,13,61.54,0.02477692307692308,67.3076923076923
6101,12130,17530,91,99,190,47.89,0.010635263157894743,13.631578947368421
6103,11787,13963,97,96,193,50.26,0.012950259067357514,14.347150259067357
6104,17733,14217,60,49,109,55.05,0.009512844036697252,19.89908256880734
6109,6902,22148,61,43,104,58.65,0.022586538461538463,23.740384615384617
6111,20288,-5588,86,84,170,50.59,0.010127647058823531,16.576470588235296
6113,7439,24321,68,46,114,59.65,0.023457894736842108,20.719298245614034
6114,10105,-13585,68,81,149,45.64,-0.0005006711409395977,17.76510067114094
6118,5732,16488,53,31,84,63.1,0.025413095238095245,29.892857142857142
6121,49514,181886,52,35,87,59.77,0.025654022988505748,33.11494252873563
6122,5267,3183,43,35,78,55.13,0.010511538461538465,38.217948717948715
6123,14324,48456,77,59,136,56.62,0.01727720588235294,20.389705882352942
6124,12931,48709,60,41,101,59.41,0.02411485148514851,23.92079207920792
6125,7962,16208,48,34,82,58.54,0.015287804878048782,38.5
6126,7369,21511,53,30,83,63.86,0.021892771084337348,33.2289156626506
6127,8624,9226,67,52,119,56.3,0.010081512605042017,19.016806722689076
6129,12842,44918,75,49,124,60.48,0.025639516129032258,22.725806451612904
6130,15800,29370,82,72,154,53.25,0.07117402597402599,18.883116883116884
6134,12705,3805,73,72,145,50.34,0.00878551724137931,21.979310344827585
6138,19061,52589,56,38,94,59.57,0.02012127659574468,26.627659574468087
6140,5391,6869,47,35,82,57.32,0.011845121951219513,33.30487804878049
6143,22981,28459,76,57,133,57.14,0.013615789473684206,17.894736842105264
6144,5670,-1240,42,45,87,48.28,0.005200000000000003,29.64367816091954
6146,20011,8189,37,31,68,54.41,0.004388235294117645,45.73529411764706
6147,29064,22166,93,74,167,55.69,0.010491017964071857,15.982035928143713
6148,6919,9491,68,53,121,56.2,0.015044628099173554,20.28099173553719
6150,14218,18992,76,68,144,52.78,0.014845833333333336,18.0
6151,6866,21554,44,27,71,61.97,0.020166197183098596,35.67605633802817
6154,3183,9967,17,13,30,56.67,0.02471333333333333,117.6
6156,9962,14768,78,70,148,52.7,0.004854054054054052,15.452702702702704
6158,13890,31830,58,44,102,56.86,0.01875588235294117,29.313725490196077
6160,14932,-27432,58,59,117,49.57,-0.002622222222222219,27.871794871794872
6161,7988,21552,60,37,97,61.86,0.022526804123711344,28.649484536082475
6163,9347,-4677,64,61,125,51.2,0.006364000000000001,22.592
6167,6395,10915,66,45,111,59.46,0.014219819819819818,24.17117117117117
6169,14732,-12492,71,67,138,51.45,0.003311594202898551,18.78985507246377
6170,13410,-190,65,54,119,54.62,0.007589075630252105,27.294117647058822
6171,6722,6138,51,42,93,54.84,0.010664516129032258,28.892473118279568
6173,7910,12230,59,46,105,56.19,0.01660285714285714,24.80952380952381
6174,8861,8019,72,69,141,51.06,0.016089361702127655,17.79432624113475
6175,7597,3913,61,49,110,55.45,0.009604545454545454,25.6
6179,13035,-8095,68,63,131,51.91,0.0007221374045801545,21.709923664122137
6180,17134,30566,66,46,112,58.93,0.0166125,24.455357142857142
6182,13084,52056,73,49,122,59.84,0.018076229508196723,22.516393442622952
6185,9051,12759,51,35,86,59.3,0.010311627906976742,32.616279069767444
6186,14119,-21939,78,93,171,45.61,-0.007156140350877193,13.309941520467836
6187,18811,64539,73,47,120,60.83,0.0236525,18.266666666666666
6188,15267,18633,47,33,80,58.75,0.014348750000000004,32.5875
6190,7101,23499,60,38,98,61.22,0.027747959183673464,27.775510204081634
6194,4593,22807,23,13,36,63.89,0.030538888888888886,86.25
6195,18362,-15302,80,90,170,47.06,0.0022341176470588235,16.2
6198,9071,33689,58,55,113,51.33,0.02887964601769911,20.495575221238937
6199,8998,13142,60,58,118,50.85,0.013335593220338983,19.889830508474578
6203,11263,18987,32,24,56,57.14,0.014817857142857141,50.839285714285715
6204,7504,29596,30,21,51,58.82,0.029558823529411766,57.568627450980394
6207,13397,21353,54,40,94,57.45,0.01361276595744681,31.06382978723404
6208,9187,62963,53,20,73,72.6,0.04856986301369864,33.42465753424658
6210,14331,35449,82,60,142,57.75,0.0178669014084507,17.267605633802816
6212,12537,-29777,75,80,155,48.39,-0.0035845161290322556,16.47741935483871
6217,12017,28523,61,64,125,48.8,0.012384000000000003,18.672
6218,4220,10880,23,13,36,63.89,0.02168611111111111,83.27777777777777
6219,11215,-6335,77,104,181,42.54,0.0007486187845303853,12.154696132596685
6220,9320,-620,51,44,95,53.68,0.007393684210526313,28.53684210526316
6221,10997,-15677,69,73,142,48.59,-0.004535915492957744,18.802816901408452
6222,7998,4432,59,70,129,45.74,0.011419379844961238,17.82170542635659
6223,36044,162456,68,36,104,65.38,0.02802019230769231,19.33653846153846
6227,9912,41908,51,28,79,64.56,0.02627594936708861,32.12658227848101
6228,9619,13811,73,59,132,55.3,0.02212121212121212,15.606060606060606
6229,7033,11677,44,26,70,62.86,0.020505714285714287,28.085714285714285
6231,26957,-43507,65,66,131,49.62,0.006338167938931296,18.938931297709924
6233,17427,-10367,82,65,147,55.78,0.009457823129251702,18.666666666666668
6234,9803,29527,51,31,82,62.2,0.02523414634146341,34.53658536585366
6236,8821,17929,78,67,145,53.79,0.029478620689655153,13.055172413793104
6237,21079,-22449,63,53,116,54.31,0.006917241379310343,22.396551724137932
6240,10362,-332,80,95,176,45.45,-0.007286363636363636,11.340909090909092
6241,9892,25548,72,68,140,51.43,0.015537142857142855,15.057142857142857
6242,10903,-6813,74,77,151,49.01,0.023923841059602644,16.60927152317881
6244,22655,-36955,70,70,140,50.0,0.0015385714285714265,21.364285714285714
6245,19390,33850,70,58,128,54.69,0.012779687500000001,19.8125
6246,9709,-8489,74,85,159,46.54,-0.0009880503144654097,14.559748427672956
6247,4187,3913,27,28,55,49.09,0.012961818181818184,58.345454545454544
6248,8861,15099,58,47,105,55.24,0.01645619047619048,20.123809523809523
6259,8461,31639,75,70,145,51.72,0.04371931034482758,13.324137931034484
6261,19554,14096,39,27,66,59.09,0.008686363636363634,41.53030303030303
6263,14509,2791,38,33,71,53.52,0.004697183098591551,36.54929577464789
6264,6550,-6560,51,56,107,47.66,-0.0006990654205607491,25.64485981308411
6265,5274,1786,42,37,79,53.16,0.008308860759493672,38.63291139240506
6266,7292,16508,63,40,103,61.17,0.017307766990291264,22.66990291262136
6270,4968,8782,29,24,53,54.72,0.01512452830188679,59.339622641509436
6274,10676,-11906,60,55,115,52.17,0.001356521739130437,24.730434782608697
6275,5990,26670,48,26,74,64.86,0.03258243243243244,28.41891891891892
6276,8390,20720,56,64,120,46.67,0.0028291666666666678,17.966666666666665
6279,25355,-39405,43,44,87,49.43,-0.00402528735632184,33.86206896551724
6284,17358,22492,61,49,110,55.45,0.007878181818181815,21.30909090909091
6287,7152,2168,70,69,139,50.36,0.009133812949640285,15.251798561151078
6290,13921,42579,57,39,96,59.38,0.0150375,23.0
6291,12151,-5911,92,117,209,44.02,0.004733971291866026,11.14354066985646
6292,10047,10173,48,39,87,55.17,0.012594252873563215,29.689655172413794
6294,13771,-18891,85,99,184,46.2,-0.020630978260869567,11.41304347826087
6404,4740,610,35,39,74,47.3,0.027231081081081087,16.04054054054054
6411,12056,34894,28,18,46,60.87,0.017491304347826083,20.73913043478261
6417,3642,-8842,8,9,17,47.06,-0.008800000000000006,56.1764705882353
6418,3382,-8792,15,21,36,41.67,-0.007783333333333333,32.55555555555556
6419,2927,10583,15,13,28,53.57,0.047050000000000015,28.607142857142858
6425,8507,-32807,21,29,50,42.0,-0.013812000000000005,20.06
6426,7280,46120,18,9,27,66.67,0.027574074074074077,24.40740740740741
6432,3276,374,12,10,22,54.55,0.009595454545454544,43.68181818181818
6435,12453,71547,20,9,29,68.97,0.041213793103448276,17.620689655172413
6441,12464,-73004,16,27,43,37.21,-0.026944186046511633,27.302325581395348
6446,21483,-5283,17,20,37,45.95,0.004791891891891892,19.81081081081081
6457,2936,13664,8,6,14,57.14,0.03427857142857143,57.357142857142854
6461,4670,11230,24,15,39,61.54,0.01949230769230769,29.076923076923077
6462,33620,8980,22,19,41,53.66,0.0034658536585365843,21.097560975609756
6465,8210,-18610,20,25,45,44.44,-0.005784444444444449,23.155555555555555
6469,5904,34996,9,4,13,69.23,0.03617692307692308,41.23076923076923
6470,5682,31818,16,8,24,66.67,0.03319583333333334,21.916666666666668
6472,16860,123090,19,8,27,70.37,0.06297777777777779,16.88888888888889
6482,7155,27295,19,14,33,57.58,0.02904242424242424,24.181818181818183
6485,6520,-6070,16,10,26,61.54,0.012249999999999995,24.076923076923077
6486,9102,19548,18,13,31,58.06,0.02003870967741936,24.225806451612904
6488,40642,439658,25,6,31,80.65,0.06703548387096775,23.193548387096776
6492,14633,48267,18,14,32,56.25,0.028937500000000005,26.875
6494,4604,40696,16,6,22,72.73,0.05112272727272727,30.636363636363637
6496,2824,2126,8,7,15,53.33,0.009046666666666668,70.4
6499,14823,-22823,19,20,39,48.72,-0.0023153846153846163,25.128205128205128
6506,3766,6634,21,17,38,55.26,0.013373684210526319,39.3421052631579
6508,6226,6374,24,19,43,55.81,0.010825581395348836,61.2093023255814
6509,8547,-2887,49,42,91,53.85,0.00567252747252747,27.560439560439562
6510,122537,-36537,16,15,31,51.61,0.003516129032258066,21.612903225806452
6512,1590,7660,11,5,16,68.75,0.03488125,62.875
6514,6299,28251,15,10,25,60.0,0.027667999999999998,33.48
6516,18313,-43223,16,15,31,51.61,-0.007261290322580643,25.032258064516128
6523,13263,-37163,16,13,29,55.17,-0.0042206896551724125,27.137931034482758
6527,2594,68256,7,2,9,77.78,0.18987777777777776,141.88888888888889
6530,1345,-1475,7,7,14,50.0,-0.0022357142857142853,44.0
6532,4139,4211,16,7,23,69.57,0.011704347826086956,21.17391304347826
6535,4485,57065,17,5,22,77.27,0.08184090909090908,23.772727272727273
6538,3975,-1125,6,7,13,46.15,0.006592307692307689,55.84615384615385
6542,8791,39709,16,13,29,55.17,0.035268965517241374,19.0
6547,3296,13154,9,8,17,52.94,0.031099999999999996,62.94117647058823
6548,14922,4728,23,18,41,56.1,0.014934146341463415,21.878048780487806
6556,3946,12954,10,10,20,50.0,0.018024999999999996,45.65
6560,7346,-9596,15,14,29,51.72,0.006403448275862069,19.17241379310345
6561,17085,144915,10,3,13,76.92,0.05653846153846154,37.07692307692308
6568,9125,109875,9,2,11,81.82,0.08073636363636363,25.363636363636363
6569,10467,37033,9,5,14,64.29,0.019292857142857146,58.857142857142854
6570,1766,17384,8,2,10,80.0,0.05878,53.9
6574,2327,-8477,3,4,7,42.86,-0.015842857142857138,141.14285714285714
6576,9499,-4089,16,11,27,59.26,0.004274074074074076,31.77777777777778
6577,2906,31894,6,2,8,75.0,0.069175,59.25
6578,2080,1270,9,8,17,52.94,0.013811764705882353,45.88235294117647
6588,3456,-19406,4,8,12,33.33,-0.029808333333333336,35.5
6589,2737,3063,8,7,15,53.33,0.01543333333333333,70.6
6590,2748,6702,9,6,15,60.0,0.022679999999999995,73.4
6593,1767,16483,7,4,11,63.64,0.059227272727272726,58.18181818181818
6594,3333,-4033,11,10,21,52.38,-0.001819047619047621,28.714285714285715
6596,3433,9817,8,4,12,66.67,0.023283333333333336,47.666666666666664
6603,4813,8947,36,31,67,53.73,0.015514925373134323,32.07462686567164
6609,7271,-3121,30,28,58,51.72,0.0023344827586206885,47.01724137931034
6612,2917,27783,6,2,8,75.0,0.058162500000000006,32.75
6613,3483,40017,3,1,4,75.0,0.07239999999999999,147.5
6615,4677,-16127,6,8,14,42.86,-0.015457142857142853,56.42857142857143
6616,1912,9208,10,7,17,58.82,0.016970588235294116,22.176470588235293
6624,1488,8862,4,3,7,57.14,0.03710000000000001,53.42857142857143
6629,3044,4456,6,4,10,60.0,0.011879999999999995,31.0
6640,1439,-1239,3,3,6,50.0,1.666666666666483e-05,61.833333333333336
6642,1224,3526,4,2,6,66.67,0.016950000000000003,43.666666666666664
6643,17068,124432,9,2,11,81.82,0.047945454545454534,12.818181818181818
6649,1702,15948,8,3,11,72.73,0.057445454545454536,33.90909090909091
6651,0,0,0,0,0,0.0,,
6654,4209,-5909,6,7,13,46.15,-0.0009538461538461518,26.692307692307693
6661,530,-3780,1,3,4,25.0,-0.03685,59.0
6662,1133,10267,3,3,6,50.0,0.056799999999999996,60.666666666666664
6664,2468,34032,6,1,7,85.71,0.09012857142857143,40.0
6667,2013,19287,5,2,7,71.43,0.06747142857142858,28.714285714285715
6679,19225,26775,13,8,21,61.9,0.011447619047619048,11.761904761904763
6680,872,-4872,1,2,3,33.33,-0.030100000000000002,124.66666666666667
6683,26046,147954,13,8,21,61.9,0.03814285714285714,10.904761904761905
6690,3906,-24906,2,4,6,33.33,-0.031083333333333334,28.833333333333332
6697,445,2305,2,0,2,100.0,0.031200000000000002,66.0
6703,1806,24694,2,1,3,66.67,0.0908,97.66666666666667
6712,8888,-87388,2,5,7,28.57,-0.047214285714285716,13.571428571428571
6716,1868,11032,2,2,4,50.0,0.048825,43.0
6727,1004,3396,2,1,3,66.67,0.019033333333333333,9.333333333333334
6728,790,-1890,1,1,2,50.0,-0.00995,20.0
6732,30385,-270885,2,9,11,18.18,-0.05766363636363636,22.727272727272727
6733,717,1983,3,2,5,60.0,0.018039999999999997,31.0
6747,2818,14682,1,1,2,50.0,0.0412,14.5
6751,1076,-18226,1,3,4,25.0,-0.08745000000000001,62.5
6752,644,-1344,1,1,2,50.0,-0.009749999999999998,83.0
6762,1530,-14030,0,1,1,0.0,-0.0518,250.0
6767,194,2156,1,0,1,100.0,0.0686,92.0
6803,17591,121409,16,4,20,80.0,0.043324999999999995,101.3
7402,7510,-30110,14,20,34,41.18,-0.017650000000000002,33.11764705882353
7556,629,9371,1,0,1,100.0,0.0937,17.0
8024,8315,12465,41,32,73,56.16,0.017235616438356163,33.83561643835616
8027,3077,12423,15,10,25,60.0,0.024123999999999993,27.28
8032,11491,30409,58,42,100,58.0,0.018055000000000005,25.27
8034,5373,6287,47,34,81,58.02,0.012403703703703703,27.469135802469136
8038,8704,13196,23,17,40,57.5,0.01845,23.7
8040,6914,32916,47,22,69,68.12,0.042120289855072456,25.507246376811594
8042,14615,43185,56,38,94,59.57,0.01871276595744681,26.0531914893617
8043,7917,25033,43,27,70,61.43,0.024889999999999995,32.08571428571429
8044,62800,4250,66,60,126,52.38,0.005067460317460315,20.238095238095237
8047,3877,12893,35,19,54,64.81,0.02631481481481481,44.407407407407405
8048,6245,15855,32,22,54,59.26,0.017814814814814815,31.48148148148148
8049,11121,-9311,82,79,161,50.93,0.0019180124223602474,14.602484472049689
8050,16771,22729,39,27,66,59.09,0.01315151515151515,42.333333333333336
8054,11616,14634,45,33,78,57.69,0.01233974358974359,32.23076923076923
8059,3985,-3525,29,31,60,48.33,-0.0003383333333333301,26.0
8064,8400,24710,57,35,92,61.96,0.021230434782608696,23.619565217391305
8066,11826,41144,90,92,182,49.45,0.04485549450549451,12.417582417582418
8067,5934,9136,48,46,94,51.06,0.017880851063829785,29.79787234042553
8068,18366,53904,103,95,198,52.02,0.019707070707070708,11.085858585858587
8069,14416,-21926,68,60,128,53.12,0.00041640624999999924,18.109375
8071,10185,14635,69,67,136,50.74,0.019631617647058824,18.50735294117647
8074,6313,5207,37,34,71,52.11,0.003997183098591549,35.70422535211268
8076,25605,-47605,54,50,104,51.92,-0.0024288461538461543,26.182692307692307
8077,11334,-28044,76,97,173,43.93,-0.0017358381502890186,11.190751445086706
8080,9546,3354,70,76,146,47.95,0.020644520547945206,18.424657534246574
8083,8925,39425,22,18,40,55.0,0.0325625,72.575
8084,11534,13736,51,54,105,48.57,0.005816190476190478,23.485714285714284
8085,5552,15238,53,38,91,58.24,0.01955274725274725,24.054945054945055
8086,17865,19085,53,42,95,55.79,0.009715789473684209,18.063157894736843
8087,3890,8050,36,23,59,61.02,0.025879661016949152,32.76271186440678
8088,14099,781,88,80,168,52.38,0.009568452380952379,13.755952380952381
8089,719,-1359,6,7,13,46.15,-0.01325384615384615,29.307692307692307
8091,18766,45434,60,44,104,57.69,0.017645192307692313,23.721153846153847
8092,5689,811,42,41,83,50.6,0.007298795180722892,30.879518072289155
8093,6038,-14668,43,53,96,44.79,-0.010635416666666666,27.458333333333332
8096,10847,4153,67,57,124,54.03,0.010807258064516127,22.903225806451612
8097,9020,10490,77,68,145,53.1,0.015386896551724136,13.63448275862069
8099,6361,10939,35,24,59,59.32,0.014866101694915255,44.389830508474574
8107,9276,4384,52,45,97,53.61,0.008804123711340206,23.412371134020617
8109,15649,27351,40,29,69,57.97,0.019431884057971017,37.44927536231884
8111,8638,-2738,60,55,115,52.17,0.007533913043478262,22.591304347826085
8121,10997,193,58,52,110,52.73,0.002911818181818182,20.254545454545454
8147,5520,19080,19,11,30,63.33,0.02202333333333333,34.1
8155,8958,32692,30,21,51,58.82,0.02573725490196079,26.941176470588236
8171,3130,-9120,19,21,40,47.5,-0.0009275000000000006,28.2
8176,2355,2675,20,15,35,57.14,0.01706285714285714,37.82857142857143
8182,5504,34546,31,14,45,68.89,0.045339999999999984,40.06666666666667
8183,6688,-6738,53,50,103,51.46,-0.00021165048543689548,20.359223300970875
8234,6773,35177,30,18,48,62.5,0.027360416666666665,36.9375
8240,13494,14856,52,40,92,56.52,0.014151086956521737,28.304347826086957
8255,37590,148460,44,25,69,63.77,0.026124637681159416,30.579710144927535
8277,10694,17636,88,74,162,54.32,0.03688148148148147,13.950617283950617
8279,6285,47015,7,3,10,70.0,0.051000000000000004,35.7
8284,2252,41688,4,4,8,50.0,0.18419999999999997,271.125
8289,2987,963,24,16,40,60.0,0.007755000000000002,53.025
8291,3779,-449,33,38,71,46.48,0.000663380281690142,16.253521126760564
8299,107358,120992,67,47,114,58.77,0.009691228070175438,16.289473684210527
8342,1800,2950,5,2,7,71.43,0.016142857142857143,123.28571428571429
8349,9521,32829,32,24,56,57.14,0.018451785714285716,46.267857142857146
8354,4302,7108,31,21,52,59.62,0.01132307692307692,54.71153846153846
8358,3131,-9311,19,19,38,50.0,-0.003468421052631581,47.078947368421055
8383,13764,5136,44,41,85,51.76,0.007447058823529416,27.070588235294117
8390,9183,13817,39,32,71,54.93,0.013777464788732393,30.676056338028168
8401,2142,11238,16,9,25,64.0,0.035944000000000004,77.28
8403,5961,30039,23,10,33,69.7,0.03308484848484848,43.24242424242424
8409,4902,13648,22,21,43,51.16,0.023288372093023257,30.27906976744186
8410,5759,-7659,20,19,39,51.28,0.0016999999999999997,39.05128205128205
8415,2032,4118,8,6,14,57.14,0.022742857142857145,57.857142857142854
8416,17172,61828,17,11,28,60.71,0.030964285714285715,59.964285714285715
8418,1869,-4699,10,14,24,41.67,-0.012729166666666668,73.20833333333333
8420,2166,9234,12,6,18,66.67,0.03072777777777778,53.77777777777778
8421,3043,8187,21,17,38,55.26,0.021844736842105264,39.81578947368421
8423,2044,4156,10,7,17,58.82,0.014276470588235293,87.52941176470588
8424,3767,3383,8,7,15,53.33,0.01,94.86666666666666
8426,4827,473,24,20,44,54.55,0.006681818181818183,36.68181818181818
8431,6935,78265,17,8,25,68.0,0.071084,15.72
8432,10924,-2774,16,16,32,50.0,-0.0006125000000000002,45.0625
8433,7724,18426,16,8,24,66.67,0.03770416666666667,46.5
8435,2938,16212,6,4,10,60.0,0.03573,132.3
8436,30625,85275,27,19,46,58.7,0.01434130434782609,27.065217391304348
8437,22891,161609,17,7,24,70.83,0.04135833333333334,21.166666666666668
8440,3409,20821,20,12,32,62.5,0.04435625,38.96875
8444,9069,-10069,12,11,23,52.17,0.00332173913043478,36.608695652173914
8446,15060,101840,20,8,28,71.43,0.04249642857142856,30.071428571428573
8450,8852,-24252,19,24,43,44.19,-0.006693023255813952,28.72093023255814
8455,2825,-3225,12,10,22,54.55,-0.000995454545454543,36.68181818181818
8472,4614,-19814,8,14,22,36.36,-0.01067272727272727,33.13636363636363
8476,1966,-1366,10,7,17,58.82,-0.008247058823529411,30.235294117647058
8477,4969,-19969,8,15,23,34.78,-0.018726086956521743,41.52173913043478
8489,18101,-59651,19,27,46,41.3,-0.01500217391304348,21.82608695652174
8905,4659,23441,43,18,61,70.49,0.03954426229508197,47.22950819672131
8906,4856,4134,45,39,84,53.57,0.012970238095238097,35.44047619047619
8908,9119,40321,64,38,102,62.75,0.030723529411764695,31.264705882352942
8916,7532,9078,49,45,94,52.13,0.010539361702127659,30.24468085106383
8917,9321,13929,28,19,47,59.57,0.01584255319148936,62.95744680851064
8921,3986,17154,39,17,56,69.64,0.03231964285714285,49.05357142857143
8923,2484,1786,16,14,30,53.33,0.009079999999999998,101.7
8924,18212,40188,57,45,102,55.88,0.016669607843137254,29.95098039215686
8927,2721,10839,22,13,35,62.86,0.026408571428571427,75.42857142857143
8928,7643,9697,50,37,87,57.47,0.01601609195402299,33.32183908045977
8929,10877,16603,73,73,148,49.32,0.0018763513513513502,15.905405405405405
8930,4052,25398,39,15,54,72.22,0.043416666666666666,51.925925925925924
8931,5018,7792,36,27,63,57.14,0.012825396825396825,48.22222222222222
8932,4458,11422,42,27,69,60.87,0.01999420289855073,37.88405797101449
8933,7182,5978,52,49,101,51.49,0.013567326732673272,26.059405940594058
8935,6487,10023,55,51,106,51.89,0.01779245283018868,24.952830188679247
8936,14041,7949,66,58,124,53.23,0.009094354838709677,22.177419354838708
8937,5201,16439,41,24,65,63.08,0.026235384615384615,45.292307692307695
8938,16949,31301,43,30,73,58.9,0.01148767123287671,40.52054794520548
8941,15219,-2809,53,67,121,43.8,0.05091735537190082,25.198347107438018
8942,21956,13374,60,49,109,55.05,0.007830275229357798,24.798165137614678
9949,3713,-5703,22,23,45,48.89,-0.0032577777777777765,67.4888888888889
9950,4205,14015,30,16,46,65.22,0.02574782608695652,56.65217391304348
9951,12750,-25260,34,39,73,46.58,-0.0009890410958904125,41.205479452054796
9960,7831,40269,42,27,69,60.87,0.035026086956521735,31.231884057971016
9962,4564,5486,35,26,61,57.38,0.017327868852459023,39.65573770491803
8916A,292,-92,0,1,1,0.0,-0.0018,818.0
4148,7926,44674,20,15,35,57.14,0.04518285714285714,20.37142857142857
6781,0,0,0,0,0,0.0,,
6776,249,51,1,0,1,100.0,0.0012,27.0
2211,350,-3750,0,1,1,0.0,-0.0601,18.0
6768,467,6133,1,0,1,100.0,0.082,2.0
3357,1814,9866,10,5,15,66.67,0.030100000000000002,56.333333333333336
6741,2479,-14979,1,2,3,33.33,-0.02513333333333333,30.333333333333332
2250,2201,-21301,1,3,4,25.0,-0.04932500000000001,29.25
5236,1333,-20833,0,2,2,0.0,-0.0852,30.0
1522A,262,-262,0,1,1,0.0,-0.0059,4.0
6684,1246,-30546,0,2,2,0.0,-0.1288,27.5
2753,2503,30997,3,0,3,100.0,0.07966666666666666,34.333333333333336
2348A,217,-117,0,1,1,0.0,-0.0032,18.0
6790,503,-6303,0,2,2,0.0,-0.0673,46.5
6788,5241,-52741,2,5,7,28.57,-0.052242857142857146,12.0
2947,0,0,0,0,0,0.0,,
4440,240,-1690,0,1,1,0.0,-0.0402,1.0
5222,1731,-5841,7,7,14,50.0,-0.007864285714285714,38.642857142857146
2881C,349,-449,0,1,1,0.0,-0.0075,32.0
6761,1853,-11453,1,2,3,33.33,-0.026899999999999997,18.333333333333332
6806,540,560,1,0,1,100.0,0.0061,18.0
2945,952,-1152,2,1,3,66.67,-0.0013666666666666695,11.0
6770,307,-2207,0,1,1,0.0,-0.0409,33.0
6792,1226,-1926,1,1,2,50.0,-0.00605,12.0
4770,0,0,0,0,0,0.0,,
2883B,65,-165,0,1,1,0.0,-0.0192,6.0
6691,1053,-3053,0,1,1,0.0,-0.0168,5.0
3592,15031,429049,19,18,37,51.35,0.17453243243243244,82.97297297297297
6719,0,0,0,0,0,0.0,,
2756,0,0,0,0,0,0.0,,
5244,956,43564,7,5,12,58.33,0.35449166666666665,201.75
6693,0,0,0,0,0,0.0,,
8112A,0,0,0,0,0,0.0,,
8438,1447,10723,4,5,9,44.44,0.061322222222222215,293.0
6829,0,0,0,0,0,0.0,,
4923,1581,65499,8,8,16,50.0,0.33446875,203.9375
6763,0,0,0,0,0,0.0,,
4558,387,26633,2,1,3,66.67,0.5459333333333333,678.3333333333334
3349,1595,-8015,9,11,20,45.0,-0.012955,185.1
6804,0,0,0,0,0,0.0,,
4768,0,0,0,0,0,0.0,,
6807,0,0,0,0,0,0.0,,
6721,0,0,0,0,0,0.0,,
6735,0,0,0,0,0,0.0,,
4583,0,0,0,0,0,0.0,,
6799,0,0,0,0,0,0.0,,
6585,1446,7374,3,1,4,75.0,0.03615,483.5
5228,934,7956,3,4,7,42.86,0.0764142857142857,305.42857142857144
6546,820,103660,2,2,4,50.0,1.709875,530.5
6796,0,0,0,0,0,0.0,,
6550,1838,48842,2,4,6,33.33,0.3729833333333334,340.3333333333333
4577,0,0,0,0,0,0.0,,
