代號,總成本,總損益(淨),獲利次數,損失次數,總交易次數,勝率%,平均報酬,平均持倉時間(日)
1101,3347,23903,12,4,16,75.0,0.04440625000000001,73.5
1102,2290,1810,7,5,12,58.33,0.013850000000000003,116.5
1103,843,-2333,5,6,11,45.45,-0.007136363636363638,141.0909090909091
1104,1526,7674,10,4,14,71.43,0.03477857142857143,111.5
1108,1014,2716,10,6,16,62.5,0.026918749999999998,91.75
1109,692,2708,6,3,9,66.67,0.02982222222222222,179.22222222222223
1110,1254,10346,11,3,14,78.57,0.05324285714285713,109.0
1201,4288,11212,20,15,35,57.14,0.021577142857142857,39.17142857142857
1203,1318,7982,7,3,10,70.0,0.03923,187.1
1210,2406,12244,11,5,16,68.75,0.03466875,96.3125
1213,2320,-2780,18,17,35,51.43,-0.0015199999999999975,44.0
1215,3808,33692,19,5,24,79.17,0.056924999999999996,64.875
1216,4880,10470,9,6,15,60.0,0.017193333333333338,114.06666666666666
1217,1030,8830,14,2,16,87.5,0.07906875,71.3125
1218,1794,1356,13,9,22,59.09,0.01066363636363636,72.9090909090909
1219,1024,4526,7,4,11,63.64,0.03146363636363637,143.63636363636363
1220,285,1515,3,1,4,75.0,0.0378,454.25
1225,5664,34086,27,11,38,71.05,0.04025526315789473,41.39473684210526
1227,4632,-30782,6,8,14,42.86,-0.030242857142857144,116.07142857142857
1229,1076,3324,6,3,9,66.67,0.021766666666666663,174.55555555555554
1231,3679,10071,11,7,18,61.11,0.01753333333333333,77.55555555555556
1232,4671,40129,9,2,11,81.82,0.057590909090909095,186.45454545454547
1233,1038,-2488,2,3,5,40.0,-0.013439999999999997,301.8
1234,1679,6771,6,3,9,66.67,0.02764444444444445,205.77777777777777
1235,3589,18911,18,7,25,72.0,0.035184,58.6
1236,1696,3534,12,7,19,63.16,0.01576315789473684,81.89473684210526
1256,34677,205923,25,13,38,65.79,0.04258947368421053,22.13157894736842
1301,6713,28187,10,5,15,66.67,0.028239999999999998,123.13333333333334
1303,10215,23485,18,10,28,64.29,0.018321428571428575,50.25
1304,2452,15018,19,7,26,73.08,0.042630769230769236,59.84615384615385
1305,4470,17780,29,17,46,63.04,0.024743478260869558,28.608695652173914
1307,3388,-9738,10,16,26,38.46,-0.008192307692307691,58.5
1308,2814,9086,16,9,25,64.0,0.021584,49.96
1309,2079,5561,18,12,30,60.0,0.025396666666666668,44.766666666666666
1310,2960,19840,25,9,34,73.53,0.04325588235294118,35.05882352941177
1312,3453,13797,23,12,35,65.71,0.025037142857142865,36.714285714285715
1313,2000,7170,17,10,27,62.96,0.025185185185185185,53.148148148148145
1314,2814,-404,22,18,40,55.0,0.004197499999999998,34.975
1315,1542,-2842,5,5,10,50.0,-0.00586,167.6
1316,2462,22528,20,10,30,66.67,0.060393333333333334,39.1
1319,5288,24512,18,8,26,69.23,0.030753846153846156,36.53846153846154
1321,3957,34843,18,5,23,78.26,0.054747826086956525,44.34782608695652
1323,4031,28969,17,6,23,73.91,0.04768695652173914,56.04347826086956
1324,1166,11694,12,4,16,75.0,0.06908125,83.625
1325,1822,-1522,7,9,16,43.75,0.005268749999999997,101.0625
1326,10289,38111,16,8,24,66.67,0.02395,61.291666666666664
1337,3304,-11164,26,27,53,49.06,-0.015935849056603776,31.132075471698112
1338,14225,-12325,21,18,39,53.85,0.002053846153846154,39.97435897435897
1339,6504,30546,18,9,27,66.67,0.03754444444444444,55.18518518518518
1340,3722,-26072,18,22,40,45.0,-0.015224999999999999,34.625
1341,1365,4535,3,1,4,75.0,0.025425,76.5
1342,310,4590,1,0,1,100.0,0.0931,11.0
1402,2937,8763,12,7,19,63.16,0.021978947368421056,70.26315789473684
1409,971,4909,10,4,14,71.43,0.04039285714285714,118.42857142857143
1410,1813,6537,9,4,13,69.23,0.02343846153846154,118.46153846153847
1413,2428,1032,23,19,42,54.76,0.014864285714285714,34.904761904761905
1414,1312,5068,15,6,21,71.43,0.03267142857142858,62.0
1416,2506,-10006,15,15,30,50.0,-0.012529999999999998,56.266666666666666
1417,742,4958,9,3,12,75.0,0.07793333333333334,124.25
1418,1440,6610,19,6,25,76.0,0.050544000000000006,40.88
1419,3167,22883,11,3,14,78.57,0.04623571428571428,107.35714285714286
1423,810,-710,7,6,13,53.85,-0.004023076923076922,115.0
1432,3510,20560,28,20,48,58.33,0.04580416666666667,28.416666666666668
1434,3026,10224,11,6,17,64.71,0.024758823529411764,72.88235294117646
1435,1432,1448,14,11,25,56.0,0.016783999999999997,54.4
1436,3548,23602,11,4,15,73.33,0.041746666666666675,103.2
1437,2405,3495,14,11,25,56.0,0.011992000000000004,49.64
1438,2381,2209,26,17,43,60.47,0.017790697674418602,33.13953488372093
1439,2329,5471,15,11,26,57.69,0.01650769230769231,56.07692307692308
1440,2055,6985,18,9,27,66.67,0.02443333333333333,50.111111111111114
1441,2261,8229,21,14,35,60.0,0.037262857142857146,35.74285714285714
1442,1962,8338,12,6,18,66.67,0.02863333333333333,89.27777777777777
1443,1467,803,13,12,25,52.0,0.009772000000000003,55.28
1444,1613,4367,14,10,24,58.33,0.024416666666666666,56.25
1445,894,346,8,6,14,57.14,0.009107142857142855,107.71428571428571
1446,3610,6890,15,12,27,55.56,0.014255555555555556,41.48148148148148
1447,2177,7703,22,12,34,64.71,0.027364705882352937,31.264705882352942
1449,2419,2291,25,25,50,50.0,0.03562599999999999,25.82
1451,3009,4741,15,10,25,60.0,0.019911999999999996,39.52
1452,2086,9774,15,6,21,71.43,0.03588095238095238,78.23809523809524
1453,1319,10811,15,5,20,75.0,0.0694,78.9
1454,569,1061,6,3,9,66.67,0.02066666666666667,205.44444444444446
1455,1729,3381,16,11,27,59.26,0.016229629629629625,46.51851851851852
1456,3513,18457,35,27,62,56.45,0.06704516129032259,15.161290322580646
1457,1710,8550,16,8,24,66.67,0.04085,56.958333333333336
1459,1395,5415,13,9,22,59.09,0.0405,55.09090909090909
1460,1741,-391,13,13,26,50.0,0.014657692307692307,53.15384615384615
1463,1733,13897,14,5,19,73.68,0.04831578947368421,74.3157894736842
1464,2302,20458,16,7,23,69.57,0.060808695652173915,60.130434782608695
1465,1343,8007,10,6,16,62.5,0.041256249999999994,96.625
1466,2773,17157,20,13,33,60.61,0.038827272727272724,40.36363636363637
1467,2271,8139,19,12,31,61.29,0.02572903225806452,41.96774193548387
1468,1080,8520,11,4,15,73.33,0.058793333333333336,105.86666666666666
1470,2201,20399,19,3,22,86.36,0.05816363636363637,40.86363636363637
1471,4421,11719,45,36,81,55.56,0.0251,13.135802469135802
1472,6465,-15285,28,45,73,38.36,0.011542465753424661,18.356164383561644
1473,2520,-970,11,9,20,55.0,0.002015000000000001,78.35
1474,1581,7349,16,7,23,69.57,0.0379695652173913,55.26086956521739
1475,4526,6574,37,32,69,53.62,0.01756231884057971,15.72463768115942
1476,70381,676819,37,7,44,84.09,0.06534545454545454,23.977272727272727
1477,25616,225884,25,5,30,83.33,0.05809333333333333,36.56666666666667
1503,462,6488,2,0,2,100.0,0.08829999999999999,781.0
1504,2919,14881,14,6,20,70.0,0.032534999999999994,68.65
1506,4914,-324,31,26,57,54.39,0.005519298245614036,27.894736842105264
1512,3455,455,34,30,64,53.12,0.007567187500000001,23.203125
1513,1950,8700,12,5,17,70.59,0.03257647058823529,72.23529411764706
1514,1017,1253,9,6,15,60.0,0.01238,102.93333333333334
1515,2971,11719,24,15,39,61.54,0.03613846153846153,38.666666666666664
1516,3946,2484,25,21,46,54.35,0.006571739130434783,27.217391304347824
1517,1866,9324,18,8,26,69.23,0.03531538461538462,49.15384615384615
1519,2731,10869,20,9,29,68.97,0.029006896551724136,49.13793103448276
1521,7731,28119,15,8,23,65.22,0.02770869565217391,62.43478260869565
1522,3831,27469,24,9,33,72.73,0.04822727272727272,32.121212121212125
1524,1994,3926,20,12,32,62.5,0.0168375,43.125
1525,6429,-21079,8,11,19,42.11,-0.003310526315789473,55.94736842105263
1526,3149,9571,24,15,39,61.54,0.02953076923076923,38.69230769230769
1527,8481,40119,25,10,35,71.43,0.036451428571428565,28.0
1528,2377,6133,21,14,35,60.0,0.024722857142857144,40.6
1529,3392,16648,34,34,68,50.0,0.10695294117647058,16.191176470588236
1530,3179,9421,11,7,18,61.11,0.020644444444444448,76.33333333333333
1531,2113,957,14,11,25,56.0,0.006955999999999999,67.56
1532,4619,19381,18,10,28,64.29,0.028682142857142854,40.67857142857143
1533,4959,29241,18,10,28,64.29,0.046224999999999995,42.107142857142854
1535,4842,22008,15,8,23,65.22,0.03069130434782608,72.21739130434783
1536,19210,90340,34,13,47,72.34,0.04083829787234043,24.48936170212766
1537,16214,93186,19,7,26,73.08,0.03715769230769231,50.0
1538,3310,7880,31,27,58,53.45,0.02775517241379311,18.017241379310345
1539,4885,28475,34,14,48,70.83,0.046447916666666665,23.8125
1540,1733,-333,10,8,18,55.56,0.00499444444444444,76.55555555555556
1541,5562,15678,28,16,44,63.64,0.030859090909090902,27.25
1558,13660,74840,12,6,18,66.67,0.03994444444444445,78.16666666666667
1560,7161,31039,16,6,22,72.73,0.03200909090909091,55.72727272727273
1568,4062,-612,19,16,35,54.29,0.009202857142857141,31.4
1582,7126,4924,13,9,22,59.09,0.010118181818181821,70.13636363636364
1583,6919,34681,15,7,22,68.18,0.03512727272727272,70.0
1587,2215,15215,15,6,21,71.43,0.040628571428571424,49.04761904761905
1589,19875,31325,32,21,53,60.38,0.019969811320754722,25.22641509433962
1590,73610,70390,34,23,57,59.65,0.008819298245614036,25.263157894736842
1597,11286,-3936,26,24,50,52.0,0.0013099999999999993,27.14
1598,3202,-2252,8,6,14,57.14,0.001978571428571424,49.285714285714285
1603,1186,8964,10,4,14,71.43,0.052892857142857144,105.5
1604,1184,2276,9,6,15,60.0,0.02259333333333334,97.66666666666667
1605,1685,2105,15,10,25,60.0,0.012848,59.4
1608,1649,731,14,11,25,56.0,0.005879999999999999,61.72
1609,960,-60,10,7,17,58.82,0.006305882352941179,88.88235294117646
1611,2869,9511,24,14,38,63.16,0.024531578947368418,34.026315789473685
1612,969,3401,10,4,14,71.43,0.02944285714285714,110.78571428571429
1614,2451,37549,12,1,13,92.31,0.09792307692307693,98.23076923076923
1615,1212,-1402,9,8,17,52.94,-0.001176470588235291,89.41176470588235
1616,1158,4362,15,6,21,71.43,0.04597619047619047,53.523809523809526
1617,1108,-728,8,9,17,47.06,0.0032,92.17647058823529
1618,1431,2559,13,9,22,59.09,0.020354545454545455,70.5909090909091
1626,4815,-9265,17,20,37,45.95,-0.004870270270270271,36.891891891891895
1701,2787,31163,20,3,23,86.96,0.06830434782608696,47.21739130434783
1702,4319,19481,12,5,17,70.59,0.03908823529411765,94.58823529411765
1707,28736,227864,24,9,33,72.73,0.04870606060606061,40.121212121212125
1708,3572,13828,14,9,23,60.87,0.02471304347826087,60.17391304347826
1709,1802,10448,14,7,21,66.67,0.04053333333333333,85.80952380952381
1710,4766,-3666,23,16,39,58.97,0.0009897435897435875,40.02564102564103
1711,2248,4152,14,9,23,60.87,0.0158,55.26086956521739
1712,1347,6453,10,5,15,66.67,0.03355333333333333,98.53333333333333
1713,831,6719,7,2,9,77.78,0.05223333333333333,142.44444444444446
1714,1913,5887,19,10,29,65.52,0.031127586206896554,51.310344827586206
1717,2209,6891,9,5,14,64.29,0.025628571428571435,105.5
1718,2392,3358,22,15,37,59.46,0.015037837837837837,28.027027027027028
1720,4172,38978,17,4,21,80.95,0.06098571428571428,58.904761904761905
1721,1324,-2024,10,9,19,52.63,0.0014105263157894732,65.10526315789474
1722,4681,34519,11,5,16,68.75,0.044875,94.4375
1723,13781,11719,12,9,21,57.14,0.011495238095238098,74.19047619047619
1725,1235,5015,10,5,15,66.67,0.025946666666666666,86.26666666666667
1726,4084,37916,8,2,10,80.0,0.059030000000000006,156.1
1727,1485,8985,12,7,19,63.16,0.040947368421052635,72.6842105263158
1730,3490,15610,14,6,20,70.0,0.037855,82.1
1731,1664,11436,13,6,19,68.42,0.04499999999999999,70.21052631578948
1732,726,3224,5,4,9,55.56,0.0309,175.77777777777777
1733,4299,-3449,14,13,27,51.85,0.0016259259259259252,63.48148148148148
1734,5310,1790,19,12,31,61.29,0.009712903225806454,43.225806451612904
1735,1100,5350,9,5,14,64.29,0.03422142857142857,110.5
1736,14892,50158,32,17,49,65.31,0.023865306122448974,25.6734693877551
1737,3195,20955,14,7,21,66.67,0.046195238095238095,70.47619047619048
1760,35401,25069,34,33,67,50.75,0.023347761194029853,15.134328358208956
1762,4746,30154,17,7,24,70.83,0.04618749999999999,44.041666666666664
1773,3676,22324,9,4,13,69.23,0.03837692307692307,119.46153846153847
1776,1594,6156,9,6,15,60.0,0.02749333333333333,55.06666666666667
1783,5199,45501,22,7,29,75.86,0.06530689655172413,20.413793103448278
1786,9362,-37662,13,18,31,41.94,-0.018251612903225804,37.74193548387097
1789,6318,-10118,20,18,38,52.63,-0.003660526315789475,43.973684210526315
1795,14180,95720,29,12,41,70.73,0.04958536585365853,16.926829268292682
1802,3716,15294,25,15,40,62.5,0.024945000000000005,32.575
1805,2697,4943,21,19,40,52.5,0.012380000000000002,31.45
1806,1572,7038,19,7,26,73.08,0.04131153846153846,44.57692307692308
1808,3661,9939,11,9,20,55.0,0.015449999999999997,75.95
1809,2366,13104,23,9,32,71.88,0.042315624999999996,33.6875
1810,1166,5754,14,4,18,77.78,0.03916111111111111,64.0
1817,2165,13535,8,3,11,72.73,0.037500000000000006,113.63636363636364
1903,4220,27130,15,5,20,75.0,0.045344999999999996,68.0
1904,622,1428,5,3,8,62.5,0.017899999999999992,188.0
1905,1140,4260,12,5,17,70.59,0.029823529411764707,79.82352941176471
1906,2493,12777,21,13,34,61.76,0.036017647058823536,37.44117647058823
1907,1431,9359,12,6,18,66.67,0.045455555555555555,68.05555555555556
1909,2045,20995,20,4,24,83.33,0.06249166666666666,52.166666666666664
2002,2036,1514,9,7,16,56.25,0.0091625,78.625
2006,2510,4090,11,8,19,57.89,0.015321052631578949,105.57894736842105
2007,1673,6647,19,11,30,63.33,0.042956666666666664,35.733333333333334
2008,2039,10811,18,12,30,60.0,0.042423333333333334,47.5
2009,2158,-568,18,16,34,52.94,0.004320588235294122,40.73529411764706
2010,936,5524,10,3,13,76.92,0.039992307692307695,142.6153846153846
2012,741,2809,6,3,9,66.67,0.030944444444444448,208.77777777777777
2013,4076,25124,16,11,27,59.26,0.03673703703703704,47.074074074074076
2014,2461,-141,22,19,41,53.66,0.004504878048780485,31.658536585365855
2015,3588,11512,9,5,14,64.29,0.021300000000000003,109.78571428571429
2017,1461,4809,16,8,24,66.67,0.03325416666666667,61.083333333333336
2020,736,5264,6,3,9,66.67,0.047444444444444435,171.11111111111111
2022,1669,-2839,15,16,31,48.39,-0.014948387096774193,40.12903225806452
2023,1732,4038,17,9,26,65.38,0.019603846153846152,61.69230769230769
2024,1572,3118,15,10,25,60.0,0.023708,58.64
2025,3421,449,35,38,73,47.95,0.0049273972602739725,15.164383561643836
2027,2186,5064,13,9,22,59.09,0.0177,64.36363636363636
2028,2405,-825,23,26,49,46.94,-0.0041489795918367295,29.285714285714285
2029,1808,17242,12,4,16,75.0,0.05713125,81.0
2030,1430,2240,13,7,20,65.0,0.014970000000000002,57.3
2031,2902,5548,18,12,30,60.0,0.012650000000000002,53.166666666666664
2032,1953,12327,21,7,28,75.0,0.04865000000000001,46.714285714285715
2033,1405,6225,13,7,20,65.0,0.037809999999999996,77.7
2034,2974,17676,16,8,24,66.67,0.0393125,54.791666666666664
2038,1501,4029,14,10,24,58.33,0.02583333333333333,58.041666666666664
2049,48433,111067,26,17,43,60.47,0.011160465116279073,29.651162790697676
2059,55168,121832,20,12,32,62.5,0.02040625,36.5625
2062,4123,4627,16,12,28,57.14,0.018575,50.107142857142854
2069,1911,-511,10,9,19,52.63,0.0023421052631578967,35.63157894736842
2101,2019,-5819,5,6,11,45.45,-0.011290909090909095,130.9090909090909
2102,3150,8450,20,13,33,60.61,0.01823939393939394,39.696969696969695
2103,7206,2594,27,22,49,55.1,0.00885918367346939,30.53061224489796
2104,4314,-3414,17,13,30,56.67,0.0018533333333333325,54.3
2105,5393,-25393,10,12,22,45.45,-0.019236363636363635,72.9090909090909
2106,4490,-7990,10,12,22,45.45,-0.004513636363636365,73.63636363636364
2107,1788,16412,12,4,16,75.0,0.055749999999999994,72.0625
2108,3865,14235,19,10,29,65.52,0.025382758620689654,43.41379310344828
2109,2587,9603,23,12,35,65.71,0.033231428571428565,34.05714285714286
2114,6251,17949,9,5,14,64.29,0.01986428571428572,119.57142857142857
2115,5110,15140,13,9,22,59.09,0.021763636363636357,56.04545454545455
2201,7187,19713,22,21,43,51.16,0.017599999999999998,38.0
2204,2646,25154,11,6,17,64.71,0.0600764705882353,79.70588235294117
2206,2720,30180,17,3,20,85.0,0.066595,60.9
2207,52441,414559,19,9,28,67.86,0.05055357142857143,37.464285714285715
2208,2025,-2625,11,11,22,50.0,0.0035227272727272707,65.72727272727273
2227,28355,122145,12,8,20,60.0,0.031380000000000005,71.3
2228,16983,-75183,15,18,33,45.45,-0.018754545454545458,44.0
2231,49205,26095,26,17,43,60.47,0.019683720930232563,27.325581395348838
2233,15410,91590,25,12,37,67.57,0.03750270270270271,33.972972972972975
2236,4418,882,19,16,35,54.29,0.006382857142857145,27.4
2239,17343,-53843,19,19,38,50.0,-0.009913157894736844,24.55263157894737
2241,4299,-919,6,8,14,42.86,0.0026714285714285737,113.92857142857143
2243,3935,16365,25,20,45,55.56,0.03154444444444444,14.933333333333334
2247,1230,-2230,0,1,1,0.0,-0.0106,260.0
2301,4706,-1656,10,10,20,50.0,0.0017400000000000015,55.2
2302,1451,8369,20,5,25,80.0,0.057076,46.68
2303,1337,8313,12,5,17,70.59,0.045158823529411765,70.52941176470588
2305,1771,6209,19,13,32,59.38,0.041915625,27.4375
2308,21980,-6480,16,12,28,57.14,0.0028785714285714274,43.607142857142854
2312,1259,10611,15,3,18,83.33,0.06863333333333334,59.44444444444444
2313,2683,16567,19,7,26,73.08,0.042507692307692316,52.80769230769231
2314,4634,22046,29,21,50,58.0,0.037432,26.74
2316,2428,11422,17,9,26,65.38,0.03390384615384616,51.65384615384615
2317,9488,30812,12,8,20,60.0,0.02293,71.8
2321,3762,548,46,36,82,56.1,0.0105890243902439,12.231707317073171
2323,1255,-2495,11,13,24,45.83,-0.021054166666666665,61.916666666666664
2324,1941,10609,13,4,17,76.47,0.040100000000000004,79.70588235294117
2327,8436,63344,23,10,33,69.7,0.06885454545454546,46.27272727272727
2328,3804,11596,25,13,38,65.79,0.022368421052631583,32.71052631578947
2329,2351,10079,23,13,36,63.89,0.03933611111111111,30.38888888888889
2330,14618,87482,13,6,19,68.42,0.03701578947368421,81.36842105263158
2331,3116,2994,24,16,40,60.0,0.014932499999999996,32.4
2332,2167,9393,17,10,27,62.96,0.03287407407407407,35.0
2337,2759,-1499,25,24,49,51.02,-0.003018367346938774,29.877551020408163
2338,1350,7060,12,7,19,63.16,0.03674736842105263,83.26315789473684
2340,2588,7772,21,12,33,63.64,0.020315151515151515,41.39393939393939
2342,4064,-2464,37,36,73,50.68,0.004506849315068491,18.73972602739726
2344,3079,7311,30,17,47,63.83,0.02614893617021277,29.617021276595743
2345,6496,34504,24,10,34,70.59,0.03280294117647059,44.294117647058826
2347,4565,11085,12,7,19,63.16,0.024342105263157898,76.78947368421052
2348,5410,2250,13,16,29,44.83,0.2718689655172414,33.96551724137931
2349,2131,4389,23,18,41,56.1,0.030290243902439024,28.78048780487805
2351,7363,35987,23,14,37,62.16,0.030799999999999998,34.729729729729726
2352,2879,7501,24,15,39,61.54,0.020053846153846155,37.58974358974359
2353,3077,-4627,17,16,33,51.52,-0.0008545454545454545,37.36363636363637
2354,8883,30017,14,9,23,60.87,0.022847826086956523,65.52173913043478
2355,7303,-9103,21,17,38,55.26,0.003078947368421056,31.894736842105264
2356,3474,29986,23,7,30,76.67,0.05738999999999999,31.633333333333333
2357,26318,106682,13,6,19,68.42,0.024831578947368416,62.8421052631579
2358,3160,320,21,23,44,47.73,0.00528409090909091,27.636363636363637
2359,2436,12564,18,8,26,69.23,0.033965384615384626,49.19230769230769
2360,12750,56400,22,10,32,68.75,0.02845,46.40625
2362,3124,2376,9,8,17,52.94,0.013635294117647063,87.05882352941177
2363,2339,-169,21,16,37,56.76,0.00687837837837838,35.45945945945946
2364,2896,1964,31,31,62,50.0,0.01896290322580645,15.064516129032258
2365,1556,8694,17,6,23,73.91,0.04423478260869564,59.95652173913044
2367,2422,3618,19,13,32,59.38,0.015093749999999998,45.0
2368,2643,11557,27,12,39,69.23,0.03606153846153846,27.743589743589745
2369,2831,18279,27,11,38,71.05,0.04448947368421052,29.31578947368421
2371,1989,871,18,14,32,56.25,0.007206250000000001,44.8125
2373,4269,16181,8,5,13,61.54,0.029576923076923074,119.84615384615384
2374,3695,23775,25,13,38,65.79,0.040568421052631566,36.36842105263158
2375,2927,12603,27,11,38,71.05,0.04730526315789473,39.10526315789474
2376,5244,30056,19,7,26,73.08,0.03545769230769231,55.19230769230769
2377,8365,43135,26,12,38,68.42,0.0377157894736842,35.68421052631579
2379,14547,51453,20,11,31,64.52,0.02572903225806452,43.193548387096776
2380,2597,6943,26,20,46,56.52,0.027726086956521737,25.891304347826086
2382,6550,44050,14,4,18,77.78,0.044727777777777776,71.22222222222223
2383,10724,80376,21,8,29,72.41,0.04697931034482759,46.62068965517241
2385,7398,70402,13,4,17,76.47,0.0604764705882353,76.11764705882354
2387,2419,6881,17,11,28,60.71,0.019914285714285718,40.357142857142854
2388,5680,22650,31,28,59,52.54,0.03033050847457627,16.47457627118644
2390,3522,16648,29,16,45,64.44,0.030906666666666662,27.555555555555557
2392,7964,-4014,19,19,38,50.0,0.0036394736842105244,44.28947368421053
2393,6133,7717,17,13,30,56.67,0.01223333333333333,44.1
2395,28721,262279,20,4,24,83.33,0.06112916666666667,52.708333333333336
2397,7292,17308,18,12,30,60.0,0.024380000000000002,47.0
2399,1996,6724,18,12,30,60.0,0.02650333333333333,41.2
2401,1830,11130,18,7,25,72.0,0.048096,39.88
2402,3081,16169,25,10,35,71.43,0.03686571428571428,33.857142857142854
2404,6200,12900,17,11,28,60.71,0.01630714285714286,52.75
2405,3205,4085,29,19,48,60.42,0.014654166666666668,24.583333333333332
2406,5241,5489,33,30,63,52.38,0.010296825396825396,19.3015873015873
2408,9537,103413,42,29,71,59.15,0.12918169014084505,17.830985915492956
2409,2772,-3242,21,19,40,52.5,-0.004147499999999998,30.925
2412,1811,22889,3,0,3,100.0,0.078,561.6666666666666
2413,3624,13256,31,17,48,64.58,0.03309375,25.9375
2414,1752,5698,12,6,18,66.67,0.022711111111111112,82.11111111111111
2415,3803,13197,26,14,40,65.0,0.02363,29.3
2417,2363,9757,20,12,32,62.5,0.035575,30.5
2419,2079,14571,14,8,22,63.64,0.04338181818181818,52.22727272727273
2420,3103,14247,12,5,17,70.59,0.03523529411764706,89.17647058823529
2421,4281,10919,21,14,35,60.0,0.01714571428571429,43.857142857142854
2423,1833,9717,11,5,16,68.75,0.03573125,90.6875
2424,6905,16295,23,24,47,48.94,0.023721276595744686,20.51063829787234
2425,7018,7332,25,23,48,52.08,0.012364583333333337,27.354166666666668
2426,3488,3762,27,22,49,55.1,0.016895918367346933,24.489795918367346
2427,1518,2332,15,9,24,62.5,0.014295833333333334,57.166666666666664
2428,7891,50959,20,8,28,71.43,0.041660714285714294,56.0
2429,3170,23310,22,17,39,56.41,0.06617179487179488,20.205128205128204
2430,5527,32123,22,11,33,66.67,0.04509090909090909,53.27272727272727
2431,2596,5884,23,14,37,62.16,0.024629729729729724,31.216216216216218
2433,2830,27870,10,2,12,83.33,0.06472499999999999,122.5
2434,2467,17293,22,19,41,53.66,0.07852682926829269,30.829268292682926
2436,6165,23985,33,18,51,64.71,0.030125490196078426,22.980392156862745
2438,2707,-787,24,25,49,48.98,0.030373469387755106,26.285714285714285
2439,31684,75766,39,25,64,60.94,0.020573437499999996,20.203125
2440,2341,12649,25,11,36,69.44,0.049833333333333334,34.22222222222222
2441,3720,24230,15,4,19,78.95,0.044700000000000004,78.73684210526316
2442,2109,4101,20,13,33,60.61,0.021003030303030305,36.81818181818182
2443,2765,-3725,27,27,54,50.0,-0.013818518518518511,21.98148148148148
2444,5550,7950,40,32,72,55.56,0.01863333333333334,19.77777777777778
2449,3346,16554,17,7,24,70.83,0.03446666666666667,42.541666666666664
2450,3341,16559,10,5,15,66.67,0.028486666666666667,106.13333333333334
2451,5890,22310,8,5,13,61.54,0.025038461538461534,132.15384615384616
2453,2181,11479,18,9,27,66.67,0.037474074074074076,38.96296296296296
2454,51537,340963,20,7,27,74.07,0.04512592592592593,49.592592592592595
2455,11302,27698,28,19,47,59.57,0.01739148936170213,30.72340425531915
2457,3111,21809,29,9,38,76.32,0.04818684210526315,26.394736842105264
2458,12131,-8731,23,21,44,52.27,-0.0005931818181818128,33.63636363636363
2459,2580,31620,11,2,13,84.62,0.07608461538461539,107.3076923076923
2460,1796,3864,16,10,26,61.54,0.020188461538461537,47.96153846153846
2461,2372,23778,22,5,27,81.48,0.06671481481481482,39.925925925925924
2462,4317,9083,17,15,32,53.12,0.014043749999999994,40.90625
2464,5518,28382,21,10,31,67.74,0.034348387096774194,38.38709677419355
2465,2674,8546,27,15,42,64.29,0.033273809523809525,22.928571428571427
2466,2042,18508,9,2,11,81.82,0.058563636363636366,119.36363636363636
2467,2468,14782,15,8,23,65.22,0.03818695652173913,57.04347826086956
2468,1214,13796,13,3,16,81.25,0.08045625,94.4375
2471,2075,12925,16,6,22,72.73,0.04021363636363636,55.09090909090909
2472,5067,26833,24,9,33,72.73,0.04085757575757575,32.72727272727273
2474,54815,4685,26,18,44,59.09,0.010995454545454544,29.5
2476,2361,14089,14,5,19,73.68,0.038621052631578945,82.42105263157895
2477,3119,22351,24,11,35,68.57,0.046400000000000004,36.457142857142856
2478,2863,2387,15,13,28,53.57,0.008135714285714283,52.285714285714285
2480,1772,1728,7,4,11,63.64,0.012727272727272726,139.63636363636363
2481,3207,4973,24,15,39,61.54,0.015953846153846152,37.30769230769231
2482,1976,9964,17,9,26,65.38,0.03918076923076923,38.61538461538461
2483,2531,21599,20,6,26,76.92,0.05802307692307693,50.34615384615385
2484,2621,18939,22,6,28,78.57,0.04765357142857144,30.714285714285715
2485,5149,-7799,23,21,44,52.27,-0.000604545454545455,37.65909090909091
2486,2608,9052,22,14,36,61.11,0.025069444444444446,35.05555555555556
2488,5748,23682,29,11,40,72.5,0.037029999999999993,29.225
2489,3592,-3522,23,20,43,53.49,0.0007279069767441875,39.116279069767444
2491,3309,4931,32,31,63,50.79,0.01703015873015873,15.26984126984127
2492,5586,32454,33,16,49,67.35,0.03579183673469388,29.448979591836736
2493,2431,4469,11,7,18,61.11,0.013033333333333334,94.38888888888889
2495,1483,1267,10,8,18,55.56,0.011222222222222224,83.05555555555556
2496,6614,2296,28,30,58,48.28,-0.0021241379310344842,23.413793103448278
2497,5302,10148,25,17,42,59.52,0.016059523809523808,30.761904761904763
2498,17863,-19563,33,31,64,51.56,0.0021265624999999982,22.796875
2501,1679,10771,12,5,17,70.59,0.04497647058823529,75.82352941176471
2504,1253,207,10,9,19,52.63,0.004899999999999999,76.57894736842105
2505,1780,6770,13,7,20,65.0,0.031545000000000004,65.75
2506,725,11515,9,1,10,90.0,0.12338999999999997,141.9
2509,2924,-674,12,13,25,48.0,0.004108000000000004,60.12
2511,1584,1556,14,8,22,63.64,0.011068181818181817,72.45454545454545
2514,2343,1857,14,11,25,56.0,0.011487999999999996,61.32
2515,1121,7719,14,4,18,77.78,0.060033333333333334,68.16666666666667
2516,1191,2329,14,7,21,66.67,0.0271952380952381,71.04761904761905
2520,4161,30089,23,9,32,71.88,0.03842812500000001,28.0
2524,1715,8185,8,4,12,66.67,0.03742500000000001,129.41666666666666
2527,1839,16011,13,5,18,72.22,0.05907222222222223,68.44444444444444
2528,4136,474,24,32,56,42.86,0.005787499999999997,25.232142857142858
2530,1815,18165,18,3,21,85.71,0.06515714285714286,46.38095238095238
2534,2917,7733,17,11,28,60.71,0.017053571428571425,44.42857142857143
2535,2044,20606,13,4,17,76.47,0.055494117647058826,82.41176470588235
2536,2668,4532,13,8,21,61.9,0.015338095238095241,69.38095238095238
2537,2377,-3197,20,16,36,55.56,-0.004597222222222221,44.97222222222222
2538,1953,5217,16,10,26,61.54,0.02049230769230769,60.23076923076923
2539,2229,25671,12,2,14,85.71,0.07208571428571428,91.42857142857143
2540,6458,30782,28,14,42,66.67,0.04757619047619048,28.547619047619047
2542,4982,15068,11,9,20,55.0,0.02143,83.1
2543,1111,-541,9,9,18,50.0,0.004027777777777776,80.05555555555556
2545,5796,34054,20,8,28,71.43,0.03962857142857144,47.42857142857143
2546,1095,4155,8,4,12,66.67,0.03019166666666667,126.33333333333333
2547,2105,-445,16,13,29,55.17,0.004375862068965516,54.96551724137931
2548,9485,13015,15,11,26,57.69,0.012869230769230773,48.92307692307692
2597,6099,51301,16,5,21,76.19,0.057519047619047615,58.904761904761905
2601,3511,939,25,20,45,55.56,0.011348888888888888,30.466666666666665
2603,2037,12553,17,7,24,70.83,0.043699999999999996,56.708333333333336
2605,3665,24385,23,11,34,67.65,0.03938235294117647,37.85294117647059
2606,6133,21017,21,12,33,63.64,0.024045454545454543,41.39393939393939
2607,1808,16092,15,4,19,78.95,0.058926315789473695,63.73684210526316
2608,2223,15377,8,2,10,80.0,0.045950000000000005,142.7
2609,2498,2892,22,16,38,57.89,0.01298684210526316,33.39473684210526
2610,1626,1344,15,9,24,62.5,0.012116666666666664,66.25
2611,1617,9653,17,6,23,73.91,0.045243478260869566,68.17391304347827
2612,4301,15799,17,11,28,60.71,0.025846428571428572,40.464285714285715
2613,2033,9917,16,7,23,69.57,0.03333043478260869,55.0
2614,3308,7172,27,26,53,50.94,0.01927358490566037,22.264150943396228
2615,1837,1063,11,8,19,57.89,0.009878947368421053,78.6842105263158
2616,1151,7649,6,2,8,75.0,0.04095,199.125
2617,2518,1032,15,11,26,57.69,0.005907692307692308,50.61538461538461
2618,2216,13284,18,9,27,66.67,0.03869259259259259,43.851851851851855
2630,1998,11252,13,7,20,65.0,0.037004999999999996,34.75
2633,1054,7646,5,2,7,71.43,0.045214285714285714,82.28571428571429
2634,2115,4285,7,5,12,58.33,0.01796666666666667,106.58333333333333
2636,2970,16480,15,7,22,68.18,0.038622727272727274,56.86363636363637
2637,3532,5868,12,9,21,57.14,0.015271428571428571,74.47619047619048
2642,2555,11295,8,5,13,61.54,0.028938461538461538,69.61538461538461
2701,525,-1675,3,4,7,42.86,-0.015428571428571427,248.14285714285714
2702,2364,6616,14,11,25,56.0,0.023707999999999993,71.2
2704,2331,19119,12,3,15,80.0,0.05120000000000001,107.53333333333333
2705,1554,4176,11,11,22,50.0,0.033749999999999995,60.13636363636363
2706,1082,-532,7,6,13,53.85,0.0033230769230769277,132.30769230769232
2707,21455,34345,15,9,24,62.5,0.016187500000000004,70.25
2712,1770,9130,9,4,13,69.23,0.03300769230769231,92.92307692307692
2722,7849,-10699,23,21,44,52.27,-0.0010795454545454537,41.22727272727273
2723,52212,26388,29,29,58,50.0,0.0011775862068965541,24.603448275862068
2727,36333,53067,33,20,53,62.26,0.01547924528301887,29.962264150943398
2731,13543,15007,18,12,30,60.0,0.011319999999999998,35.93333333333333
2739,2746,-4296,10,9,19,52.63,-0.00323684210526316,54.8421052631579
2748,3671,-17521,5,9,14,35.71,-0.017364285714285714,70.21428571428571
2801,788,5112,6,2,8,75.0,0.0414625,229.875
2809,2683,9167,12,6,18,66.67,0.02363888888888889,80.05555555555556
2812,351,1399,4,1,5,80.0,0.03578,336.0
2816,1953,4397,12,8,20,60.0,0.015750000000000004,68.9
2820,235,3365,3,0,3,100.0,0.09726666666666667,522.6666666666666
2832,688,4012,4,2,6,66.67,0.039233333333333335,354.6666666666667
2834,406,464,4,2,6,66.67,0.014916666666666668,316.8333333333333
2836,479,3261,6,1,7,85.71,0.05485714285714286,258.2857142857143
2838,696,534,6,4,10,60.0,0.006920000000000001,196.8
2841,2109,-4779,14,22,36,38.89,-0.022477777777777777,44.72222222222222
2845,426,1804,4,2,6,66.67,0.030733333333333335,336.5
2849,1204,14396,12,2,14,85.71,0.07822857142857143,56.57142857142857
2850,1303,4847,7,3,10,70.0,0.027239999999999997,145.7
2851,647,6203,6,1,7,85.71,0.060457142857142855,199.0
2852,1015,985,7,6,13,53.85,0.01116153846153846,111.53846153846153
2855,1351,8599,12,4,16,75.0,0.040749999999999995,90.75
2867,1436,-2926,8,12,20,40.0,-0.01422,70.7
2880,890,6160,7,2,9,77.78,0.0451,164.66666666666666
2881,4550,22100,13,6,19,68.42,0.03448421052631579,93.05263157894737
2882,5036,32314,15,6,21,71.43,0.04283809523809524,79.04761904761905
2883,1171,-621,10,8,18,55.56,0.0027333333333333315,80.72222222222223
2884,1313,2837,8,4,12,66.67,0.020025,163.91666666666666
2885,1443,3007,10,7,17,58.82,0.016441176470588233,83.70588235294117
2886,1268,11432,7,2,9,77.78,0.05571111111111112,175.33333333333334
2887,1464,4736,13,6,19,68.42,0.023136842105263154,78.73684210526316
2888,1229,3841,12,7,19,63.16,0.02589473684210526,72.05263157894737
2889,584,-854,5,4,9,55.56,-0.006622222222222228,174.88888888888889
2890,975,8445,11,2,13,84.62,0.05996153846153846,125.0
2891,1936,7664,12,6,18,66.67,0.026777777777777786,92.61111111111111
2892,934,3766,6,3,9,66.67,0.027755555555555558,170.44444444444446
2897,629,2281,7,3,10,70.0,0.029230000000000006,77.7
2901,2869,4931,10,8,18,55.56,0.014811111111111115,87.72222222222223
2903,2000,7100,10,6,16,62.5,0.03131875,92.0625
2904,1950,6550,9,6,15,60.0,0.021073333333333333,107.13333333333334
2905,2604,12446,16,6,22,72.73,0.030713636363636367,60.45454545454545
2906,827,8483,9,2,11,81.82,0.0725,149.0909090909091
2908,500,4500,3,1,4,75.0,0.058399999999999994,445.75
2910,4008,36842,19,5,24,79.17,0.05555833333333333,50.375
2911,2504,-3994,20,19,39,51.28,-0.006364102564102564,38.17948717948718
2912,28048,108952,15,7,22,68.18,0.028163636363636356,70.4090909090909
2913,1823,17177,16,4,20,80.0,0.05611000000000001,79.9
2915,5943,22507,11,6,17,64.71,0.026270588235294122,72.0
2923,2825,10825,15,7,22,68.18,0.02558636363636364,39.27272727272727
2929,10842,-62522,22,35,57,38.6,-0.02652982456140351,21.035087719298247
2936,3006,5144,15,9,24,62.5,0.014262500000000003,36.5
2939,7450,-34350,13,19,32,40.62,-0.021021875000000002,16.40625
3002,1031,10429,12,2,14,85.71,0.07410714285714286,89.35714285714286
3003,8003,30547,25,14,39,64.1,0.02728461538461538,33.717948717948715
3004,10225,22975,21,16,37,56.76,0.018194594594594594,33.37837837837838
3005,3920,32280,23,8,31,74.19,0.04570645161290324,46.03225806451613
3006,7565,33235,27,13,40,67.5,0.036070000000000005,30.725
3008,693206,4436794,36,17,53,67.92,0.04222264150943397,25.433962264150942
3010,3944,20756,9,5,14,64.29,0.03475,105.5
3011,1971,7339,23,10,33,69.7,0.037454545454545456,33.93939393939394
3013,4223,12677,28,20,48,58.33,0.021708333333333333,30.875
3014,5376,19674,22,10,32,68.75,0.0247625,39.09375
3015,2526,19374,14,6,20,70.0,0.04198,52.5
3016,5932,-10952,30,30,60,50.0,-0.002480000000000001,22.65
3017,3976,14174,21,11,32,65.62,0.029834374999999996,34.78125
3018,3510,13390,19,15,34,55.88,0.023567647058823533,39.05882352941177
3019,9302,22148,27,20,47,57.45,0.01538510638297872,31.106382978723403
3021,1616,4384,13,8,21,61.9,0.018752380952380947,68.71428571428571
3022,4256,23944,12,7,19,63.16,0.0404421052631579,58.1578947368421
3023,7780,31820,18,9,27,66.67,0.03412592592592593,54.0
3024,1426,-956,12,14,26,46.15,-0.0028115384615384634,40.69230769230769
3025,2742,6318,22,15,37,59.46,0.02231621621621621,40.945945945945944
3026,3558,21042,11,6,17,64.71,0.0475,90.88235294117646
3027,2413,2897,18,16,34,52.94,0.013597058823529413,39.88235294117647
3028,1142,3958,7,4,11,63.64,0.024172727272727276,166.45454545454547
3029,3640,9810,24,12,36,66.67,0.021122222222222223,35.94444444444444
3030,4766,17534,12,6,18,66.67,0.026683333333333333,60.72222222222222
3031,3000,14970,25,14,39,64.1,0.03681538461538461,27.974358974358974
3032,3687,20223,21,10,31,67.74,0.03677096774193549,34.58064516129032
3033,1730,6220,11,6,17,64.71,0.02494117647058823,89.23529411764706
3034,22225,88275,19,11,30,63.33,0.02516,40.43333333333333
3035,6796,11204,19,14,33,57.58,0.015287878787878786,36.36363636363637
3036,3239,10911,9,6,15,60.0,0.02314,90.06666666666666
3037,3736,-11436,17,18,35,48.57,-0.008285714285714283,38.2
3038,2298,2312,22,14,36,61.11,0.013408333333333331,38.02777777777778
3040,3755,29345,19,6,25,76.0,0.055908,45.8
3041,7679,26401,41,25,66,62.12,0.023563636363636366,15.287878787878787
3042,3091,-1641,8,6,14,57.14,0.007071428571428573,79.85714285714286
3043,3523,-623,40,33,73,54.79,0.005023287671232877,13.876712328767123
3044,9596,47354,18,9,27,66.67,0.031070370370370366,58.370370370370374
3045,4379,65721,7,0,7,100.0,0.09475714285714285,294.0
3046,3096,14984,27,20,47,57.45,0.06779148936170212,26.97872340425532
3047,2147,9743,21,10,31,67.74,0.035074193548387096,27.419354838709676
3048,2200,6650,17,8,25,68.0,0.025808,48.36
3049,2816,5024,28,18,46,60.87,0.018191304347826093,20.17391304347826
3050,1781,7149,18,10,28,64.29,0.033492857142857144,45.07142857142857
3051,2541,59,26,24,51,50.98,0.0020921568627450975,20.058823529411764
3052,1440,10650,15,5,20,75.0,0.056755,66.25
3054,4968,19152,30,18,48,62.5,0.029772916666666666,22.229166666666668
3055,4294,10856,26,16,42,61.9,0.022888095238095235,36.26190476190476
3056,3508,5092,16,13,29,55.17,0.017565517241379308,43.51724137931034
3057,2985,8465,23,21,44,52.27,0.02920681818181818,31.363636363636363
3058,2704,15046,23,15,38,60.53,0.037302631578947365,32.05263157894737
3059,4799,16551,26,12,38,68.42,0.02865,29.55263157894737
3060,7740,-6740,36,32,68,52.94,0.000957352941176474,23.08823529411765
3062,3805,17545,26,12,38,68.42,0.03195526315789473,24.973684210526315
3090,3115,6435,13,8,21,61.9,0.017504761904761905,75.0
3094,3143,10257,20,8,28,71.43,0.023725,40.0
3130,13231,152669,15,2,17,88.24,0.07781176470588236,89.11764705882354
3138,2014,9056,19,11,30,63.33,0.043093333333333324,25.666666666666668
3149,9487,22333,42,34,76,55.26,0.02447894736842105,17.5
3164,5201,13999,23,15,38,60.53,0.02148157894736842,36.5
3167,5523,23777,17,11,28,60.71,0.029125,43.607142857142854
3189,19029,89271,34,19,53,64.15,0.026383018867924525,24.20754716981132
3209,2331,2819,11,9,20,55.0,0.011879999999999998,81.2
3229,3708,-4778,22,29,51,43.14,0.009621568627450977,25.45098039215686
3231,3923,20777,21,9,30,70.0,0.03423666666666667,40.233333333333334
3257,11162,63088,27,13,40,67.5,0.0397175,28.275
3266,1862,11788,17,6,23,73.91,0.04555652173913044,67.82608695652173
3296,3418,15232,24,14,38,63.16,0.029792105263157898,30.842105263157894
3305,3791,29259,18,8,26,69.23,0.05182692307692308,46.11538461538461
3308,1790,9120,19,11,30,63.33,0.049449999999999994,37.333333333333336
3311,4493,18207,18,13,31,58.06,0.03693548387096774,44.645161290322584
3312,1411,2599,12,9,21,57.14,0.00945238095238095,44.42857142857143
3321,2214,7716,17,13,30,56.67,0.029289999999999997,17.6
3338,6438,18162,23,18,41,56.1,0.01923658536585366,24.365853658536587
3346,10158,15992,23,23,46,50.0,0.013749999999999997,18.23913043478261
3356,11266,-6666,32,32,64,50.0,0.004625000000000003,25.046875
3376,13482,18518,18,11,29,62.07,0.013575862068965518,40.89655172413793
3380,3584,19616,23,10,33,69.7,0.03720909090909091,32.15151515151515
3383,4703,1047,39,51,90,43.33,0.027602222222222226,15.377777777777778
3406,49300,-70150,39,38,77,50.65,0.0010545454545454577,17.792207792207794
3413,21898,104902,21,13,34,61.76,0.0277764705882353,19.823529411764707
3416,4455,58745,13,1,14,92.86,0.08373571428571427,81.0
3419,3022,14448,24,11,35,68.57,0.030791428571428574,29.571428571428573
3432,1966,6904,17,9,26,65.38,0.030392307692307694,39.19230769230769
3437,5710,-10910,25,24,49,51.02,-0.005765306122448979,21.959183673469386
3443,13021,10879,17,11,28,60.71,0.012807142857142855,53.107142857142854
3450,18127,-577,28,17,45,62.22,0.011062222222222223,22.288888888888888
3454,11191,36909,15,9,24,62.5,0.02415416666666666,49.5
3481,2482,16588,26,9,35,74.29,0.041800000000000004,30.97142857142857
3494,3339,-3609,28,31,59,47.46,0.00021355932203390114,26.23728813559322
3501,5161,19639,13,6,19,68.42,0.026684210526315796,57.0
3504,13886,8164,28,21,49,57.14,0.002185714285714285,24.591836734693878
3515,8694,55556,16,6,22,72.73,0.03545000000000001,52.40909090909091
3518,9402,-23152,31,32,63,49.21,-0.005936507936507939,22.41269841269841
3528,3350,24200,13,5,18,72.22,0.043611111111111114,78.66666666666667
3530,9811,65969,23,15,38,60.53,0.03798947368421052,31.42105263157895
3532,12666,19034,28,24,52,53.85,0.011532692307692308,27.26923076923077
3533,30448,-26248,23,24,47,48.94,0.0002765957446808501,31.4468085106383
3535,3097,-637,19,23,42,45.24,0.009183333333333335,26.738095238095237
3536,4085,19975,45,23,68,66.18,0.03950147058823529,15.058823529411764
3543,1626,3184,13,9,22,59.09,0.018054545454545455,37.5
3545,7911,41289,25,15,40,62.5,0.03293,21.725
3550,1893,3787,16,7,23,69.57,0.015886956521739132,54.391304347826086
3557,3003,-2763,25,25,50,50.0,-0.000726,25.84
3563,10732,25668,20,13,33,60.61,0.018209090909090907,45.78787878787879
3576,4180,3540,30,27,57,52.63,0.010059649122807018,23.157894736842106
3583,8500,86150,20,7,27,74.07,0.06422592592592592,30.48148148148148
3588,6448,19952,22,14,36,61.11,0.024561111111111113,33.44444444444444
3591,6041,3999,34,24,58,58.62,0.009444827586206898,23.620689655172413
3593,2643,5927,21,19,40,52.5,0.021330000000000002,28.55
3596,10829,23271,29,18,47,61.7,0.01675744680851064,29.02127659574468
3605,4337,4863,18,12,30,60.0,0.01374666666666667,36.36666666666667
3607,6369,-12299,31,29,60,51.67,-0.0012533333333333335,26.1
3617,10209,48691,16,9,25,64.0,0.029324,50.4
3622,6783,14957,31,22,53,58.49,0.01712641509433963,24.92452830188679
3645,8728,13022,27,20,47,57.45,0.012348936170212767,23.78723404255319
3653,20426,-44876,24,27,51,47.06,-0.006513725490196077,28.215686274509803
3661,16362,15138,32,24,56,57.14,0.013103571428571426,15.803571428571429
3665,45219,159031,41,21,62,66.13,0.03131612903225806,18.0
3669,2981,27019,19,7,26,73.08,0.06028076923076923,41.15384615384615
3673,15171,19429,29,21,50,58.0,0.008402,31.1
3679,9112,5688,18,14,32,56.25,0.007846875,35.0625
3682,2192,-292,19,16,35,54.29,0.00889142857142857,42.22857142857143
3686,3216,7344,28,26,54,51.85,0.033792592592592596,23.22222222222222
3694,5313,8187,33,21,54,61.11,0.016309259259259253,19.574074074074073
3701,1968,4862,17,15,32,53.12,0.03285625,44.71875
3702,2868,9282,9,5,14,64.29,0.02285,98.35714285714286
3703,920,2000,8,5,13,61.54,0.016723076923076927,137.23076923076923
3704,2606,18574,22,8,30,73.33,0.05059,31.2
3705,2831,12419,7,4,11,63.64,0.031372727272727274,186.8181818181818
3706,3626,2574,14,10,24,58.33,0.009258333333333328,45.333333333333336
3708,9025,34275,12,7,19,63.16,0.025205263157894738,26.157894736842106
3711,4513,-17313,6,6,12,50.0,-0.014366666666666661,28.25
3712,1168,-5068,6,6,12,50.0,-0.016549999999999995,33.75
3714,1093,-13293,1,2,3,33.33,-0.0646,29.333333333333332
4104,4149,20851,10,4,14,71.43,0.030264285714285716,68.07142857142857
4106,5599,13801,18,16,34,52.94,0.017361764705882347,43.205882352941174
4108,6398,-98,23,25,48,47.92,0.006947916666666667,30.229166666666668
4119,9723,35877,16,8,24,66.67,0.026866666666666664,56.666666666666664
4133,4738,24612,14,8,22,63.64,0.04387727272727272,57.59090909090909
4137,44046,-104146,23,23,46,50.0,-0.009158695652173914,23.67391304347826
4142,6843,14257,23,16,39,58.97,0.024402564102564105,30.974358974358974
4155,4189,6101,15,11,26,57.69,0.013753846153846153,38.76923076923077
4164,5428,-6178,13,11,24,54.17,-0.0018875000000000048,64.83333333333333
4190,6928,29772,11,5,16,68.75,0.0281625,42.875
4306,2799,6441,21,12,33,63.64,0.01917878787878788,47.0
4414,3039,-11239,18,23,41,43.9,-0.019302439024390244,30.975609756097562
4426,12218,2882,31,22,53,58.49,0.007173584905660379,21.962264150943398
4438,12271,57229,12,5,17,70.59,0.0320764705882353,43.0
4439,6910,21590,6,3,9,66.67,0.022366666666666667,29.0
4526,2280,-2580,13,11,24,54.17,0.002741666666666663,71.45833333333333
4532,2917,7633,14,9,23,60.87,0.017956521739130437,69.04347826086956
4536,16114,57086,16,8,24,66.67,0.026816666666666666,48.625
4540,4299,85631,10,11,21,47.62,0.14624761904761904,56.333333333333336
4545,4816,22584,18,11,29,62.07,0.03337586206896552,35.6551724137931
4551,21457,122743,21,10,31,67.74,0.03561935483870968,20.129032258064516
4552,4357,-9357,11,11,22,50.0,-0.0020545454545454517,44.54545454545455
4555,5580,7920,11,7,18,61.11,0.013033333333333334,53.333333333333336
4557,2327,9573,4,2,6,66.67,0.029166666666666664,173.16666666666666
4560,2024,-4624,3,5,8,37.5,-0.009462499999999997,114.0
4562,3372,-16072,8,18,26,30.77,-0.018000000000000002,40.96153846153846
4564,3625,10575,10,6,16,62.5,0.023037500000000002,11.5625
4566,3676,12174,10,5,15,66.67,0.024359999999999996,37.4
4571,4656,23044,7,6,13,53.85,0.03294615384615385,23.153846153846153
4572,5953,48347,8,3,11,72.73,0.04819090909090909,31.90909090909091
4576,4305,48395,6,4,10,60.0,0.09197999999999999,27.9
4581,597,-1297,1,2,3,33.33,-0.012066666666666665,112.66666666666667
4720,1665,11935,15,5,20,75.0,0.047045,63.35
4722,2645,15655,12,5,17,70.59,0.040476470588235294,63.05882352941177
4737,6819,62731,15,6,21,71.43,0.05919047619047618,58.23809523809524
4739,12168,6332,30,20,50,60.0,0.015109999999999997,28.68
4746,14754,-10054,23,26,49,46.94,0.004648979591836733,31.20408163265306
4755,3461,25639,13,5,18,72.22,0.0404,69.22222222222223
4763,14555,71745,14,7,21,66.67,0.03824761904761905,34.476190476190474
4764,3593,-4493,5,5,10,50.0,-0.00030000000000000024,79.6
4766,6713,-3713,5,4,9,55.56,0.003444444444444446,50.44444444444444
4807,3295,-3795,12,9,21,57.14,0.00016190476190476523,43.80952380952381
4904,2859,44341,7,0,7,100.0,0.09752857142857144,178.14285714285714
4906,4639,19111,25,13,38,65.79,0.02281578947368421,27.81578947368421
4912,18263,28137,26,17,43,60.47,0.014967441860465116,34.372093023255815
4915,7414,39486,22,11,33,66.67,0.03448787878787878,37.24242424242424
4916,6452,19998,26,17,43,60.47,0.02766046511627907,24.209302325581394
4919,6444,9806,22,15,37,59.46,0.011954054054054055,36.027027027027025
4927,5442,34208,21,8,29,72.41,0.038251724137931035,39.3448275862069
4930,1556,5114,13,8,21,61.9,0.03026666666666667,57.57142857142857
4934,4366,20834,33,27,60,55.0,0.028913333333333333,20.333333333333332
4935,5490,-5990,14,11,25,56.0,0.0006279999999999991,54.08
4938,7284,42916,16,7,23,69.57,0.03730434782608696,47.43478260869565
4942,4716,17884,19,10,29,65.52,0.02177586206896552,49.44827586206897
4943,20461,-99161,19,30,49,38.78,-0.021671428571428567,14.857142857142858
4952,4238,21112,17,7,24,70.83,0.036925,39.958333333333336
4956,5328,932,31,25,56,55.36,0.006773214285714291,19.285714285714285
4958,9480,65620,15,6,21,71.43,0.04701904761904761,43.142857142857146
4960,4976,-5036,36,35,71,50.7,-0.0006985915492957745,20.492957746478872
4961,5415,-7995,15,15,30,50.0,0.0033199999999999983,49.03333333333333
4967,2749,-4119,13,20,33,39.39,-0.009839393939393933,27.484848484848484
4968,17911,32139,25,16,41,60.98,0.020741463414634145,16.463414634146343
4976,6589,6461,28,20,48,58.33,0.015047916666666666,24.291666666666668
4977,16065,-15165,21,20,41,51.22,-0.0005219512195121964,28.317073170731707
4989,2062,13068,15,14,29,51.72,0.07092068965517241,22.03448275862069
4994,21382,20318,34,22,56,60.71,0.013475000000000003,24.571428571428573
4999,6321,34279,17,8,25,68.0,0.0378,56.6
5007,2358,16042,6,2,8,75.0,0.046725,156.0
5203,8908,73492,14,5,19,73.68,0.054010526315789474,64.52631578947368
5215,6119,9481,18,13,31,58.06,0.015029032258064517,35.45161290322581
5225,7283,-11933,26,22,48,54.17,0.001206249999999999,27.5625
5234,9721,-11321,18,18,36,50.0,-0.0028555555555555595,41.666666666666664
5243,3668,5332,11,7,18,61.11,0.02005555555555556,54.22222222222222
5258,4795,34005,21,11,32,65.62,0.041328125,21.03125
5269,85851,103599,49,42,91,53.85,0.014469230769230767,12.956043956043956
5283,2650,5340,7,6,13,53.85,0.019276923076923077,82.61538461538461
5284,5456,-13006,12,10,22,54.55,-0.006740909090909089,60.90909090909091
5285,4842,23708,13,7,20,65.0,0.025865,57.65
5288,11437,84263,18,6,24,75.0,0.04351666666666667,36.375
5388,6169,40081,13,5,18,72.22,0.04513888888888889,58.111111111111114
5434,6084,37816,13,5,18,72.22,0.03690555555555556,76.88888888888889
5469,2896,-2626,20,18,38,52.63,-0.00019210526315789587,36.8421052631579
5471,4046,35354,14,4,18,77.78,0.060994444444444434,65.33333333333333
5484,1829,7451,18,12,30,60.0,0.04049666666666667,36.5
5515,1231,7699,13,4,17,76.47,0.04075294117647059,77.94117647058823
5519,2766,8134,19,10,29,65.52,0.02413103448275862,51.724137931034484
5521,2903,47,23,20,43,53.49,0.00374186046511628,31.093023255813954
5522,4355,33545,14,5,19,73.68,0.044194736842105266,47.0
5525,1815,5085,10,7,17,58.82,0.018129411764705883,99.82352941176471
5531,3190,8450,24,17,41,58.54,0.024468292682926832,29.78048780487805
5533,672,4178,5,2,7,71.43,0.03837142857142856,255.42857142857142
5534,9806,-4056,14,14,28,50.0,0.005532142857142856,56.535714285714285
5538,2072,18928,9,3,12,75.0,0.057716666666666666,94.41666666666667
5546,2173,-31873,0,6,6,0.0,-0.07923333333333334,54.5
5607,2429,8721,13,9,22,59.09,0.022368181818181815,64.31818181818181
5608,2979,10041,23,18,41,56.1,0.026031707317073174,44.5609756097561
5706,6779,17571,18,13,31,58.06,0.020167741935483867,49.54838709677419
5871,11817,-1117,16,14,30,53.33,0.006546666666666665,51.2
5876,1828,11732,6,3,9,66.67,0.03587777777777777,163.55555555555554
5880,601,-901,4,3,7,57.14,-0.0032000000000000045,235.14285714285714
5906,3412,-5642,25,34,60,41.67,0.027318333333333333,20.983333333333334
5907,4369,-5619,16,16,32,50.0,0.0016000000000000007,39.0625
6005,1039,2431,10,5,15,66.67,0.020713333333333337,80.26666666666667
6024,1412,16838,7,1,8,87.5,0.072575,218.5
6108,3435,9515,18,13,31,58.06,0.01560645161290323,45.54838709677419
6112,2875,19725,12,4,16,75.0,0.043843749999999994,87.125
6115,3462,21538,10,5,15,66.67,0.03876,154.26666666666668
6116,3218,10402,37,19,56,66.07,0.02800714285714286,18.928571428571427
6117,1678,9572,13,7,20,65.0,0.039795000000000004,62.65
6120,3484,-4664,24,22,46,52.17,-0.002073913043478263,26.23913043478261
6128,2132,118,6,6,12,50.0,0.008691666666666662,105.0
6133,1109,4971,12,5,17,70.59,0.038064705882352945,76.29411764705883
6136,1567,433,7,7,14,50.0,0.006457142857142863,147.64285714285714
6139,4514,26686,21,10,31,67.74,0.03484193548387096,37.67741935483871
6141,1904,5356,15,11,26,57.69,0.021373076923076925,57.96153846153846
6142,2554,6096,28,15,43,65.12,0.022565116279069767,30.441860465116278
6152,4570,-1690,39,32,71,54.93,0.0029943661971830993,20.464788732394368
6153,6265,13235,26,17,43,60.47,0.0196046511627907,23.790697674418606
6155,2404,20596,14,6,20,70.0,0.05900999999999999,63.05
6164,2284,6206,21,12,33,63.64,0.02302121212121212,37.45454545454545
6165,3939,17101,34,20,54,62.96,0.03470370370370371,19.62962962962963
6166,9392,13758,20,14,34,58.82,0.014067647058823528,38.029411764705884
6168,2962,-732,22,17,39,56.41,0.003956410256410254,28.512820512820515
6172,6123,4747,57,46,103,55.34,0.016428155339805826,10.844660194174757
6176,14293,19057,18,12,30,60.0,0.01524,36.43333333333333
6177,3393,7907,14,8,22,63.64,0.0197,64.5909090909091
6183,2696,8404,10,7,17,58.82,0.02488823529411765,90.6470588235294
6184,2113,16837,7,2,9,77.78,0.05121111111111111,184.77777777777777
6189,2448,13452,10,4,14,71.43,0.034864285714285716,111.28571428571429
6191,1789,5191,17,10,27,62.96,0.023422222222222226,51.2962962962963
6192,6070,12630,11,7,18,61.11,0.014083333333333337,72.61111111111111
6196,4785,17765,22,13,35,62.86,0.02516285714285714,43.114285714285714
6197,3445,27055,16,5,21,76.19,0.05009523809523809,51.42857142857143
6201,1592,5458,6,4,10,60.0,0.022539999999999998,170.0
6202,7887,20113,18,10,28,64.29,0.020939285714285716,52.57142857142857
6205,2989,14461,15,7,22,68.18,0.034949999999999995,50.63636363636363
6206,4051,-31951,4,6,10,40.0,-0.03643999999999999,138.3
6209,7590,10160,33,27,60,55.0,0.011718333333333332,22.533333333333335
6213,3673,9077,13,10,23,56.52,0.014460869565217393,64.47826086956522
6214,12914,21936,25,15,40,62.5,0.020689999999999997,33.925
6215,2835,9215,22,12,34,64.71,0.027752941176470588,36.44117647058823
6216,2030,21720,12,2,14,85.71,0.06980714285714286,65.14285714285714
6224,4892,41508,11,3,14,78.57,0.05397857142857143,77.07142857142857
6225,3875,5525,38,40,78,48.72,0.021546153846153843,14.243589743589743
6226,2821,2589,27,20,47,57.45,0.013774468085106385,29.851063829787233
6230,24928,-19028,29,24,53,54.72,0.0054924528301886774,25.22641509433962
6235,3035,11125,28,16,44,63.64,0.02675454545454545,27.204545454545453
6239,9516,49584,19,8,27,70.37,0.03174814814814814,51.2962962962963
6243,2919,3441,22,18,40,55.0,0.015642500000000004,26.45
6251,1727,9833,17,7,24,70.83,0.04280416666666667,48.083333333333336
6257,3426,10924,14,8,22,63.64,0.02360909090909091,56.59090909090909
6269,17721,57279,21,13,34,61.76,0.025641176470588233,40.470588235294116
6271,26529,105071,26,16,42,61.9,0.02444047619047619,23.333333333333332
6277,10205,64145,18,6,24,75.0,0.04457083333333334,69.95833333333333
6278,4399,-6499,11,9,20,55.0,0.0003449999999999995,75.1
6281,2920,5080,5,3,8,62.5,0.015287499999999996,235.5
6282,3064,25586,18,6,24,75.0,0.05369166666666666,41.75
6283,5242,16838,33,29,62,53.23,0.010054838709677423,22.661290322580644
6285,9871,54079,19,8,27,70.37,0.03435925925925926,32.81481481481482
6288,2405,-535,19,19,38,50.0,0.005886842105263152,33.31578947368421
6289,3951,1969,36,51,87,41.38,0.01810919540229885,14.632183908045977
6405,5558,3852,23,18,41,56.1,0.007063414634146338,24.024390243902438
6409,61526,318974,20,7,27,74.07,0.038511111111111114,39.148148148148145
6412,4758,3192,11,9,20,55.0,0.010770000000000002,56.55
6414,57111,57389,25,16,41,60.98,0.014243902439024392,19.658536585365855
6415,77103,387897,26,12,38,68.42,0.03422894736842105,23.894736842105264
6416,13622,73668,19,12,31,61.29,0.038225806451612915,27.322580645161292
6431,3497,-4477,21,22,43,48.84,0.0010976744186046512,20.930232558139537
6438,7094,-9544,11,9,20,55.0,0.00024000000000000133,22.8
6442,4750,6600,12,11,23,52.17,0.013826086956521742,47.91304347826087
6443,1512,128,10,13,23,43.48,0.029234782608695647,31.347826086956523
6449,5902,648,21,13,34,61.76,0.01094705882352941,24.235294117647058
6451,17263,67637,21,13,34,61.76,0.027100000000000003,17.529411764705884
6456,15343,38957,16,12,28,57.14,0.01749285714285714,36.17857142857143
6464,4405,-12805,3,4,7,42.86,-0.017342857142857142,136.14285714285714
6477,2495,8755,14,7,21,66.67,0.023961904761904757,27.142857142857142
6491,6962,39908,6,7,13,46.15,0.03920769230769231,115.07692307692308
6504,18981,56019,13,10,23,56.52,0.02233913043478261,47.08695652173913
6505,10055,25045,12,9,21,57.14,0.015433333333333339,75.9047619047619
6515,9010,57990,3,1,4,75.0,0.038425,10.25
6525,6238,-4688,9,9,18,50.0,0.0017000000000000025,39.05555555555556
6531,8224,26476,11,7,18,61.11,0.032855555555555555,27.833333333333332
6533,20272,-41972,15,15,30,50.0,-0.002236666666666669,14.7
6541,17002,-16602,27,28,55,49.09,0.006836363636363639,16.21818181818182
6552,6948,-10298,12,11,23,52.17,0.008056521739130436,22.0
6558,4108,2292,14,9,23,60.87,0.018156521739130432,46.52173913043478
6573,6175,2225,26,26,52,50.0,0.007284615384615384,13.48076923076923
6579,4515,7985,6,5,11,54.55,0.017672727272727277,90.9090909090909
6581,4953,3897,8,5,13,61.54,0.0133923076923077,49.61538461538461
6582,6971,-19271,8,9,17,47.06,-0.012158823529411764,45.88235294117647
6591,6316,17234,14,8,22,63.64,0.02431363636363636,27.045454545454547
6592,986,9914,2,0,2,100.0,0.061799999999999994,132.5
6598,5295,12005,12,10,22,54.55,0.013777272727272728,13.045454545454545
6605,8709,-10409,12,13,25,48.0,0.0014319999999999977,65.48
6625,2781,-12631,6,9,15,40.0,-0.01710666666666667,49.733333333333334
6641,2093,3107,3,3,6,50.0,0.01018333333333333,53.666666666666664
6655,1902,-19052,2,6,8,25.0,-0.0505125,52.5
6666,5827,-23427,5,8,13,38.46,-0.018346153846153845,35.46153846153846
6668,4283,10717,8,6,14,57.14,0.012542857142857146,21.0
6669,35757,200243,8,2,10,80.0,0.04019,23.2
6670,6971,44029,5,2,7,71.43,0.03851428571428571,39.42857142857143
6671,1352,3548,3,3,6,50.0,0.021816666666666675,107.0
6672,2453,16947,4,1,5,80.0,0.051660000000000005,37.2
6674,2372,-472,9,7,16,56.25,0.008643750000000002,28.6875
6698,1344,-8644,2,4,6,33.33,-0.02808333333333333,29.166666666666668
6706,7115,-5115,4,4,8,50.0,-0.00145,6.5
6715,3466,33034,4,1,5,80.0,0.061919999999999996,17.0
6743,4786,-8136,7,6,13,53.85,-0.006761538461538459,16.692307692307693
6754,774,8276,3,0,3,100.0,0.06886666666666666,45.0
6756,6149,111851,3,0,3,100.0,0.12760000000000002,6.666666666666667
8011,5914,6986,33,23,56,58.93,0.011649999999999997,24.142857142857142
8016,13390,99460,23,8,31,74.19,0.04766774193548388,40.483870967741936
8021,2346,11854,14,6,20,70.0,0.03409,63.4
8028,6337,763,20,21,41,48.78,0.008587804878048782,30.024390243902438
8033,2500,12410,25,11,36,69.44,0.04145277777777778,28.22222222222222
8039,6870,50330,21,7,28,75.0,0.046150000000000004,40.142857142857146
8046,6280,32270,18,11,29,62.07,0.034886206896551725,26.310344827586206
8070,14545,21605,25,15,40,62.5,0.0136075,39.55
8072,3493,10307,14,9,23,60.87,0.026169565217391298,70.65217391304348
8081,12180,59370,17,9,26,65.38,0.03046153846153846,45.15384615384615
8101,4055,-7055,33,46,79,41.77,-0.01954936708860759,19.367088607594937
8103,5477,50023,24,8,32,75.0,0.054784375,35.59375
8104,9675,26475,15,13,28,53.57,0.022667857142857135,19.214285714285715
8105,2499,6261,21,13,34,61.76,0.024611764705882357,21.764705882352942
8110,2638,7522,24,14,38,63.16,0.025797368421052635,35.39473684210526
8112,3507,9913,24,13,37,64.86,0.02111621621621622,40.972972972972975
8114,12921,-58621,10,13,23,43.48,-0.009995652173913043,64.95652173913044
8131,3315,-415,16,11,27,59.26,0.005707407407407407,55.96296296296296
8150,2732,33168,13,3,16,81.25,0.07028125,30.75
8163,5101,-301,24,19,43,55.81,0.002793023255813956,35.02325581395349
8201,2918,5702,25,17,42,59.52,0.01784761904761905,32.76190476190476
8210,6132,10568,13,10,23,56.52,0.014391304347826085,52.56521739130435
8213,4037,8063,12,8,20,60.0,0.015624999999999995,69.2
8215,3803,-1303,21,18,39,53.85,0.003912820512820515,28.53846153846154
8222,2283,4767,15,11,26,57.69,0.017038461538461537,43.03846153846154
8249,1825,8575,12,5,17,70.59,0.03671176470588236,75.0
8261,5105,17335,28,15,43,65.12,0.029988372093023248,24.348837209302324
8271,4259,13541,16,12,28,57.14,0.020749999999999998,50.964285714285715
8341,26730,100070,19,11,30,63.33,0.022693333333333336,30.3
8367,543,4307,3,1,4,75.0,0.0517,90.0
8374,4641,19619,30,16,46,65.22,0.022293478260869568,23.5
8404,7363,14287,27,20,47,57.45,0.0195,32.170212765957444
8411,3605,-9155,21,19,40,52.5,-0.006342499999999999,35.875
8422,15059,55941,10,6,16,62.5,0.0237,96.375
8429,4471,-26621,21,30,51,41.18,-0.021864705882352946,30.647058823529413
8442,3732,2468,6,8,14,42.86,0.009650000000000002,61.714285714285715
8443,1303,-1933,10,8,18,55.56,-0.003966666666666667,71.61111111111111
8454,17780,-49780,7,7,14,50.0,-0.0075071428571428555,76.5
8462,15578,53122,14,7,21,66.67,0.0273047619047619,32.333333333333336
8463,2543,11307,11,9,20,55.0,0.031275,43.85
8464,39532,285468,18,6,24,75.0,0.048854166666666664,20.833333333333332
8466,3853,3497,7,5,12,58.33,0.0012333333333333326,76.25
8467,3288,2462,8,8,16,50.0,0.009181249999999997,65.25
8473,3581,-15681,6,9,15,40.0,-0.019313333333333335,62.733333333333334
8478,24078,154572,34,17,51,66.67,0.04121176470588235,16.41176470588235
8480,6309,-8809,5,5,10,50.0,-0.012949999999999995,77.0
8481,2814,18036,8,2,10,80.0,0.04209,54.2
8482,3956,-17856,3,5,8,37.5,-0.020462499999999998,72.5
8488,2086,11714,16,6,22,72.73,0.03902727272727272,31.0
8499,10298,37702,12,7,19,63.16,0.027615789473684215,25.526315789473685
8926,1747,9103,9,4,13,69.23,0.03413076923076923,132.76923076923077
8940,2670,-3390,18,16,34,52.94,0.0007705882352941162,49.05882352941177
8996,10196,45604,25,11,36,69.44,0.03321388888888889,26.305555555555557
9802,9714,60536,25,10,35,71.43,0.03601142857142857,32.82857142857143
9902,1685,9565,17,7,24,70.83,0.04359166666666667,49.625
9904,3177,11973,12,5,17,70.59,0.025052941176470587,75.0
9905,1856,2944,7,6,13,53.85,0.014346153846153845,125.53846153846153
9906,5488,52352,29,12,41,70.73,0.059263414634146326,22.51219512195122
9907,1873,307,14,10,24,58.33,0.007574999999999999,63.333333333333336
9908,674,5976,4,1,5,80.0,0.057420000000000006,361.0
9910,23698,186302,28,8,36,77.78,0.05178333333333333,27.333333333333332
9911,3922,20828,19,9,28,67.86,0.03309642857142857,52.714285714285715
9912,2030,2140,15,16,31,48.39,0.015038709677419352,42.03225806451613
9914,36750,209750,30,9,39,76.92,0.04376923076923077,26.23076923076923
9917,2736,24064,5,1,6,83.33,0.05971666666666667,343.0
9918,1189,15411,6,0,6,100.0,0.08013333333333333,327.1666666666667
9919,1014,5296,7,5,12,58.33,0.03725833333333334,102.75
9921,35536,53464,20,14,34,58.82,0.011438235294117645,43.76470588235294
9924,3484,21166,13,5,18,72.22,0.04237222222222222,80.0
9925,1753,12597,6,2,8,75.0,0.0469,282.375
9926,1970,11930,6,2,8,75.0,0.0394125,247.0
9927,2189,21311,9,3,12,75.0,0.059491666666666665,121.91666666666667
9928,2272,6418,21,20,41,51.22,0.020817073170731712,38.073170731707314
9929,1706,17924,20,5,25,80.0,0.081392,62.24
9930,2213,-1013,4,4,8,50.0,0.002450000000000001,260.875
9931,2383,27517,11,1,12,91.67,0.07058333333333335,149.08333333333334
9933,4348,14202,12,7,19,63.16,0.02366842105263157,77.63157894736842
9934,2543,6257,19,11,30,63.33,0.018719999999999994,49.03333333333333
9935,2864,2026,23,19,42,54.76,0.011899999999999999,34.095238095238095
9937,1403,9247,5,2,7,71.43,0.04152857142857143,326.57142857142856
9938,12531,44969,28,16,44,63.64,0.03615227272727273,27.113636363636363
9939,5165,50685,12,4,16,75.0,0.05935,57.875
9940,2934,12716,11,6,17,64.71,0.03132941176470588,90.6470588235294
9941,4897,37803,8,3,11,72.73,0.05207272727272727,142.45454545454547
9942,5482,47718,11,3,14,78.57,0.05506428571428572,109.71428571428571
9943,5230,35220,13,6,19,68.42,0.039121052631578945,97.36842105263158
9944,3284,7566,18,10,28,64.29,0.018175,55.892857142857146
9945,6842,35808,19,10,29,65.52,0.03317931034482759,36.96551724137931
9946,2777,6093,19,12,31,61.29,0.020370967741935486,33.61290322580645
9955,3489,33461,27,6,33,81.82,0.059912121212121215,34.484848484848484
9958,1472,928,12,8,20,60.0,0.009729999999999999,85.7
1312A,839,7961,5,1,6,83.33,0.060633333333333324,290.1666666666667
2002A,953,2597,3,1,4,75.0,0.020275,555.5
2836A,138,962,1,0,1,100.0,0.0422,350.0
2838A,311,1289,1,0,1,100.0,0.0248,1346.0
2881A,370,-570,0,1,1,0.0,-0.009,1393.0
2881B,361,839,1,0,1,100.0,0.0138,1366.0
2882A,365,-165,0,1,1,0.0,-0.0027,1071.0
2882B,364,336,1,0,1,100.0,0.0054,1074.0
2887E,311,1389,1,0,1,100.0,0.0268,1436.0
2887F,298,1002,1,0,1,100.0,0.02,812.0
2888A,249,-1199,0,1,1,0.0,-0.0278,423.0
2888B,245,1605,1,0,1,100.0,0.0396,315.0
2891B,368,-268,0,1,1,0.0,-0.0043,1297.0
2891C,357,1643,1,0,1,100.0,0.0276,812.0
2897A,209,71,1,2,3,33.33,0.004766666666666665,259.6666666666667
3702A,288,2662,1,0,1,100.0,0.0566,793.0
5871A,0,0,0,0,0,0.0,,
9941A,609,2891,1,1,2,50.0,0.03125,385.0
1240,3246,12004,8,4,12,66.67,0.027808333333333334,29.75
1258,5932,-4402,28,22,50,56.0,0.008364,33.26
1259,2542,22458,4,2,6,66.67,0.05523333333333333,278.5
1264,10644,85856,7,2,9,77.78,0.053566666666666665,117.22222222222223
1268,6561,24439,6,3,9,66.67,0.024677777777777774,110.77777777777777
1336,2438,5332,22,12,34,64.71,0.015582352941176469,38.705882352941174
1565,100928,81572,22,21,43,51.16,0.004290697674418606,32.395348837209305
1569,6123,11407,33,20,53,62.26,0.016971698113207548,22.528301886792452
1570,1565,7145,15,6,21,71.43,0.03743333333333333,75.0
1580,17904,39496,17,12,29,58.62,0.014396551724137932,57.41379310344828
1584,3093,11727,26,17,43,60.47,0.026025581395348833,33.48837209302326
1586,6686,21864,25,17,42,59.52,0.024997619047619043,30.523809523809526
1591,6740,-6740,27,25,52,51.92,0.0026076923076923044,30.326923076923077
1593,4313,52787,19,2,21,90.48,0.0725952380952381,57.80952380952381
1595,8967,-27317,19,21,40,47.5,-0.005250000000000002,40.975
1599,6782,44518,20,9,29,68.97,0.04167931034482757,48.03448275862069
1742,3325,5555,20,17,37,54.05,0.017305405405405407,27.35135135135135
1752,2741,18309,9,4,13,69.23,0.04653846153846153,96.92307692307692
1777,8533,38367,15,7,22,68.18,0.03351818181818182,85.5909090909091
1781,7831,10699,39,40,79,49.37,0.016984810126582275,19.341772151898734
1784,6082,49868,21,8,29,72.41,0.05316551724137931,33.37931034482759
1785,3823,197,18,15,33,54.55,0.006303030303030302,49.36363636363637
1788,6913,48787,9,4,13,69.23,0.048946153846153855,111.3076923076923
1796,4698,-5248,12,13,25,48.0,0.0023920000000000018,33.16
1799,5158,26772,33,24,57,57.89,0.03466140350877193,18.92982456140351
1813,2912,-1812,12,10,22,54.55,0.0023409090909090905,75.63636363636364
1815,3147,1983,24,18,42,57.14,0.009071428571428569,33.404761904761905
2035,2301,12699,8,3,11,72.73,0.04103636363636364,187.36363636363637
2061,3243,4767,22,18,40,55.0,0.00984,34.075
2063,4724,14826,17,13,30,56.67,0.024063333333333336,44.5
2064,1392,4208,9,7,16,56.25,0.0175125,66.0625
2065,2207,12543,7,4,11,63.64,0.03686363636363637,70.36363636363636
2066,10225,-34775,13,14,27,48.15,-0.011925925925925925,56.77777777777778
2067,2492,-1812,17,16,33,51.52,0.00664545454545454,38.75757575757576
2070,3517,26233,12,7,19,63.16,0.05178947368421053,36.68421052631579
2221,4577,7323,25,19,44,56.82,0.015734090909090906,33.31818181818182
2230,3663,12077,23,18,41,56.1,0.025236585365853652,29.5609756097561
2235,6591,2559,12,9,21,57.14,0.00752857142857143,56.95238095238095
2596,1609,8641,10,6,16,62.5,0.034868750000000004,87.5625
2640,8246,28304,14,8,22,63.64,0.02561818181818182,58.18181818181818
2641,1241,-1101,11,9,20,55.0,-0.00025000000000000163,44.3
2643,3453,-7103,6,9,15,40.0,-0.008086666666666666,57.733333333333334
2718,5340,-10440,21,19,40,52.5,-0.0049025,43.4
2719,6888,-7928,41,59,100,41.0,0.003969000000000001,14.51
2724,4582,-2632,36,47,83,43.37,-0.003128915662650597,21.228915662650603
2726,11622,31428,21,18,39,53.85,0.012997435897435895,25.743589743589745
2729,26430,67070,13,7,20,65.0,0.019489999999999997,51.0
2732,12005,39795,14,10,24,58.33,0.022074999999999997,52.166666666666664
2734,8588,5962,34,38,72,47.22,0.006465277777777775,18.34722222222222
2736,2914,9436,19,12,31,61.29,0.024706451612903222,27.870967741935484
2740,5718,3322,22,31,53,41.51,0.01624528301886793,18.60377358490566
2743,3744,32996,19,8,27,70.37,0.05561851851851852,13.0
2745,5079,20821,19,14,33,57.58,0.022912121212121214,21.757575757575758
2752,3648,29952,4,2,6,66.67,0.04866666666666667,14.5
2754,777,-1177,1,1,2,50.0,-0.01065,63.0
2755,718,10082,2,0,2,100.0,0.08765,22.0
2916,1212,8438,8,4,12,66.67,0.04474999999999999,124.91666666666667
2924,4347,-25047,11,13,24,45.83,-0.011391666666666666,76.70833333333333
2926,7628,-97528,4,12,16,25.0,-0.0631625,101.1875
2937,1750,2800,7,6,13,53.85,0.010046153846153845,66.84615384615384
3064,7550,-6000,30,42,72,41.67,0.019430555555555548,17.958333333333332
3066,1247,9033,15,6,21,71.43,0.07467142857142857,44.857142857142854
3067,2369,4391,12,12,24,50.0,0.017520833333333333,61.0
3071,2697,4713,24,18,42,57.14,0.016219047619047616,35.11904761904762
3073,4039,11821,35,31,66,53.03,0.03694545454545453,15.06060606060606
3078,3780,8990,23,12,35,65.71,0.01944571428571428,30.97142857142857
3081,38160,-8160,15,13,28,53.57,0.0005178571428571412,28.321428571428573
3083,6850,11500,15,13,28,53.57,0.01469642857142857,20.607142857142858
3085,3724,26646,31,29,60,51.67,0.07660333333333334,13.433333333333334
3086,2946,4734,25,17,42,59.52,0.015495238095238102,22.952380952380953
3088,5643,29357,16,6,22,72.73,0.0357590909090909,57.95454545454545
3089,4791,27019,29,23,52,55.77,0.06335384615384615,17.807692307692307
3092,7431,10419,37,27,64,57.81,0.015448437500000004,21.40625
3093,3676,20074,15,5,20,75.0,0.032845,85.85
3095,2973,-653,30,31,61,49.18,0.004445901639344269,23.524590163934427
3105,13137,79163,30,16,46,65.22,0.03034565217391304,31.891304347826086
3114,2629,4221,19,13,32,59.38,0.014059375000000002,48.78125
3115,1636,15754,13,8,21,61.9,0.06607142857142857,52.76190476190476
3118,3772,9578,13,8,21,61.9,0.02086190476190476,82.85714285714286
3122,3730,5110,27,19,46,58.7,0.016300000000000002,19.32608695652174
3128,2103,17177,22,6,28,78.57,0.05855714285714286,29.178571428571427
3131,43721,156279,24,17,41,58.54,0.030090243902439025,28.48780487804878
3141,4849,23401,22,13,35,62.86,0.03217142857142857,21.97142857142857
3147,1584,3516,8,7,15,53.33,0.01979333333333333,97.53333333333333
3152,33895,292105,23,10,33,69.7,0.0539030303030303,38.78787878787879
3162,2106,-1486,17,17,34,50.0,0.0023529411764705854,39.8235294117647
3163,11091,-11541,27,21,48,56.25,0.003664583333333337,21.041666666666668
3169,5950,42700,25,9,34,73.53,0.04468823529411764,36.1764705882353
3171,2260,7220,15,10,25,60.0,0.024811999999999997,58.56
3176,25114,-25064,38,37,75,50.67,-0.0005133333333333349,20.88
3178,5598,11762,33,22,55,60.0,0.021201818181818183,20.745454545454546
3188,3486,20444,29,17,46,63.04,0.041278260869565216,29.52173913043478
3191,4014,9236,29,19,48,60.42,0.019485416666666665,20.125
3202,3663,4037,31,23,54,57.41,0.011890740740740738,24.703703703703702
3205,15807,1893,32,30,62,51.61,0.01516290322580645,19.193548387096776
3206,3703,29097,21,9,30,70.0,0.050933333333333324,38.7
3207,1968,1362,12,17,29,41.38,0.010165517241379308,35.03448275862069
3211,11053,27497,18,9,27,66.67,0.027766666666666665,47.51851851851852
3213,5142,51058,17,5,22,77.27,0.06314545454545456,54.45454545454545
3217,2335,9615,17,9,26,65.38,0.026407692307692306,55.57692307692308
3218,5813,15137,21,12,33,63.64,0.026042424242424242,37.54545454545455
3219,3482,13758,26,19,45,57.78,0.052559999999999996,18.844444444444445
3221,4138,26872,28,14,42,66.67,0.045478571428571424,22.428571428571427
3224,10646,16204,41,26,67,61.19,0.028501492537313433,19.73134328358209
3226,6516,26834,14,9,23,60.87,0.036204347826086954,62.78260869565217
3227,15382,34618,23,15,38,60.53,0.01603421052631579,34.526315789473685
3228,3503,19497,17,10,27,62.96,0.03937407407407407,38.2962962962963
3230,1648,2562,18,11,29,62.07,0.019082758620689654,38.758620689655174
3232,4737,8403,29,20,49,59.18,0.01634285714285714,23.73469387755102
3234,8074,21376,31,18,49,63.27,0.02464489795918367,23.897959183673468
3236,5602,15448,36,22,58,62.07,0.01978965517241379,22.189655172413794
3252,2471,22929,15,9,24,62.5,0.06273749999999999,53.041666666666664
3259,5494,25356,30,18,48,62.5,0.03309583333333333,25.520833333333332
3260,11981,81369,31,15,46,67.39,0.04112826086956521,23.782608695652176
3264,3936,15014,19,11,30,63.33,0.026596666666666664,42.36666666666667
3265,5515,25335,27,11,38,71.05,0.031642105263157895,29.81578947368421
3268,2381,9189,21,12,33,63.64,0.031021212121212116,34.63636363636363
3272,7600,-6450,22,19,41,53.66,0.0016170731707317026,24.804878048780488
3276,2832,2308,23,18,41,56.1,0.010748780487804878,31.75609756097561
3284,1731,12899,16,6,22,72.73,0.04572727272727272,50.90909090909091
3285,4116,10684,22,14,36,61.11,0.017847222222222226,34.416666666666664
3287,2126,10294,23,10,33,69.7,0.04208787878787879,29.09090909090909
3288,3794,22586,35,27,62,56.45,0.051924193548387086,14.85483870967742
3289,12593,-37893,23,22,45,51.11,0.0017577777777777804,29.133333333333333
3290,2670,2030,18,12,30,60.0,0.011756666666666667,41.833333333333336
3293,34255,-12105,27,24,51,52.94,-0.003647058823529414,24.215686274509803
3294,2408,10712,19,10,29,65.52,0.03141034482758621,44.96551724137931
3297,3156,13474,23,12,35,65.71,0.030134285714285707,43.51428571428571
3303,2867,-3867,13,13,26,50.0,-0.004907692307692308,49.30769230769231
3306,2639,13361,18,5,23,78.26,0.03378260869565217,50.43478260869565
3310,4874,7676,28,21,49,57.14,0.01625102040816326,27.510204081632654
3313,3471,21299,30,15,45,66.67,0.03072444444444445,25.0
3317,5706,-4176,36,24,60,60.0,0.00431,23.65
3322,2123,4787,18,15,33,54.55,0.025945454545454546,30.484848484848484
3323,3095,-2395,15,13,28,53.57,0.000982142857142855,50.714285714285715
3324,10326,-8926,27,28,55,49.09,-0.0056690909090909075,22.09090909090909
3325,3184,1426,21,17,38,55.26,0.010626315789473683,32.5
3332,2713,12737,10,3,13,76.92,0.034876923076923076,149.3846153846154
3339,3905,4125,38,32,70,54.29,0.029631428571428576,17.314285714285713
3354,1902,9778,19,8,27,70.37,0.039900000000000005,44.48148148148148
3360,3018,11452,25,13,38,65.79,0.031960526315789474,23.31578947368421
3362,7297,6953,26,25,51,50.98,0.008625490196078434,23.725490196078432
3363,4553,31347,21,8,29,72.41,0.0459,29.551724137931036
3372,2524,7496,25,18,43,58.14,0.04225116279069767,29.767441860465116
3373,6747,-28097,17,22,39,43.59,-0.010676923076923079,35.58974358974359
3374,8230,37770,27,14,41,65.85,0.029368292682926827,18.048780487804876
3379,3597,10573,29,18,47,61.7,0.02462553191489362,31.382978723404257
3388,4436,10164,7,5,12,58.33,0.016283333333333334,133.5
3390,5846,3204,33,24,57,57.89,0.010700000000000001,27.49122807017544
3402,3890,6210,26,15,41,63.41,0.013690243902439024,35.19512195121951
3426,3028,-7878,7,7,14,50.0,-0.009428571428571429,67.64285714285714
3434,2012,3848,15,12,27,55.56,0.018140740740740742,45.77777777777778
3438,2910,35440,16,5,21,76.19,0.08008571428571427,45.19047619047619
3441,6329,1721,31,24,55,56.36,0.0026618181818181814,21.87272727272727
3444,4189,15511,25,11,36,69.44,0.028811111111111107,38.916666666666664
3455,9362,28738,34,19,53,64.15,0.024315094339622638,26.962264150943398
3465,3324,1326,32,22,54,59.26,0.018353703703703702,22.703703703703702
3466,4617,10333,28,21,49,57.14,0.021710204081632656,31.755102040816325
3479,4715,-6315,9,9,18,50.0,-0.0028222222222222242,69.0
3483,3842,-6812,17,19,36,47.22,-0.0056833333333333345,37.72222222222222
3484,3597,25653,18,6,24,75.0,0.04505,43.875
3489,2286,10834,22,9,31,70.97,0.03836129032258065,38.12903225806452
3490,5276,2324,24,17,41,58.54,0.011912195121951217,29.048780487804876
3491,11644,64006,22,10,32,68.75,0.03716875,34.71875
3492,3443,1557,18,14,32,56.25,0.010175,28.375
3498,11480,-14980,27,27,54,50.0,0.0005611111111111092,23.11111111111111
3499,2217,11483,19,9,28,67.86,0.03565000000000001,37.5
3508,11153,-5363,43,45,88,48.86,-0.001992045454545453,14.647727272727273
3511,5766,32284,32,17,49,65.31,0.03736530612244898,23.591836734693878
3512,4872,37138,30,13,43,69.77,0.049225581395348834,30.441860465116278
3516,1774,3716,15,10,25,60.0,0.018972000000000003,43.16
3520,10943,-58203,47,43,90,52.22,0.009854444444444447,11.11111111111111
3521,3509,-2169,23,22,45,51.11,0.0022777777777777766,29.066666666666666
3522,5100,16530,36,21,57,63.16,0.02664912280701755,21.035087719298247
3523,5485,-3785,32,44,76,42.11,-0.0007750000000000016,20.644736842105264
3526,9932,48818,31,20,51,60.78,0.02344509803921568,24.705882352941178
3527,11155,40245,19,10,29,65.52,0.02593103448275862,37.275862068965516
3529,43435,379465,29,9,38,76.32,0.05580526315789474,23.07894736842105
3531,2343,6707,13,9,22,59.09,0.019922727272727273,61.5
3537,4951,8349,21,15,36,58.33,0.013866666666666666,30.083333333333332
3540,4589,-459,27,20,47,57.45,0.0014595744680851058,25.72340425531915
3541,7700,55550,15,6,21,71.43,0.05755714285714286,40.76190476190476
3546,16130,-1080,30,28,58,51.72,0.0038103448275862047,21.810344827586206
3548,10397,-747,28,24,52,53.85,0.0047269230769230765,25.115384615384617
3551,9515,52035,27,11,38,71.05,0.03685,28.526315789473685
3552,34319,-71119,32,34,66,48.48,-0.001221212121212118,20.0
3555,9583,16897,48,47,95,50.53,0.017310526315789474,13.557894736842105
3556,8995,57255,19,8,27,70.37,0.04422592592592593,44.25925925925926
3558,17897,21303,18,12,30,60.0,0.012940000000000002,39.333333333333336
3564,6684,-16984,21,23,44,47.73,-0.007252272727272729,32.63636363636363
3567,3566,17364,27,12,39,69.23,0.033692307692307695,37.205128205128204
3570,11164,83136,20,8,28,71.43,0.050114285714285715,42.714285714285715
3577,3827,17073,14,7,21,66.67,0.0336952380952381,59.285714285714285
3580,6358,-2568,38,41,79,48.1,0.0024670886075949345,16.20253164556962
3581,2799,1101,17,14,31,54.84,0.008948387096774193,27.096774193548388
3587,13259,73991,23,12,35,65.71,0.032068571428571425,25.542857142857144
3594,4043,4007,17,12,29,58.62,0.00740344827586207,40.55172413793103
3597,558,4102,5,2,7,71.43,0.049242857142857144,123.42857142857143
3609,2331,10469,16,10,26,61.54,0.030546153846153848,47.0
3611,31888,187012,22,8,30,73.33,0.045363333333333325,33.833333333333336
3615,5726,13024,30,19,49,61.22,0.018795918367346936,24.816326530612244
3623,4680,-14680,19,17,36,52.78,0.0007833333333333338,35.75
3624,3816,21034,20,8,28,71.43,0.03833928571428571,38.892857142857146
3625,4798,16042,34,23,57,59.65,0.023214035087719298,23.017543859649123
3628,6464,50836,19,9,28,67.86,0.051810714285714286,51.57142857142857
3629,5410,-670,31,36,67,46.27,0.010364179104477615,17.567164179104477
3630,12900,-13200,38,34,72,52.78,0.003233333333333333,20.22222222222222
3631,6888,23262,25,17,42,59.52,0.022516666666666664,26.976190476190474
3632,3393,-8373,20,26,46,43.48,-0.008154347826086953,36.78260869565217
3642,5291,-13291,28,33,61,45.9,-0.0091655737704918,23.508196721311474
3646,4987,35113,33,11,44,75.0,0.04855909090909092,28.59090909090909
3652,2300,24250,16,6,22,72.73,0.06511363636363637,53.95454545454545
3663,2967,21733,19,7,26,73.08,0.046365384615384614,47.84615384615385
3664,3557,9533,27,21,48,56.25,0.02382916666666667,23.166666666666668
3666,6935,7215,35,24,59,59.32,0.012003389830508472,16.372881355932204
3672,5247,7313,28,21,49,57.14,0.017487755102040817,21.79591836734694
3675,8076,33624,33,18,51,64.71,0.02825882352941176,28.647058823529413
3680,10082,14668,21,15,36,58.33,0.024088888888888892,29.055555555555557
3684,5101,30099,14,8,22,63.64,0.04034545454545454,55.40909090909091
3685,5087,72613,25,5,30,83.33,0.09014666666666665,24.3
3687,17351,17249,33,26,59,55.93,0.013381355932203392,21.779661016949152
3689,10352,36598,33,18,51,64.71,0.027321568627450974,28.980392156862745
3691,74630,-117330,44,42,86,51.16,-0.0013581395348837206,17.197674418604652
3693,19356,-12056,35,34,69,50.72,0.007966666666666665,19.304347826086957
3707,3667,-907,24,23,47,51.06,0.001829787234042554,17.80851063829787
3709,945,3905,4,4,8,50.0,0.035449999999999995,68.5
3710,855,3785,10,4,14,71.43,0.040607142857142856,30.857142857142858
3713,852,-6152,2,2,4,50.0,-0.041775,23.25
4102,4478,2322,19,17,36,52.78,0.010405555555555557,41.166666666666664
4105,13717,-4117,18,13,31,58.06,0.005951612903225803,46.61290322580645
4107,18182,70518,27,11,38,71.05,0.03832368421052632,35.13157894736842
4109,3711,-811,19,21,40,47.5,0.004085,40.875
4111,2739,12611,14,5,19,73.68,0.029342105263157888,81.78947368421052
4113,2075,3555,15,11,26,57.69,0.017353846153846154,56.69230769230769
4114,4203,6147,16,12,28,57.14,0.011771428571428573,55.92857142857143
4116,6687,22513,18,13,31,58.06,0.025254838709677423,31.29032258064516
4120,10521,2379,19,17,36,52.78,0.006274999999999999,41.47222222222222
4121,2562,17648,22,8,30,73.33,0.04772333333333333,24.8
4123,11055,65595,24,10,34,70.59,0.04269117647058823,32.294117647058826
4126,6696,-1196,9,8,17,52.94,0.004170588235294115,82.58823529411765
4127,4488,-838,31,26,57,54.39,0.00700526315789474,29.12280701754386
4128,3509,14891,14,12,26,53.85,0.024103846153846156,57.73076923076923
4129,6643,-4293,16,12,28,57.14,0.0001714285714285704,50.42857142857143
4130,6253,2147,18,18,36,50.0,0.004950000000000002,39.638888888888886
4131,3110,10560,25,27,52,48.08,0.03836153846153846,18.692307692307693
4138,4535,14215,9,6,15,60.0,0.021713333333333338,112.66666666666667
4139,9467,-46467,14,21,35,40.0,-0.023142857142857142,46.02857142857143
4147,16638,-42538,14,17,31,45.16,-0.00674193548387097,33.25806451612903
4153,7174,76,23,20,43,53.49,0.007611627906976745,31.790697674418606
4154,3149,20501,15,8,23,65.22,0.04267826086956522,31.956521739130434
4157,5304,-864,27,22,49,55.1,0.005232653061224489,23.857142857142858
4160,2541,33609,14,2,16,87.5,0.08433125,70.3125
4161,6018,-20668,15,17,32,46.88,-0.011925000000000002,47.09375
4162,34055,-144405,29,37,66,43.94,-0.013371212121212122,23.71212121212121
4163,18367,-11167,17,14,31,54.84,0.002761290322580644,47.96774193548387
4167,2356,9044,12,8,20,60.0,0.028825,45.0
4168,9689,-6889,33,30,63,52.38,0.004314285714285712,22.92063492063492
4171,7018,-43368,13,25,38,34.21,-0.026294736842105263,28.94736842105263
4173,4326,17274,21,14,35,60.0,0.027791428571428568,36.2
4174,26846,24854,20,19,39,51.28,0.012812820512820513,24.71794871794872
4175,7194,29906,11,6,17,64.71,0.031164705882352952,78.05882352941177
4183,1357,2243,7,6,13,53.85,0.01236923076923077,47.30769230769231
4188,2839,-2139,11,13,24,45.83,0.003312499999999998,45.791666666666664
4192,6247,25003,20,13,33,60.61,0.030751515151515155,21.78787878787879
4198,4056,3994,27,42,69,39.13,0.00730289855072464,14.942028985507246
4205,2040,15560,6,2,8,75.0,0.047674999999999995,196.0
4207,1846,5824,16,9,25,64.0,0.0229,54.08
4303,2933,14467,21,13,34,61.76,0.03610588235294117,44.11764705882353
4304,4639,-2189,39,41,80,48.75,0.0021237499999999985,13.5
4305,1598,5352,7,3,10,70.0,0.024380000000000002,155.4
4401,9654,-14004,23,18,41,56.1,0.0038317073170731713,34.36585365853659
4402,2524,14186,31,14,45,68.89,0.05825999999999999,20.022222222222222
4406,587,2193,6,3,9,66.67,0.039766666666666665,190.77777777777777
4413,3274,22386,28,18,46,60.87,0.08094130434782609,24.26086956521739
4416,5058,46842,8,2,10,80.0,0.05714,151.2
4417,2960,22140,12,5,17,70.59,0.0491,74.0
4419,1987,-887,16,20,36,44.44,-2.7777777777755443e-06,13.722222222222221
4420,2349,18451,12,4,16,75.0,0.0518,85.8125
4430,2668,12382,12,5,17,70.59,0.02898823529411765,69.88235294117646
4432,6907,-16207,28,27,55,50.91,-0.0010454545454545443,28.563636363636363
4433,2799,1251,9,8,17,52.94,0.003570588235294117,49.294117647058826
4502,6296,9284,31,29,60,51.67,0.011200000000000005,23.266666666666666
4503,4898,23302,34,21,55,61.82,0.033701818181818194,24.254545454545454
4506,4667,20783,19,11,30,63.33,0.03211666666666667,52.1
4510,1681,7159,15,6,21,71.43,0.031838095238095235,51.95238095238095
4513,1559,7271,15,8,23,65.22,0.039334782608695655,49.130434782608695
4523,5011,21139,25,16,41,60.98,0.028392682926829272,31.170731707317074
4527,2406,15494,13,4,17,76.47,0.04332941176470589,82.0
4528,7221,38329,22,9,31,70.97,0.04221290322580645,36.806451612903224
4529,7655,-11415,39,42,81,48.15,0.0013530864197530855,14.296296296296296
4530,3745,-855,31,39,70,44.29,0.01691285714285715,18.65714285714286
4533,1049,5361,10,4,14,71.43,0.039021428571428575,79.0
4534,2708,1262,22,14,36,61.11,0.019688888888888884,33.638888888888886
4535,2953,9597,10,6,16,62.5,0.0222875,99.0
4538,1020,7650,8,4,12,66.67,0.05110833333333333,103.08333333333333
4541,3365,835,15,11,26,57.69,0.006223076923076924,44.38461538461539
4542,4223,3027,18,14,32,56.25,0.006696874999999999,34.71875
4543,2163,10787,12,9,21,57.14,0.03458095238095238,47.285714285714285
4549,7362,20438,10,7,17,58.82,0.019352941176470594,43.529411764705884
4550,1813,9737,9,6,15,60.0,0.03626666666666666,68.06666666666666
4554,4774,12576,18,13,31,58.06,0.025961290322580644,21.548387096774192
4556,1508,15192,6,2,8,75.0,0.0634875,126.0
4561,964,9836,4,2,6,66.67,0.07300000000000001,77.5
4563,4084,-2384,11,10,21,52.38,0.0038523809523809517,35.76190476190476
4568,2734,-11534,4,4,8,50.0,-0.019812499999999997,65.625
4580,526,-4726,0,1,1,0.0,-0.0508,401.0
4609,3412,-1622,28,24,52,53.85,0.0037749999999999997,27.884615384615383
4702,4650,16550,37,29,66,56.06,0.04843181818181817,24.045454545454547
4706,1507,4193,10,5,15,66.67,0.021359999999999997,117.6
4707,1447,7503,16,5,21,76.19,0.0399047619047619,49.0
4711,1559,9691,13,5,18,72.22,0.03846666666666667,83.27777777777777
4712,6491,-16451,37,60,97,38.14,-0.008640206185567012,15.989690721649485
4714,1852,11468,18,7,25,72.0,0.043852,43.16
4716,3904,11346,28,18,46,60.87,0.02118478260869565,34.15217391304348
4721,7908,14042,28,20,48,58.33,0.013608333333333339,28.875
4726,8113,13637,27,20,47,57.45,0.012148936170212765,24.361702127659573
4728,8162,588,24,18,42,57.14,0.006566666666666668,31.476190476190474
4729,2828,10202,21,16,37,56.76,0.031010810810810818,29.405405405405407
4735,8396,104,32,29,61,52.46,0.00592295081967213,22.75409836065574
4736,19658,15242,22,15,37,59.46,0.014267567567567566,37.83783783783784
4741,6763,-45163,13,19,32,40.62,-0.025231249999999997,50.5625
4743,12470,16330,32,25,57,56.14,0.01857719298245614,19.894736842105264
4744,4994,12306,17,23,40,42.5,0.020712500000000002,23.35
4745,6901,-3551,16,16,32,50.0,-0.0004406249999999931,46.375
4747,1750,9050,4,4,8,50.0,0.029375000000000005,157.0
4754,2097,17503,7,1,8,87.5,0.0491375,72.375
4760,1586,10984,7,5,12,58.33,0.05200000000000002,109.33333333333333
4767,387,5463,3,0,3,100.0,0.08816666666666666,78.66666666666667
4804,4025,-1755,27,24,51,52.94,0.0027529411764705878,18.58823529411765
4806,3572,-7332,22,30,52,42.31,-0.005086538461538463,18.53846153846154
4903,3537,-5767,23,22,45,51.11,0.0034377777777777822,19.488888888888887
4905,7304,11946,19,13,32,59.38,0.016846874999999997,45.40625
4907,4193,4747,25,30,55,45.45,0.015514545454545458,25.6
4908,2878,31772,16,5,21,76.19,0.06815238095238095,42.80952380952381
4909,5888,-2188,28,22,50,56.0,0.0014839999999999983,29.1
4911,11169,-45669,21,29,50,42.0,-0.013500000000000002,32.5
4924,5136,-2116,41,30,71,57.75,0.010540845070422541,19.0
4931,1715,19275,15,15,30,50.0,0.055983333333333336,48.4
4933,7103,5097,22,16,38,57.89,0.01277105263157895,34.71052631578947
4939,3438,7352,26,18,44,59.09,0.015829545454545457,29.068181818181817
4944,5030,17250,33,28,61,54.1,0.02536557377049181,14.688524590163935
4945,1187,15313,3,1,4,75.0,0.080825,11.0
4946,12484,69116,38,29,67,56.72,0.03602537313432836,20.253731343283583
4950,4446,-6906,23,28,51,45.1,-0.0025686274509803993,22.647058823529413
4953,5548,-17498,16,16,32,50.0,-0.00375,37.96875
4966,90993,-196493,28,29,57,49.12,-0.006485964912280701,25.87719298245614
4971,11220,17380,21,15,36,58.33,0.017152777777777777,28.13888888888889
4972,2610,19440,10,4,14,71.43,0.0538,85.07142857142857
4973,5333,-3633,20,17,37,54.05,0.005045945945945948,33.16216216216216
4974,6980,36820,21,9,30,70.0,0.03784333333333333,35.7
4979,9509,-3959,43,28,71,60.56,0.005347887323943663,20.197183098591548
4987,4115,-2015,8,6,14,57.14,0.00867857142857143,113.07142857142857
4991,8716,-366,16,14,30,53.33,0.0035899999999999977,36.13333333333333
4995,4398,44002,18,5,23,78.26,0.06590869565217393,47.0
5009,2794,18656,18,7,25,72.0,0.04132400000000001,46.4
5011,2705,19245,16,8,24,66.67,0.04640416666666667,59.666666666666664
5013,3085,23915,20,6,26,76.92,0.049003846153846155,58.76923076923077
5014,1828,7592,18,10,28,64.29,0.03078214285714285,45.785714285714285
5015,3997,4803,22,12,34,64.71,0.016005882352941175,44.029411764705884
5016,2445,16505,10,6,16,62.5,0.04339375,80.0
5102,623,2527,5,2,7,71.43,0.02754285714285714,211.71428571428572
5201,3063,15227,23,12,35,65.71,0.036477142857142854,40.51428571428571
5202,2942,22398,26,8,34,76.47,0.05188235294117648,33.6764705882353
5205,3588,22982,31,25,56,55.36,0.06711964285714285,14.589285714285714
5206,1797,-7017,10,13,23,43.48,-0.02339130434782608,66.82608695652173
5209,4310,29490,12,3,15,80.0,0.04756,92.73333333333333
5210,1345,5285,16,6,22,72.73,0.03837727272727273,47.31818181818182
5211,4374,6976,27,16,43,62.79,0.013576744186046511,34.46511627906977
5212,3803,12097,23,13,36,63.89,0.023452777777777777,41.166666666666664
5213,2005,10395,12,7,19,63.16,0.03375789473684211,72.26315789473684
5220,3495,8615,14,12,26,53.85,0.019353846153846152,27.384615384615383
5223,3282,3168,8,7,15,53.33,0.010846666666666668,30.6
5227,9825,49325,43,38,81,53.09,0.026103703703703702,12.592592592592593
5230,6233,-13433,18,18,36,50.0,-0.006377777777777778,44.19444444444444
5245,10937,1913,27,21,48,56.25,0.006000000000000001,19.166666666666668
5251,4719,-4779,27,23,50,54.0,0.003122000000000001,31.4
5263,40157,17543,24,19,43,55.81,0.010327906976744187,26.674418604651162
5272,11623,29077,42,29,71,59.15,0.020069014084507043,18.43661971830986
5274,100238,550262,33,19,52,63.46,0.03042307692307692,21.48076923076923
5276,3525,-5915,22,21,43,51.16,-0.003620930232558138,32.06976744186046
5278,15260,-82510,27,34,61,44.26,-0.010347540983606561,20.37704918032787
5281,2422,-4572,9,9,18,50.0,0.0035722222222222236,45.22222222222222
5287,31789,147211,15,9,24,62.5,0.02991666666666667,49.625
5289,17061,46539,18,12,30,60.0,0.021143333333333337,39.06666666666667
5291,3477,-5077,15,18,33,45.45,-0.0010999999999999975,30.454545454545453
5299,2717,1673,14,15,29,48.28,0.015075862068965514,43.89655172413793
5301,5069,-13599,19,32,51,37.25,-0.01174705882352941,22.80392156862745
5302,2280,6490,26,13,39,66.67,0.029776923076923076,26.17948717948718
5306,22046,74754,24,12,36,66.67,0.03128333333333333,36.75
5309,2978,6932,24,20,44,54.55,0.024315909090909086,28.477272727272727
5310,7781,16239,34,37,71,47.89,0.023359154929577467,20.732394366197184
5312,4672,-15972,7,6,13,53.85,-0.014207692307692303,136.07692307692307
5314,6220,-1580,55,57,112,49.11,0.0009705357142857095,12.607142857142858
5315,4612,2578,37,27,64,57.81,0.024856249999999996,20.421875
5321,7244,2066,32,34,66,48.48,0.03998939393939394,16.59090909090909
5324,1556,-346,10,12,22,45.45,0.005154545454545454,71.9090909090909
5328,2276,6244,24,14,38,63.16,0.030194736842105264,28.63157894736842
5340,1832,2848,19,15,34,55.88,0.019638235294117647,42.6764705882353
5344,1769,10361,18,10,28,64.29,0.04982142857142858,41.964285714285715
5345,2333,4237,21,19,40,52.5,0.025882499999999996,24.725
5347,9388,24262,25,15,40,62.5,0.023204999999999996,35.275
5348,3045,-1755,23,26,49,46.94,0.0009224489795918352,22.714285714285715
5351,3336,6594,26,21,47,55.32,0.023742553191489366,22.361702127659573
5353,2000,-860,16,11,27,59.26,0.0031148148148148124,54.2962962962963
5355,2419,4821,25,16,41,60.98,0.024273170731707316,37.31707317073171
5356,5258,4592,16,14,30,53.33,0.006946666666666668,56.233333333333334
5364,3119,40731,25,21,46,54.35,0.7488891304347828,33.91304347826087
5371,4902,6298,17,12,29,58.62,0.015217241379310341,44.96551724137931
5381,3367,-4677,30,41,71,42.25,-0.02108309859154929,16.112676056338028
5383,2255,15185,22,8,30,73.33,0.04693666666666667,28.833333333333332
5386,8144,22256,31,22,53,58.49,0.02576226415094339,22.60377358490566
5392,5998,-8898,18,17,35,51.43,-0.005528571428571425,41.22857142857143
5398,4563,-5463,20,19,39,51.28,0.004138461538461539,33.53846153846154
5403,2621,17529,11,6,17,64.71,0.04369411764705883,99.47058823529412
5410,1737,-187,12,10,22,54.55,0.006063636363636365,70.0909090909091
5425,6634,19016,25,15,40,62.5,0.025077500000000003,35.025
5426,1565,3545,13,8,21,61.9,0.02051904761904762,84.28571428571429
5432,2262,18088,17,6,23,73.91,0.04952608695652175,51.52173913043478
5438,1397,10553,13,5,18,72.22,0.05235000000000001,71.88888888888889
5439,3783,16017,17,11,28,60.71,0.027064285714285718,51.67857142857143
5443,3880,10800,29,17,46,63.04,0.023626086956521738,28.5
5450,2713,5177,20,14,34,58.82,0.023647058823529413,25.764705882352942
5452,1891,3959,17,11,28,60.71,0.01254642857142857,46.607142857142854
5455,3681,11819,35,36,71,49.3,0.06661690140845071,11.04225352112676
5457,10177,823,39,26,65,60.0,0.013772307692307695,21.046153846153846
5460,750,5490,7,3,10,70.0,0.05004000000000001,119.2
5464,2086,8454,15,8,23,65.22,0.028365217391304348,55.0
5465,3045,15195,25,16,41,60.98,0.046482926829268294,29.5609756097561
5468,5045,13985,51,37,88,57.95,0.02650340909090909,12.181818181818182
5474,16599,56901,40,24,64,62.5,0.0290484375,17.796875
5475,3234,2436,32,31,63,50.79,0.013444444444444445,19.206349206349206
5478,13766,81184,25,12,37,67.57,0.038037837837837825,31.2972972972973
5481,1786,7764,15,7,22,68.18,0.03536363636363637,46.31818181818182
5483,12364,-19764,26,25,51,50.98,-0.0018490196078431403,27.607843137254903
5487,4379,21071,21,11,32,65.62,0.035753125000000004,44.78125
5488,1346,4644,15,8,23,65.22,0.035543478260869565,51.130434782608695
5489,3346,9504,10,6,16,62.5,0.021343749999999998,96.125
5490,7495,5605,24,18,42,57.14,0.008059523809523808,32.57142857142857
5493,3063,9587,11,7,18,61.11,0.027805555555555552,86.55555555555556
5498,1958,5482,18,12,30,60.0,0.02235,40.1
5508,4181,25819,14,7,21,66.67,0.03265714285714286,65.85714285714286
5511,1031,10019,6,1,7,85.71,0.0628857142857143,212.14285714285714
5512,1640,730,14,10,24,58.33,0.008616666666666667,64.75
5514,1495,8895,11,5,16,68.75,0.0357125,74.3125
5516,1457,-1097,10,10,20,50.0,-0.004430000000000001,56.75
5520,1420,10980,7,2,9,77.78,0.048900000000000006,205.77777777777777
5523,2703,17037,22,16,38,57.89,0.04886578947368421,35.39473684210526
5529,4226,7624,31,27,58,53.45,0.021887931034482756,22.551724137931036
5530,3417,14733,6,5,11,54.55,0.029500000000000002,147.0
5536,13719,16481,15,10,25,60.0,0.012308000000000006,61.24
5543,1548,-2848,5,7,12,41.67,-0.003258333333333332,59.083333333333336
5601,2330,12620,13,3,16,81.25,0.035793750000000006,102.8125
5603,862,-1172,6,6,12,50.0,-0.0011500000000000006,122.83333333333333
5604,2036,18464,8,2,10,80.0,0.06345,175.6
5609,1814,8186,10,6,16,62.5,0.0284125,81.375
5701,3367,-2567,35,36,71,49.3,-0.006281690140845073,21.492957746478872
5703,1054,10796,6,2,8,75.0,0.06345,129.375
5704,1567,3533,7,5,12,58.33,0.019558333333333334,144.08333333333334
5820,654,1946,7,3,10,70.0,0.02869,167.8
5864,850,910,8,6,14,57.14,0.012928571428571432,110.0
5878,1861,7839,5,2,7,71.43,0.027400000000000004,188.85714285714286
5902,1591,21679,17,2,19,89.47,0.09707368421052631,71.47368421052632
5903,17926,141074,12,4,16,75.0,0.0497125,82.8125
5904,37693,308607,24,8,32,75.0,0.05172500000000001,37.53125
5905,2134,6846,20,11,31,64.52,0.031264516129032256,35.32258064516129
6015,1360,6590,16,6,22,72.73,0.04196363636363636,56.5
6016,1158,4012,13,6,19,68.42,0.033673684210526314,66.94736842105263
6020,907,9693,8,3,11,72.73,0.0679090909090909,119.63636363636364
6021,1663,15307,18,4,22,81.82,0.0627409090909091,53.31818181818182
6023,2643,13907,8,4,12,66.67,0.035208333333333335,123.25
6026,794,3266,8,4,12,66.67,0.038066666666666665,67.91666666666667
6101,7489,8641,34,38,72,47.22,0.017018055555555554,17.805555555555557
6103,4230,5940,36,44,80,45.0,0.018133749999999994,11.075
6104,4230,4670,16,11,27,59.26,0.012829629629629627,36.18518518518518
6109,1329,-259,11,8,19,57.89,0.006800000000000005,64.0
6111,16863,92237,32,19,51,62.75,0.03412941176470589,21.215686274509803
6113,1809,2311,15,14,29,51.72,0.015686206896551723,42.96551724137931
6114,7792,19148,28,21,49,57.14,0.049753061224489796,22.816326530612244
6118,1818,1772,17,11,28,60.71,0.009196428571428574,43.892857142857146
6121,19928,-66728,12,14,26,46.15,-0.01507307692307692,58.73076923076923
6122,1770,8580,18,8,26,69.23,0.0323076923076923,52.92307692307692
6123,6430,18220,20,16,36,55.56,0.021319444444444446,38.916666666666664
6124,4320,25580,21,10,31,67.74,0.04218709677419355,28.225806451612904
6125,1163,9537,12,3,15,80.0,0.05930666666666667,71.0
6126,2942,7448,26,12,38,68.42,0.028250000000000004,32.36842105263158
6127,2815,9865,24,14,38,63.16,0.026639473684210532,29.07894736842105
6129,1811,3999,20,9,29,68.97,0.02542068965517241,36.44827586206897
6130,12496,19854,35,34,69,50.72,0.01480289855072464,22.144927536231883
6134,3846,10844,37,20,57,64.91,0.028343859649122807,21.45614035087719
6138,6350,6850,26,17,43,60.47,0.011155813953488372,33.95348837209303
6140,1474,10296,16,4,20,80.0,0.05113500000000001,46.75
6143,7256,19244,21,10,31,67.74,0.021996774193548382,32.83870967741935
6144,2306,-2816,15,21,36,41.67,-0.006361111111111111,35.611111111111114
6146,21585,137315,20,7,27,74.07,0.045848148148148145,56.0
6147,9530,38670,21,10,31,67.74,0.02515806451612903,35.774193548387096
6148,1911,1369,21,10,31,67.74,0.016177419354838712,38.935483870967744
6150,4506,5524,34,26,60,56.67,0.019994999999999995,22.75
6151,2060,18390,15,3,18,83.33,0.055561111111111124,44.77777777777778
6154,1752,948,9,9,18,50.0,0.014227777777777777,115.33333333333333
6156,3158,12752,23,18,41,56.1,0.025626829268292683,28.682926829268293
6158,3626,14784,25,15,40,62.5,0.0284825,32.575
6160,4583,7717,26,22,48,54.17,0.0151625,30.645833333333332
6161,1958,1672,18,12,30,60.0,0.007960000000000002,49.53333333333333
6163,2698,12062,20,11,31,64.52,0.03221612903225806,34.25806451612903
6167,3358,1822,36,28,64,56.25,0.0079328125,19.875
6169,4747,17103,23,17,40,57.5,0.027375000000000003,19.675
6170,2137,5643,17,12,29,58.62,0.022365517241379314,41.206896551724135
6171,1765,14975,14,6,20,70.0,0.060305,56.65
6173,3611,7059,27,18,45,60.0,0.014128888888888887,32.75555555555555
6174,1593,7607,13,7,20,65.0,0.039215,55.05
6175,3263,9537,24,14,38,63.16,0.023189473684210527,36.18421052631579
6179,4594,22396,22,14,36,61.11,0.047708333333333325,34.388888888888886
6180,8318,-7768,20,22,42,47.62,0.0010523809523809529,35.595238095238095
6182,4503,-9613,28,27,55,50.91,-0.008252727272727271,26.563636363636363
6185,3334,-3584,20,15,35,57.14,-0.002525714285714288,39.4
6186,3405,14395,16,11,27,59.26,0.028107407407407404,45.851851851851855
6187,9639,45111,29,15,44,65.91,0.03840227272727273,22.15909090909091
6188,5883,33817,27,10,37,72.97,0.040032432432432444,30.37837837837838
6190,2655,-155,23,19,42,54.76,0.0019904761904761888,34.45238095238095
6194,1196,54,6,5,11,54.55,0.006800000000000001,122.45454545454545
6195,5383,28567,14,7,21,66.67,0.03623809523809524,69.14285714285714
6198,2744,17986,22,13,35,62.86,0.045239999999999995,33.08571428571429
6199,3836,-3286,25,25,50,50.0,0.00734,24.68
6203,4680,40970,17,5,22,77.27,0.056745454545454564,55.40909090909091
6204,1799,16001,10,4,14,71.43,0.0551,99.71428571428571
6207,4280,19870,20,11,31,64.52,0.030454838709677422,39.12903225806452
6208,2708,10702,20,11,31,64.52,0.02826129032258065,47.54838709677419
6210,3987,6113,11,7,18,61.11,0.01253888888888889,87.27777777777777
6212,3098,13352,15,7,22,68.18,0.042263636363636364,58.45454545454545
6217,6181,12319,22,16,38,57.89,0.016681578947368426,28.342105263157894
6218,2501,6949,12,10,22,54.55,0.021249999999999995,64.4090909090909
6219,2162,18038,17,7,24,70.83,0.05392916666666667,42.083333333333336
6220,5222,28858,31,16,47,65.96,0.027606382978723407,29.25531914893617
6221,4153,14847,19,12,31,61.29,0.025538709677419356,45.32258064516129
6222,1560,6120,14,11,25,56.0,0.024767999999999995,30.52
6223,11905,33095,21,12,33,63.64,0.026160606060606058,32.18181818181818
6227,2913,12287,20,10,30,66.67,0.03287333333333334,37.03333333333333
6228,2812,2458,23,23,46,50.0,0.016421739130434782,22.195652173913043
6229,2734,18796,24,9,33,72.73,0.04801515151515151,36.666666666666664
6231,16390,40960,34,23,57,59.65,0.01827543859649123,21.24561403508772
6233,3221,11989,28,16,44,63.64,0.03086363636363636,27.59090909090909
6234,2707,33293,20,4,24,83.33,0.07854583333333333,34.416666666666664
6236,7911,12979,43,38,81,53.09,0.025213580246913586,16.08641975308642
6237,4616,5974,24,15,39,61.54,0.017441025641025638,27.205128205128204
6240,3757,27233,24,11,35,68.57,0.05696,22.97142857142857
6241,5635,10685,28,20,48,58.33,0.023714583333333334,26.125
6242,4447,23173,20,18,38,52.63,0.07107631578947367,31.289473684210527
6244,7717,-7917,36,36,72,50.0,0.008659722222222221,16.875
6245,9338,47212,26,13,39,66.67,0.034194871794871795,25.564102564102566
6246,4284,12796,35,44,79,44.3,0.07216582278481012,14.177215189873417
6247,1531,15069,15,6,21,71.43,0.07355238095238094,71.9047619047619
6248,6170,7150,41,38,79,51.9,0.0071379746835443045,15.962025316455696
6259,4305,8345,37,49,86,43.02,0.046422093023255805,13.534883720930232
6261,6371,36829,15,6,21,71.43,0.03433809523809524,50.476190476190474
6263,6408,20692,17,8,25,68.0,0.027804,60.28
6264,2686,4554,24,19,43,55.81,0.0246046511627907,34.651162790697676
6265,1134,5616,15,4,19,78.95,0.04721578947368421,66.3157894736842
6266,1497,3833,11,8,19,57.89,0.02318421052631579,72.0
6270,1324,5056,10,7,17,58.82,0.027982352941176472,70.6470588235294
6274,7304,21146,27,17,44,61.36,0.019352272727272732,33.70454545454545
6275,2401,10139,18,10,28,64.29,0.03261428571428572,50.392857142857146
6276,4373,19417,27,21,48,56.25,0.03484583333333333,23.5
6279,15386,47114,21,10,31,67.74,0.025961290322580644,40.483870967741936
6284,6215,19135,28,14,42,66.67,0.022164285714285716,29.428571428571427
6287,3558,5252,38,35,73,52.05,0.031349315068493144,17.315068493150687
6290,7070,-5820,21,20,41,51.22,-0.001378048780487805,32.926829268292686
6291,4337,-5257,37,51,88,42.05,-0.010112499999999998,11.272727272727273
6292,2947,39753,15,2,17,88.24,0.08468823529411765,59.588235294117645
6294,15948,78552,27,20,47,57.45,0.020951063829787234,30.06382978723404
6404,4737,-37,35,39,74,47.3,0.0267,15.986486486486486
6411,11561,38089,28,17,45,62.22,0.018628888888888886,21.377777777777776
6417,3642,-8842,8,9,17,47.06,-0.008800000000000006,56.1764705882353
6418,3384,-6824,16,20,36,44.44,-0.0044777777777777784,32.611111111111114
6419,2754,11656,13,13,26,50.0,0.04882692307692309,31.115384615384617
6425,8499,-31339,21,29,50,42.0,-0.012960000000000003,20.12
6426,7279,47121,18,9,27,66.67,0.028114814814814818,24.555555555555557
6432,3150,4100,12,9,21,57.14,0.015733333333333332,42.523809523809526
6435,13054,80546,21,9,30,70.0,0.04298333333333334,17.1
6441,13451,-105321,15,31,46,32.61,-0.03776304347826088,25.434782608695652
6446,20745,-24045,16,20,36,44.44,0.0004194444444444445,20.38888888888889
6457,2936,13664,8,6,14,57.14,0.03427857142857143,57.357142857142854
6461,4669,11081,24,15,39,61.54,0.019297435897435898,29.0
6462,34455,50145,24,18,42,57.14,0.010571428571428572,20.404761904761905
6465,7351,-23151,18,24,42,42.86,-0.008635714285714286,25.11904761904762
6469,5904,34996,9,4,13,69.23,0.03617692307692308,41.23076923076923
6470,5184,29066,15,7,22,68.18,0.03363181818181818,24.227272727272727
6472,16860,123090,19,8,27,70.37,0.06297777777777779,16.88888888888889
6482,7169,30281,20,13,33,60.61,0.031036363636363636,24.060606060606062
6485,6521,-6971,16,10,26,61.54,0.011476923076923072,24.153846153846153
6486,9102,19548,18,13,31,58.06,0.02003870967741936,24.225806451612904
6488,42233,335067,24,8,32,75.0,0.05537187500000001,21.125
6492,14642,50258,18,14,32,56.25,0.029690625000000002,26.75
6494,4604,40696,16,6,22,72.73,0.05112272727272727,30.636363636363637
6496,2822,1978,8,7,15,53.33,0.008993333333333334,71.2
6499,14834,-20534,19,20,39,48.72,-0.0014589743589743598,25.025641025641026
6506,2052,12498,14,7,21,66.67,0.04219523809523809,62.523809523809526
6508,1499,15301,8,1,9,88.89,0.06543333333333333,138.44444444444446
6509,2526,14224,19,5,24,79.17,0.036225,41.708333333333336
6510,117746,-103246,15,15,30,50.0,0.0012233333333333345,21.433333333333334
6512,1589,7461,10,6,16,62.5,0.0342,62.625
6514,5879,23471,14,10,24,58.33,0.02549583333333334,34.875
6516,18327,-43337,16,15,31,51.61,-0.007225806451612904,25.096774193548388
6523,13280,-33380,16,13,29,55.17,-0.0026793103448275847,27.0
6527,2594,68256,7,2,9,77.78,0.18987777777777776,141.88888888888889
6530,1252,-332,7,6,13,53.85,0.0008000000000000016,45.30769230769231
6532,3924,8326,16,6,22,72.73,0.01677272727272727,22.363636363636363
6535,4913,59387,19,5,24,79.17,0.07806249999999999,21.875
6538,3993,1157,6,7,13,46.15,0.008638461538461536,55.61538461538461
6542,8789,39211,16,13,29,55.17,0.03497586206896552,18.862068965517242
6547,3296,13154,9,8,17,52.94,0.031099999999999996,62.94117647058823
6548,14932,6918,23,18,41,56.1,0.015517073170731708,21.78048780487805
6556,3946,12954,10,10,20,50.0,0.018024999999999996,45.65
6560,7364,-5514,15,14,29,51.72,0.00873103448275862,19.03448275862069
6561,17085,144915,10,3,13,76.92,0.05653846153846154,37.07692307692308
6568,9130,106370,9,2,11,81.82,0.0784090909090909,25.818181818181817
6569,10506,43994,9,5,14,64.29,0.023878571428571426,58.857142857142854
6570,1774,17376,8,2,10,80.0,0.05807,54.3
6574,2324,-9174,2,5,7,28.57,-0.017799999999999996,140.57142857142858
6576,9102,-8092,15,11,26,57.69,0.0020538461538461565,32.84615384615385
6577,2906,33294,6,2,8,75.0,0.071925,59.375
6578,2087,2663,9,8,17,52.94,0.017294117647058824,45.64705882352941
6588,3459,-18459,4,8,12,33.33,-0.02791666666666667,35.25
6589,2737,3063,8,7,15,53.33,0.01543333333333333,70.6
6590,2748,6702,9,6,15,60.0,0.022679999999999995,73.4
6593,1767,16083,7,4,11,63.64,0.05815454545454545,58.54545454545455
6594,3308,-5258,10,11,21,47.62,-0.003347619047619049,28.476190476190474
6596,3433,9917,8,4,12,66.67,0.023691666666666666,47.833333333333336
6603,1929,3591,15,11,26,57.69,0.015176923076923076,47.23076923076923
6609,3191,6609,14,9,23,60.87,0.02132608695652174,52.56521739130435
6612,2917,27783,6,2,8,75.0,0.058162500000000006,32.75
6613,4323,49177,4,1,5,80.0,0.07168,117.2
6615,5039,-13789,6,9,15,40.0,-0.011666666666666664,52.53333333333333
6616,1784,10086,10,6,16,62.5,0.02046875,23.6875
6624,1479,8771,4,3,7,57.14,0.0366,53.142857142857146
6629,3044,4456,6,4,10,60.0,0.011879999999999995,31.0
6640,1439,-1239,3,3,6,50.0,1.666666666666483e-05,61.833333333333336
6642,1224,3526,4,2,6,66.67,0.016950000000000003,43.666666666666664
6643,17068,124432,9,2,11,81.82,0.047945454545454534,12.818181818181818
6649,1702,15048,7,4,11,63.64,0.0539181818181818,35.72727272727273
6651,0,0,0,0,0,0.0,,
6654,4192,-7692,6,7,13,46.15,-0.003276923076923074,27.76923076923077
6661,530,-3730,1,3,4,25.0,-0.0363,58.0
6662,1134,10516,3,3,6,50.0,0.05806666666666666,60.666666666666664
6664,2469,33631,6,1,7,85.71,0.08914285714285715,40.285714285714285
6667,2013,19287,5,2,7,71.43,0.06747142857142858,28.714285714285715
6679,19225,26775,13,8,21,61.9,0.011447619047619048,11.761904761904763
6680,872,-4872,1,2,3,33.33,-0.030100000000000002,123.33333333333333
6683,24547,126453,12,8,20,60.0,0.035640000000000005,11.6
6690,3265,-29765,1,4,5,20.0,-0.047599999999999996,34.0
6697,441,1009,2,0,2,100.0,0.013600000000000001,66.0
6703,2287,22713,3,1,4,75.0,0.064575,71.75
6712,8932,-77432,2,5,7,28.57,-0.03875714285714286,13.0
6716,1868,11032,2,2,4,50.0,0.048825,43.0
6727,1004,3396,2,1,3,66.67,0.019033333333333333,9.333333333333334
6728,790,-1890,1,1,2,50.0,-0.00995,20.0
6732,30547,-245047,2,9,11,18.18,-0.0526,22.727272727272727
6733,719,2181,4,1,5,80.0,0.01978,30.4
6747,2818,14682,1,1,2,50.0,0.0412,14.5
6751,1076,-18476,1,3,4,25.0,-0.08897500000000001,61.5
6752,647,-947,1,1,2,50.0,-0.00605,81.0
6762,1534,-13034,0,1,1,0.0,-0.0481,246.0
6767,178,-1528,0,1,1,0.0,-0.0486,88.0
6803,8011,52989,6,2,8,75.0,0.0447375,228.25
7402,7249,-26449,14,19,33,42.42,-0.015812121212121215,32.484848484848484
7556,629,9371,1,0,1,100.0,0.0937,17.0
8024,1254,11236,15,2,17,88.24,0.06234117647058824,64.29411764705883
8027,3257,11293,16,10,26,61.54,0.021930769230769233,26.307692307692307
8032,2276,13174,11,5,16,68.75,0.0374875,84.625
8034,3315,-815,27,25,52,51.92,0.00420192307692308,26.76923076923077
8038,8458,19442,22,17,39,56.41,0.022869230769230767,24.076923076923077
8040,2054,8326,21,9,30,70.0,0.03621,40.86666666666667
8042,5299,46251,16,7,23,69.57,0.05091304347826086,52.95652173913044
8043,2088,7362,15,7,22,68.18,0.026872727272727274,63.81818181818182
8044,51989,-48589,40,33,73,54.79,0.0015712328767123343,20.205479452054796
8047,1238,7832,14,3,17,82.35,0.04725294117647058,81.11764705882354
8048,4951,30349,26,9,35,74.29,0.043217142857142864,37.457142857142856
8049,3263,3567,29,18,47,61.7,0.014180851063829785,31.0
8050,4583,7767,11,8,19,57.89,0.018052631578947372,60.78947368421053
8054,4069,24281,22,11,33,66.67,0.040009090909090904,38.81818181818182
8059,2572,19888,26,11,37,70.27,0.058191891891891896,28.45945945945946
8064,3083,11407,24,15,39,61.54,0.031097435897435893,26.358974358974358
8066,11051,68449,20,13,33,60.61,0.057063636363636365,28.363636363636363
8067,1728,2982,17,13,30,56.67,0.01921666666666667,35.1
8068,7596,13504,54,49,103,52.43,0.012458252427184468,10.223300970873787
8069,5389,-1089,28,23,51,54.9,0.0011137254901960785,28.725490196078432
8071,4310,20500,34,16,50,68.0,0.034962,31.94
8074,1882,1918,10,8,18,55.56,0.01078888888888889,64.83333333333333
8076,10974,-11374,26,26,52,50.0,0.0034249999999999997,31.173076923076923
8077,3175,-7925,19,27,46,41.3,-0.0006195652173913025,30.869565217391305
8080,3649,1881,28,38,66,42.42,0.03088484848484848,14.590909090909092
8083,12040,105960,13,4,17,76.47,0.06574117647058825,75.47058823529412
8084,4727,27903,27,13,40,67.5,0.044840000000000005,34.425
8085,1976,1474,20,17,37,54.05,0.01654864864864865,34.13513513513514
8086,10298,22302,30,22,52,57.69,0.015138461538461535,23.115384615384617
8087,2013,607,19,13,32,59.38,0.010149999999999996,46.5
8088,3786,26314,20,9,29,68.97,0.04702758620689656,28.103448275862068
8089,1615,-2165,4,6,10,40.0,-0.001340000000000001,26.8
8091,10609,35991,20,11,31,64.52,0.02262580645161291,39.806451612903224
8092,2372,9308,21,15,36,58.33,0.034694444444444444,32.5
8093,1857,2043,18,15,33,54.55,0.01541212121212121,35.75757575757576
8096,4232,11238,33,21,54,61.11,0.024692592592592596,27.61111111111111
8097,3264,2546,26,22,48,54.17,0.010066666666666666,16.645833333333332
8099,2305,20995,15,6,21,71.43,0.05604761904761904,56.76190476190476
8107,3706,20864,26,14,40,65.0,0.04388,30.775
8109,9487,32063,19,9,28,67.86,0.027875,42.32142857142857
8111,2681,3719,26,21,47,55.32,0.01768510638297872,28.127659574468087
8121,5972,19278,39,25,64,60.94,0.020314062499999997,18.203125
8147,5520,19080,19,11,30,63.33,0.02202333333333333,34.1
8155,8958,32692,30,21,51,58.82,0.02573725490196079,26.941176470588236
8171,2995,6795,23,17,40,57.5,0.01902,25.35
8176,2355,2945,20,15,35,57.14,0.01778,37.74285714285714
8182,2088,8212,16,8,24,66.67,0.02733333333333333,62.333333333333336
8183,2600,14260,26,13,39,66.67,0.03772820512820513,36.38461538461539
8234,3266,6934,15,8,23,65.22,0.016482608695652178,55.78260869565217
8240,3792,17058,18,8,26,69.23,0.037446153846153844,41.15384615384615
8255,12212,70588,17,6,23,73.91,0.040273913043478264,46.130434782608695
8277,3919,8821,32,26,58,55.17,0.02576724137931034,19.96551724137931
8279,6286,45914,7,3,10,70.0,0.049519999999999995,36.7
8284,2254,41836,4,4,8,50.0,0.18448749999999997,271.25
8289,1419,11201,15,4,19,78.95,0.055673684210526306,54.8421052631579
8291,2980,-1150,24,33,57,42.11,-0.0035070175438596464,19.263157894736842
8299,29130,94370,15,7,22,68.18,0.02291363636363636,48.31818181818182
8342,1801,3149,5,2,7,71.43,0.01667142857142857,123.0
8349,8957,31043,18,11,29,62.07,0.03132068965517241,50.275862068965516
8354,1205,10845,10,3,13,76.92,0.05783846153846155,114.92307692307692
8358,3246,43074,24,6,30,80.0,0.06513666666666668,49.266666666666666
8383,4873,12077,18,10,28,64.29,0.01954285714285714,34.714285714285715
8390,3301,15199,20,8,28,71.43,0.04193928571428572,38.107142857142854
8401,1233,7397,10,5,15,66.67,0.03453333333333333,90.4
8403,3769,9381,13,7,20,65.0,0.020859999999999997,63.75
8409,4903,13847,22,21,43,51.16,0.023462790697674422,30.186046511627907
8410,7363,23737,31,17,48,64.58,0.02475416666666667,30.604166666666668
8415,2032,4118,8,6,14,57.14,0.022742857142857145,57.857142857142854
8416,17181,63819,17,11,28,60.71,0.03155,60.035714285714285
8418,1629,-6019,9,12,21,42.86,-0.019028571428571426,75.85714285714286
8420,2166,9234,12,6,18,66.67,0.03072777777777778,53.77777777777778
8421,3048,9482,21,17,38,55.26,0.023771052631578946,39.8421052631579
8423,1908,-6458,6,10,16,37.5,-0.014793749999999998,86.375
8424,3768,2932,8,7,15,53.33,0.009266666666666666,95.13333333333334
8426,4174,-12074,20,18,38,52.63,-0.005905263157894735,37.078947368421055
8431,6877,78523,17,8,25,68.0,0.07135599999999999,15.6
8432,10794,38256,18,13,31,58.06,0.017606451612903223,44.806451612903224
8433,7724,18426,16,8,24,66.67,0.03770416666666667,46.5
8435,2938,16212,6,4,10,60.0,0.03573,132.3
8436,30625,85275,27,19,46,58.7,0.01434130434782609,27.065217391304348
8437,20837,152663,16,6,22,72.73,0.04384545454545455,23.363636363636363
8440,3113,25167,19,10,29,65.52,0.0556551724137931,42.86206896551724
8444,8756,2244,12,10,22,54.55,0.012413636363636361,38.40909090909091
8446,13922,86578,18,8,26,69.23,0.0396,32.19230769230769
8450,8859,-22609,20,23,43,46.51,-0.005337209302325579,28.627906976744185
8455,2824,-2824,12,10,22,54.55,-0.00026818181818181514,36.72727272727273
8472,4960,-18960,9,14,23,39.13,-0.009339130434782607,31.91304347826087
8476,1966,-1316,10,7,17,58.82,-0.00811764705882353,30.352941176470587
8477,4820,-19370,8,14,22,36.36,-0.018513636363636368,43.40909090909091
8489,18107,-58257,20,26,46,43.48,-0.014017391304347827,21.73913043478261
8905,1621,6679,10,8,18,55.56,0.02554444444444445,81.94444444444444
8906,1696,-576,14,12,26,53.85,0.0014884615384615368,57.46153846153846
8908,3058,13442,11,4,15,73.33,0.035853333333333334,108.13333333333334
8916,4027,19123,14,5,19,73.68,0.035873684210526315,50.578947368421055
8917,2017,10883,5,2,7,71.43,0.037457142857142856,305.85714285714283
8921,1651,-1951,11,8,19,57.89,-0.0028684210526315787,100.15789473684211
8923,547,753,4,2,6,66.67,0.011166666666666667,300.6666666666667
8924,2576,3024,14,11,25,56.0,0.013851999999999998,49.88
8927,1035,-6525,4,10,14,28.57,-0.03584285714285714,110.21428571428571
8928,3771,32569,23,7,30,76.67,0.06146666666666667,36.63333333333333
8929,4947,9353,20,14,34,58.82,0.013297058823529407,47.14705882352941
8930,1547,14373,17,3,20,85.0,0.060685,60.05
8931,1727,23873,12,2,14,85.71,0.08845714285714286,88.28571428571429
8932,1937,9763,16,10,26,61.54,0.04325384615384615,43.84615384615385
8933,3813,1437,28,29,57,49.12,0.013014035087719299,19.75438596491228
8935,2378,782,20,21,41,48.78,0.010348780487804875,27.195121951219512
8936,3060,21090,18,8,26,69.23,0.04425,52.61538461538461
8937,2375,5795,18,12,30,60.0,0.019346666666666668,36.43333333333333
8938,3882,-7082,13,13,26,50.0,-0.004826923076923077,49.26923076923077
8941,6373,14717,18,21,40,45.0,0.18492499999999998,30.15
8942,8220,23880,14,8,22,63.64,0.021981818181818182,66.5
9949,2030,9330,17,9,26,65.38,0.03089999999999999,67.11538461538461
9950,2289,-859,16,14,30,53.33,0.005466666666666666,59.13333333333333
9951,19022,9478,24,15,39,61.54,0.018415384615384618,29.46153846153846
9960,4272,19478,20,15,35,57.14,0.029328571428571426,38.0
9962,1994,5036,17,12,29,58.62,0.018727586206896553,46.89655172413793
8916A,292,-92,0,1,1,0.0,-0.0018,814.0
4148,7938,47562,20,15,35,57.14,0.04648571428571428,20.257142857142856
6781,0,0,0,0,0,0.0,,
6776,250,-50,0,1,1,0.0,-0.0012,25.0
2211,355,-2755,0,1,1,0.0,-0.0441,15.0
6768,464,7936,1,0,1,100.0,0.1087,4.0
3357,2135,160165,9,3,12,75.0,0.561,197.91666666666666
6741,2513,-7513,2,1,3,66.67,-0.007233333333333331,29.0
2250,2191,-18291,1,3,4,25.0,-0.042949999999999995,29.25
5236,1367,-16367,0,2,2,0.0,-0.0662,28.5
1522A,261,-161,0,1,1,0.0,-0.0036,3.0
6684,1276,-23776,0,2,2,0.0,-0.0967,25.5
2753,2491,28509,3,0,3,100.0,0.07406666666666667,33.0
2348A,218,-18,0,1,1,0.0,-0.0005,14.0
6790,505,-5705,0,2,2,0.0,-0.0603,44.5
6788,5280,-43780,3,4,7,42.86,-0.04292857142857143,11.428571428571429
2947,0,0,0,0,0,0.0,,
4440,0,0,0,0,0,0.0,,
5222,1731,-5841,7,7,14,50.0,-0.007864285714285714,38.642857142857146
2881C,350,-50,0,1,1,0.0,-0.0008,28.0
6761,1883,-4983,1,2,3,33.33,-0.008366666666666666,17.0
6806,555,2645,1,0,1,100.0,0.0287,16.0
2945,639,-1439,1,1,2,50.0,-0.004750000000000004,16.5
6770,324,1476,1,0,1,100.0,0.0273,29.0
6792,1248,3252,1,1,2,50.0,0.0178,10.0
4770,0,0,0,0,0,0.0,,
2883B,66,-76,0,1,1,0.0,-0.0089,2.0
6691,1069,431,1,0,1,100.0,0.0024,1.0
3592,5250,10830,11,7,18,61.11,0.015955555555555553,33.0
6719,0,0,0,0,0,0.0,,
2756,0,0,0,0,0,0.0,,
5244,746,41524,5,4,9,55.56,0.4478333333333333,258.77777777777777
6693,0,0,0,0,0,0.0,,
8112A,0,0,0,0,0,0.0,,
8438,1443,12717,4,5,9,44.44,0.06921111111111111,284.3333333333333
6829,0,0,0,0,0,0.0,,
4923,1104,63036,5,6,11,45.45,0.45375454545454547,243.27272727272728
6763,0,0,0,0,0,0.0,,
4558,387,26633,2,1,3,66.67,0.5459333333333333,682.3333333333334
3349,726,8304,7,1,8,87.5,0.073125,64.5
6804,0,0,0,0,0,0.0,,
4768,0,0,0,0,0,0.0,,
6807,0,0,0,0,0,0.0,,
6721,0,0,0,0,0,0.0,,
6735,0,0,0,0,0,0.0,,
4583,0,0,0,0,0,0.0,,
6799,0,0,0,0,0,0.0,,
6585,1446,7374,3,1,4,75.0,0.03615,483.5
5228,800,7590,3,3,6,50.0,0.08596666666666668,357.1666666666667
6546,820,103660,2,2,4,50.0,1.709875,530.5
6796,0,0,0,0,0,0.0,,
6550,2099,48481,2,5,7,28.57,0.31278571428571433,291.57142857142856
