代號,總成本,總損益(淨),獲利次數,損失次數,總交易次數,勝率%,平均報酬,平均持倉時間(日)
1101,5936,-2536,17,16,33,51.52,0.006848484848484848,42.09090909090909
1102,5517,-9367,17,15,32,53.12,0.005624999999999998,63.53125
1103,3065,-2335,19,16,35,54.29,0.0010971428571428584,45.48571428571429
1104,2639,1461,16,11,27,59.26,0.011792592592592585,97.70370370370371
1108,1882,-4532,15,15,30,50.0,-0.005013333333333332,79.86666666666666
1109,1978,10762,17,8,25,68.0,0.039203999999999996,89.56
1110,2556,8694,22,12,34,64.71,0.02552352941176471,39.85294117647059
1201,4851,4039,21,16,37,56.76,0.013716216216216215,31.405405405405407
1203,3308,14292,17,11,28,60.71,0.025760714285714286,70.0
1210,4441,-35971,10,19,29,34.48,-0.03280344827586207,52.44827586206897
1213,3262,-9142,18,22,40,45.0,-0.009300000000000001,51.9
1215,4258,-13018,15,16,31,48.39,-0.010493548387096771,41.354838709677416
1216,7417,44283,20,10,30,66.67,0.034379999999999994,64.6
1217,2145,1675,20,13,33,60.61,0.012463636363636364,57.03030303030303
1218,2562,11348,20,12,32,62.5,0.020959375000000002,43.90625
1219,1928,13522,19,5,24,79.17,0.045099999999999994,101.45833333333333
1220,1640,410,13,12,25,52.0,1.5999999999999904e-05,99.48
1225,4366,7574,21,10,31,67.74,0.02861935483870968,35.58064516129032
1227,6386,-33486,12,10,22,54.55,-0.0069545454545454554,104.22727272727273
1229,2339,-10189,10,10,20,50.0,-0.011525,64.4
1231,3520,-6210,13,13,26,50.0,-0.009869230769230767,64.53846153846153
1232,5293,39707,12,5,17,70.59,0.038970588235294125,141.1764705882353
1233,4065,-5365,11,9,20,55.0,0.003750000000000002,138.9
1234,3434,2686,16,9,25,64.0,0.010295999999999998,97.08
1235,3669,4681,16,11,27,59.26,0.012248148148148149,37.03703703703704
1236,2384,5246,14,10,24,58.33,0.018375,126.375
1256,20896,-241396,5,13,18,27.78,-0.05068333333333333,21.666666666666668
1301,9219,-20619,10,12,22,45.45,-0.013918181818181817,67.36363636363636
1303,9173,-1273,16,12,28,57.14,0.008571428571428574,57.5
1304,3395,-20765,15,21,36,41.67,-0.031236111111111107,60.05555555555556
1305,3592,-9402,21,20,41,51.22,-0.005987804878048781,28.926829268292682
1307,4476,-876,18,14,32,56.25,0.007318750000000001,67.03125
1308,4600,850,20,17,37,54.05,0.003908108108108106,45.432432432432435
1309,2973,-6703,20,19,39,51.28,-0.004417948717948717,31.307692307692307
1310,4054,-17014,22,24,46,47.83,-0.014902173913043475,31.5
1312,3499,-16119,17,24,41,41.46,-0.020060975609756098,31.70731707317073
1313,3040,-24300,12,25,37,32.43,-0.043572972972972975,37.21621621621622
1314,3070,-10170,17,21,38,44.74,-0.01908421052631579,38.578947368421055
1315,4135,11485,16,10,26,61.54,0.019203846153846155,66.1923076923077
1316,3518,-15668,24,28,52,46.15,-0.02361346153846154,21.615384615384617
1319,10379,14821,28,26,54,51.85,0.007662962962962965,29.59259259259259
1321,4459,3391,19,17,36,52.78,0.005861111111111109,45.80555555555556
1323,3510,-8420,13,14,27,48.15,-0.012055555555555555,73.07407407407408
1324,2956,-3376,16,21,37,43.24,-0.004856756756756753,59.945945945945944
1325,7183,-6803,19,18,37,51.35,0.003475675675675675,73.4054054054054
1326,10824,-63874,13,16,29,44.83,-0.023210344827586205,78.89655172413794
1337,3888,-54828,6,22,28,21.43,-0.0765392857142857,33.82142857142857
1338,8422,-66172,8,12,20,40.0,-0.035524999999999994,46.25
1339,4557,-12457,8,9,17,47.06,0.004376470588235291,52.35294117647059
1340,6359,-45539,10,16,26,38.46,-0.031973076923076924,37.53846153846154
1341,791,12909,2,0,2,100.0,0.10389999999999999,154.5
1342,341,5359,1,0,1,100.0,0.0992,209.0
1402,5500,17950,22,12,34,64.71,0.025641176470588237,50.73529411764706
1409,2335,-5645,18,17,35,51.43,-0.01283714285714286,35.57142857142857
1410,2504,8496,17,10,27,62.96,0.025303703703703703,60.44444444444444
1413,2731,-3891,24,26,50,48.0,-0.009486,32.38
1414,2360,2070,20,21,41,48.78,-0.002021951219512191,34.609756097560975
1416,2831,-13831,18,20,38,47.37,-0.015605263157894737,38.68421052631579
1417,1984,-15864,11,23,34,32.35,-0.0604235294117647,44.05882352941177
1418,2953,3537,30,23,53,56.6,0.0035358490566037757,21.245283018867923
1419,5527,12023,16,16,32,50.0,0.0036531250000000006,60.0
1423,2028,4562,18,15,33,54.55,0.015227272727272732,63.333333333333336
1432,3726,-10866,20,29,49,40.82,-0.0343734693877551,33.183673469387756
1434,4333,12267,21,8,29,72.41,0.023920689655172415,93.96551724137932
1435,2692,-4532,23,23,46,50.0,-0.005789130434782605,36.17391304347826
1436,4032,17508,19,8,27,70.37,0.04049259259259259,57.851851851851855
1437,3625,-6215,20,19,39,51.28,-0.004223076923076923,37.76923076923077
1438,1886,-736,22,16,38,57.89,0.008542105263157896,20.210526315789473
1439,4343,18617,25,15,40,62.5,0.034955,36.225
1440,3580,-1060,25,20,45,55.56,-0.0024866666666666665,39.577777777777776
1441,2842,-3692,24,24,48,50.0,-0.005668749999999996,30.604166666666668
1442,3332,-19302,12,20,32,37.5,-0.022434375,52.15625
1443,2193,-1083,19,22,41,46.34,-0.02115609756097561,24.926829268292682
1444,2736,1484,23,20,43,53.49,-0.001669767441860462,39.30232558139535
1445,1515,-305,14,11,25,56.0,0.0017159999999999992,76.08
1446,3212,-13122,16,20,36,44.44,-0.018972222222222224,30.694444444444443
1447,3062,1588,30,18,48,62.5,0.01397916666666667,30.625
1449,3169,981,30,31,61,49.18,0.012731147540983607,23.868852459016395
1451,4705,-15975,18,21,39,46.15,-0.015153846153846153,56.205128205128204
1452,2668,-5538,16,17,33,48.48,-0.007139393939393937,49.96969696969697
1453,2359,-39,21,21,42,50.0,-0.011659523809523812,42.26190476190476
1454,1681,5289,18,10,28,64.29,0.028750000000000005,73.0
1455,2954,-1084,20,23,43,46.51,-0.007444186046511626,43.0
1456,3491,-91,34,30,64,53.12,0.004642187499999995,22.71875
1457,2113,-2163,18,18,36,50.0,-0.011205555555555557,32.94444444444444
1459,2725,-4825,20,21,41,48.78,-0.010960975609756103,42.73170731707317
1460,2264,-16914,11,25,36,30.56,-0.05080833333333334,46.22222222222222
1463,2592,-6352,18,20,38,47.37,-0.012031578947368421,27.13157894736842
1464,3273,-6933,18,20,38,47.37,-0.012805263157894735,40.078947368421055
1465,2425,5155,20,11,31,64.52,0.02153548387096774,79.38709677419355
1466,3696,-19606,17,31,48,35.42,-0.03841041666666667,32.354166666666664
1467,2750,-6910,18,19,37,48.65,-0.026329729729729728,42.027027027027025
1468,2539,24091,26,7,33,78.79,0.06676363636363637,71.6969696969697
1470,1981,14379,18,8,26,69.23,0.043973076923076934,51.57692307692308
1471,5231,-6481,29,29,58,50.0,-0.005501724137931033,17.362068965517242
1472,4697,-31637,20,37,57,35.09,-0.040905263157894736,25.964912280701753
1473,5681,-29431,15,19,34,44.12,-0.024676470588235296,87.41176470588235
1474,2381,-8601,16,20,36,44.44,-0.024622222222222222,58.77777777777778
1475,4984,-32484,28,35,63,44.44,-0.011077777777777778,18.666666666666668
1476,36968,30942,17,17,34,50.0,-0.009014705882352939,28.558823529411764
1477,22358,-96658,13,21,34,38.24,-0.03057647058823529,44.794117647058826
1503,4074,29526,15,6,21,71.43,0.04777619047619049,133.66666666666666
1504,3584,-1174,18,15,33,54.55,0.004963636363636365,44.878787878787875
1506,3712,-1432,21,19,40,52.5,0.0034950000000000007,39.925
1512,2909,1071,25,23,48,52.08,0.006218749999999996,26.708333333333332
1513,3205,17995,19,10,29,65.52,0.030693103448275867,58.58620689655172
1514,2274,-1104,17,15,32,53.12,-0.007253125000000002,36.53125
1515,7149,-33959,20,30,50,40.0,-0.02395,35.44
1516,4126,15674,28,27,55,50.91,0.040381818181818185,23.490909090909092
1517,2656,-11276,16,21,37,43.24,-0.021543243243243245,50.054054054054056
1519,4138,-1048,16,17,33,48.48,-0.006954545454545454,50.78787878787879
1521,9478,-13278,16,21,37,43.24,-0.021286486486486487,68.1891891891892
1522,5608,-15608,22,21,43,51.16,0.0017930232558139522,39.55813953488372
1524,2696,-6406,18,20,38,47.37,-0.011071052631578948,48.473684210526315
1525,13291,54409,26,21,47,55.32,0.01823404255319149,36.191489361702125
1526,4233,3637,22,19,41,53.66,0.00341219512195122,26.926829268292682
1527,10385,-28885,18,26,44,40.91,-0.024450000000000006,34.61363636363637
1528,2867,-14177,16,23,39,41.03,-0.026461538461538463,48.43589743589744
1529,3884,15956,35,34,69,50.72,0.11114057971014495,13.347826086956522
1530,7549,-11949,16,18,34,47.06,-0.012523529411764704,39.88235294117647
1531,5688,-31188,16,27,43,37.21,-0.03065116279069767,49.651162790697676
1532,7059,-35459,19,24,43,44.19,-0.019869767441860465,41.372093023255815
1533,8363,-19443,22,29,51,43.14,-0.013260784313725493,27.92156862745098
1535,6117,-6117,15,12,27,55.56,0.012111111111111107,61.074074074074076
1536,11331,-24831,19,22,41,46.34,-0.009065853658536585,23.70731707317073
1537,10075,10825,15,19,34,44.12,-0.01748823529411765,68.05882352941177
1538,6352,-20832,31,28,59,52.54,0.00994406779661017,16.1864406779661
1539,4080,-20430,19,29,48,39.58,-0.030929166666666664,30.104166666666668
1540,4414,-2464,21,17,38,55.26,0.0074500000000000035,53.86842105263158
1541,6445,-10985,25,28,53,47.17,-0.0015094339622641502,37.35849056603774
1558,12162,-53562,7,12,19,36.84,-0.03351052631578948,93.94736842105263
1560,15275,-36925,24,22,46,52.17,-0.008147826086956524,18.91304347826087
1568,2273,-12323,7,12,19,36.84,-0.021731578947368425,25.63157894736842
1582,13523,-49273,16,17,33,48.48,-0.018184848484848484,37.90909090909091
1583,7634,30416,19,9,28,67.86,0.024517857142857143,45.535714285714285
1587,2213,-4763,7,12,19,36.84,-0.01639473684210526,58.8421052631579
1589,10866,-48816,9,13,22,40.91,-0.03139090909090909,31.227272727272727
1590,49362,254638,16,11,27,59.26,0.021229629629629626,15.074074074074074
1597,6456,-61956,6,13,19,31.58,-0.051126315789473686,25.63157894736842
1598,4940,-40390,5,11,16,31.25,-0.03250625,31.0625
1603,2825,4955,22,13,35,62.86,0.003677142857142855,48.457142857142856
1604,2474,-3254,21,17,38,55.26,-0.005373684210526311,41.05263157894737
1605,2918,-13118,16,23,39,41.03,-0.022182051282051283,26.358974358974358
1608,2282,-782,16,17,33,48.48,-0.008257575757575757,45.24242424242424
1609,2412,98,20,16,36,55.56,-0.005197222222222222,53.833333333333336
1611,2963,2717,20,16,36,55.56,0.01391666666666667,53.47222222222222
1612,2487,-277,18,13,31,58.06,0.005548387096774193,53.16129032258065
1614,3920,6230,15,12,27,55.56,0.011974074074074071,86.70370370370371
1615,2320,4700,18,12,30,60.0,0.008756666666666668,63.56666666666667
1616,2477,-7107,20,21,41,48.78,-0.01581219512195122,38.19512195121951
1617,2832,-2002,20,20,40,50.0,-0.0047799999999999995,47.525
1618,3056,-7726,19,23,42,45.24,-0.016166666666666673,37.57142857142857
1626,5203,-36353,13,17,30,43.33,-0.022626666666666666,30.866666666666667
1701,3165,8385,18,13,31,58.06,0.01833548387096774,75.35483870967742
1702,5695,-25865,17,17,34,50.0,-0.004623529411764711,46.38235294117647
1707,15885,9365,18,10,28,64.29,0.029874999999999992,62.5
1708,4269,10741,19,9,28,67.86,0.022546428571428575,55.67857142857143
1709,1825,-5995,10,12,22,45.45,-0.013195454545454545,110.68181818181819
1710,5901,-20301,18,22,40,45.0,-0.016165000000000002,42.5
1711,3940,-11480,19,20,39,48.72,-0.006482051282051282,41.05128205128205
1712,1814,2896,16,9,25,64.0,0.017704,54.36
1713,2404,7866,19,11,30,63.33,0.02723333333333333,66.93333333333334
1714,2790,-3100,19,21,40,47.5,-0.007419999999999999,43.225
1717,5692,-5492,19,17,36,52.78,-0.0021472222222222222,45.47222222222222
1718,3241,-5361,23,24,47,48.94,-0.014002127659574466,32.170212765957444
1720,4682,12518,17,13,30,56.67,0.015853333333333337,79.96666666666667
1721,2892,8338,29,14,43,67.44,0.038804651162790686,41.97674418604651
1722,8177,-37727,11,12,23,47.83,-0.012760869565217393,81.26086956521739
1723,16344,-29144,14,14,28,50.0,-0.005624999999999999,60.142857142857146
1725,3404,-1754,18,15,33,54.55,-0.0003909090909090918,83.57575757575758
1726,6635,-5885,11,10,21,52.38,0.0009000000000000037,103.0
1727,2817,4203,19,11,30,63.33,0.017379999999999996,76.46666666666667
1730,4443,5377,15,12,27,55.56,0.01754074074074074,53.81481481481482
1731,2902,3418,20,15,35,57.14,0.009642857142857147,65.34285714285714
1732,2984,-7644,17,18,35,48.57,-0.012325714285714287,54.857142857142854
1733,9718,-19768,19,20,39,48.72,-0.011666666666666667,60.30769230769231
1734,5304,-6504,17,19,36,47.22,0.004700000000000003,58.888888888888886
1735,3268,642,21,15,36,58.33,0.004955555555555554,78.02777777777777
1736,16720,-75020,22,22,44,50.0,-0.010868181818181815,29.795454545454547
1737,4756,4554,20,15,35,57.14,0.009485714285714283,54.48571428571429
1760,23869,-43859,20,22,42,47.62,0.004535714285714286,25.976190476190474
1762,5358,-7208,13,10,23,56.52,-0.00534782608695652,46.04347826086956
1773,2966,12984,6,3,9,66.67,0.014722222222222223,87.44444444444444
1776,863,-13,4,4,8,50.0,0.008337500000000005,137.125
1783,3986,-8936,10,13,23,43.48,-0.02236521739130435,24.956521739130434
1786,7639,-17289,12,13,25,48.0,-0.002968,19.32
1789,5369,-22419,12,11,23,52.17,-0.0009608695652173875,57.608695652173914
1795,9156,-34556,14,14,28,50.0,-0.005332142857142854,23.0
1802,5044,-12684,15,23,38,39.47,-0.026881578947368416,50.078947368421055
1805,3335,-405,32,25,57,56.14,-0.0005631578947368444,23.912280701754387
1806,2647,-9547,17,20,37,45.95,-0.031616216216216214,45.62162162162162
1808,5975,-13255,18,15,33,54.55,-0.0010636363636363643,46.78787878787879
1809,2903,-8073,20,18,38,52.63,-0.011202631578947367,36.76315789473684
1810,2195,-5565,16,17,33,48.48,-0.016881818181818182,52.72727272727273
1817,2131,-16781,4,7,11,36.36,-0.0439,103.54545454545455
1903,8933,-15883,20,21,41,48.78,-0.0037195121951219493,50.68292682926829
1904,2679,4761,18,11,29,62.07,0.006886206896551726,68.34482758620689
1905,2686,-6716,15,18,33,45.45,-0.014603030303030305,54.878787878787875
1906,2604,-8734,15,21,36,41.67,-0.027508333333333336,33.55555555555556
1907,2532,-7182,15,16,31,48.39,-0.011970967741935483,57.096774193548384
1909,3605,-25235,17,25,42,40.48,-0.02796190476190476,41.45238095238095
2002,3714,-19464,10,13,23,43.48,-0.022478260869565215,140.30434782608697
2006,5905,28445,23,14,37,62.16,0.026359459459459462,40.108108108108105
2007,2516,-13086,15,28,43,34.88,-0.04169069767441861,33.674418604651166
2008,2559,-9749,17,23,40,42.5,-0.023650000000000004,42.85
2009,2817,-14317,15,20,35,42.86,-0.02854,44.17142857142857
2010,2454,-3304,13,16,29,44.83,-0.011320689655172413,99.82758620689656
2012,2413,4857,21,10,31,67.74,0.02440967741935484,44.774193548387096
2013,3412,-1962,13,13,26,50.0,-0.0063461538461538425,66.76923076923077
2014,3670,-19460,17,27,44,38.64,-0.03500227272727272,40.84090909090909
2015,6751,-4201,14,14,28,50.0,0.0013571428571428601,70.03571428571429
2017,2390,-15400,15,23,38,39.47,-0.035694736842105265,48.921052631578945
2020,3274,-12824,15,17,32,46.88,-0.0049281249999999985,69.5
2022,2715,-10515,21,25,46,45.65,-0.029891304347826088,32.34782608695652
2023,3286,-586,23,16,39,58.97,0.002005128205128206,55.205128205128204
2024,1989,-699,17,16,33,51.52,-0.008048484848484843,38.57575757575758
2025,2713,-10343,23,27,50,46.0,-0.029902,12.92
2027,5745,-20695,21,21,42,50.0,-0.011778571428571428,33.54761904761905
2028,3627,-4547,28,29,57,49.12,-0.01053157894736842,19.19298245614035
2029,5538,-12488,17,21,38,44.74,-0.0112,59.05263157894737
2030,3528,-6158,19,19,38,50.0,-0.007592105263157894,34.60526315789474
2031,5879,-41829,15,26,41,36.59,-0.03547073170731707,43.5609756097561
2032,3642,-8302,19,22,41,46.34,-0.011846341463414633,43.926829268292686
2033,3264,10526,26,14,40,65.0,0.033147499999999996,62.125
2034,5125,-26575,15,23,38,39.47,-0.023678947368421056,40.421052631578945
2038,2110,-10340,7,18,25,28.0,-0.044608,63.4
2049,43611,-9611,18,15,33,54.55,0.0016333333333333339,21.696969696969695
2059,44498,53302,18,15,33,54.55,0.00785757575757576,37.42424242424242
2062,6468,-4468,16,16,32,50.0,0.005715625,48.65625
2069,994,-12344,2,6,8,25.0,-0.077225,98.0
2101,7240,20760,22,15,37,59.46,0.017613513513513514,43.432432432432435
2102,4368,-8208,21,22,43,48.84,-0.004958139534883721,44.883720930232556
2103,7185,-34235,14,23,37,37.84,-0.031383783783783786,37.648648648648646
2104,4200,-40950,11,18,29,37.93,-0.04145172413793103,40.51724137931034
2105,11021,-24971,18,22,40,45.0,-0.014189999999999998,59.9
2106,6634,-32784,16,22,38,42.11,-0.018339473684210527,69.1842105263158
2107,3879,8081,24,13,37,64.86,0.02917297297297297,46.5945945945946
2108,6784,-38384,19,21,40,47.5,-0.0066725000000000005,44.525
2109,3403,-1583,25,22,47,53.19,0.0025021276595744665,34.95744680851064
2114,7140,-34240,7,13,20,35.0,-0.027765,86.9
2115,3510,-25810,6,9,15,40.0,-0.03344666666666666,54.46666666666667
2201,7581,-38881,17,24,41,41.46,-0.026921951219512193,52.048780487804876
2204,6170,-2880,18,21,39,46.15,0.007338461538461542,50.07692307692308
2206,4122,8938,22,13,35,62.86,0.015694285714285716,48.05714285714286
2207,38843,-119143,18,14,32,56.25,0.006703124999999999,49.0625
2208,2629,-8129,9,13,22,40.91,-0.01873636363636363,71.36363636363636
2227,30412,12538,15,20,35,42.86,-0.012102857142857148,58.34285714285714
2228,12423,-42823,9,12,21,42.86,-0.016657142857142853,35.333333333333336
2231,26838,-163688,11,16,27,40.74,-0.017359259259259255,21.85185185185185
2233,9216,-11916,11,9,20,55.0,-0.01013,17.55
2236,3642,11158,13,6,19,68.42,0.015173684210526317,18.210526315789473
2239,9812,-89312,5,13,18,27.78,-0.04976666666666666,26.27777777777778
2241,2536,-43066,3,5,8,37.5,-0.0867125,35.125
2243,1137,-7067,6,6,12,50.0,-0.017666666666666667,18.166666666666668
2247,1213,-11213,0,1,1,0.0,-0.0522,395.0
2301,7605,-13155,18,17,35,51.43,-0.005288571428571428,41.48571428571429
2302,2385,-285,23,19,42,54.76,0.0027142857142857116,27.428571428571427
2303,4123,1217,20,18,38,52.63,0.004571052631578945,39.73684210526316
2305,2542,-4502,22,24,46,47.83,-0.015580434782608694,28.17391304347826
2308,21076,6124,17,15,32,53.12,0.006825000000000002,41.125
2312,2925,3665,25,15,40,62.5,0.012247499999999996,46.6
2313,5024,-7564,26,23,49,53.06,0.0004183673469387756,18.489795918367346
2314,5175,-5445,24,27,51,47.06,-0.012843137254901962,15.411764705882353
2316,4243,4877,26,21,47,55.32,0.00811702127659574,28.872340425531913
2317,26730,7570,23,18,41,56.1,0.001317073170731709,37.97560975609756
2321,3421,409,31,26,57,54.39,-0.0005350877192982483,20.70175438596491
2323,3029,-10599,24,23,47,51.06,-0.010240425531914895,29.23404255319149
2324,5987,-25637,18,22,40,45.0,-0.0186625,64.3
2327,29434,-71774,26,21,47,55.32,-0.0002680851063829787,19.74468085106383
2328,8466,-25566,22,25,47,46.81,-0.007202127659574467,22.127659574468087
2329,3501,-5461,28,29,57,49.12,-0.0028807017543859624,19.50877192982456
2330,16806,40394,14,8,22,63.64,0.02570454545454546,59.27272727272727
2331,5844,-15544,26,31,57,45.61,-0.009635087719298245,20.526315789473685
2332,5871,-34331,14,26,40,35.0,-0.034517500000000007,31.05
2337,4322,-30052,19,32,51,37.25,-0.04065882352941176,18.764705882352942
2338,4220,8970,25,13,38,65.79,0.019768421052631574,43.31578947368421
2340,4387,-5997,25,22,47,53.19,-0.00874468085106383,18.085106382978722
2342,6063,-7153,34,40,74,45.95,-0.013282432432432436,12.891891891891891
2344,3391,-7061,21,26,47,44.68,-0.013580851063829788,18.29787234042553
2345,10746,-38146,23,23,46,50.0,-0.012154347826086955,23.47826086956522
2347,9426,9574,21,14,35,60.0,0.011168571428571432,56.82857142857143
2348,7409,14701,32,30,62,51.61,-0.0038403225806451606,18.758064516129032
2349,3639,-3279,27,29,56,48.21,-0.012823214285714287,29.767857142857142
2351,7746,-20216,17,23,40,42.5,-0.027882499999999994,26.775
2352,5449,-4809,26,25,51,50.98,-0.010107843137254902,27.666666666666668
2353,8593,-49043,18,24,42,42.86,-0.02867142857142857,30.142857142857142
2354,21005,7295,19,18,37,51.35,-0.0030675675675675682,48.4054054054054
2355,6799,-36329,19,21,40,47.5,-0.023822500000000003,39.575
2356,4563,7227,26,17,43,60.47,0.01048139534883721,48.86046511627907
2357,34925,118925,22,16,38,57.89,0.10973684210526316,54.5
2358,4592,-11822,31,32,63,49.21,0.0008730158730158742,14.587301587301587
2359,3929,1801,31,18,49,63.27,0.0079265306122449,26.653061224489797
2360,14471,-44521,19,20,39,48.72,-0.008030769230769227,19.128205128205128
2362,7342,1898,22,17,39,56.41,0.009764102564102562,38.794871794871796
2363,4282,-2652,29,25,54,53.7,-0.007162962962962962,18.666666666666668
2364,3133,-5423,30,33,63,47.62,-0.016650793650793642,20.365079365079364
2365,5585,-20655,21,26,47,44.68,-0.020176595744680847,43.06382978723404
2367,4269,-7219,25,25,50,50.0,-0.004671999999999999,16.9
2368,3152,-8882,22,17,39,56.41,0.0010102564102564115,19.46153846153846
2369,3295,-14065,19,23,42,45.24,-0.024154761904761908,22.071428571428573
2371,3583,-2973,27,21,48,56.25,0.0001729166666666644,18.604166666666668
2373,6044,32356,16,7,23,69.57,0.03836086956521739,97.08695652173913
2374,7919,-38129,26,29,55,47.27,-0.020032727272727275,36.92727272727273
2375,5295,-26435,22,23,45,48.89,-0.013831111111111112,24.333333333333332
2376,10207,-49857,19,26,45,42.22,-0.020073333333333332,34.86666666666667
2377,10899,-39599,22,22,44,50.0,-0.014834090909090908,30.795454545454547
2379,23364,-24114,23,22,45,51.11,-0.007111111111111112,20.11111111111111
2380,3697,-15057,20,26,46,43.48,-0.026580434782608697,34.869565217391305
2382,13049,-15649,21,19,40,52.5,-0.0005874999999999977,39.5
2383,10018,-5438,22,19,41,53.66,-0.004026829268292685,20.878048780487806
2385,11226,-78526,15,22,37,40.54,-0.02717567567567568,50.945945945945944
2387,7568,-11918,26,25,51,50.98,-0.0004509803921568659,36.490196078431374
2388,7611,-32611,23,38,61,37.7,-0.02406229508196721,16.16393442622951
2390,4562,5368,31,26,57,54.39,0.008033333333333335,25.719298245614034
2392,15412,65538,29,20,49,59.18,0.01970612244897959,36.48979591836735
2393,13842,-60692,19,26,45,42.22,-0.02078444444444444,31.177777777777777
2395,18836,60564,15,10,25,60.0,0.013580000000000002,40.64
2397,7754,-16654,17,15,32,53.12,-0.003743749999999999,48.53125
2399,4409,-13899,24,28,52,46.15,-0.015726923076923076,20.03846153846154
2401,7414,-29044,25,26,51,49.02,-0.012754901960784312,25.705882352941178
2402,6965,5275,30,23,53,56.6,0.011745283018867922,21.11320754716981
2404,8802,38298,20,14,34,58.82,0.01679117647058824,57.85294117647059
2405,5468,20342,42,19,61,68.85,0.027273770491803274,18.918032786885245
2406,6519,-25109,34,36,70,48.57,-0.017661428571428568,14.471428571428572
2408,9088,-61868,24,38,62,38.71,-0.03670967741935484,17.612903225806452
2409,6733,-32743,21,30,51,41.18,-0.024858823529411756,24.11764705882353
2412,3574,126,6,3,9,66.67,-0.002588888888888889,509.22222222222223
2413,4811,-4051,28,29,57,49.12,-0.008840350877192983,21.789473684210527
2414,2525,-4535,14,14,28,50.0,-0.007910714285714283,43.892857142857146
2415,4313,-27633,20,27,47,42.55,-0.02300425531914894,26.80851063829787
2417,7191,-31101,19,28,47,40.43,-0.01897446808510638,28.872340425531913
2419,3965,1035,23,24,47,48.94,-0.00430851063829787,23.127659574468087
2420,5427,-16457,20,19,39,51.28,-0.01028205128205128,45.97435897435897
2421,5870,-920,24,19,43,55.81,0.0123953488372093,38.55813953488372
2423,3935,-1635,19,15,34,55.88,-0.0003470588235294111,56.794117647058826
2424,5658,21052,34,19,53,64.15,0.01764150943396226,22.0
2425,5364,4806,30,27,57,52.63,0.005412280701754385,23.526315789473685
2426,5076,-10046,30,26,56,53.57,-0.013346428571428568,19.107142857142858
2427,2699,-5049,21,19,40,52.5,-0.008905,34.425
2428,9960,-15360,20,20,40,50.0,-0.006932500000000004,34.45
2429,5009,1001,40,36,76,52.63,0.03973421052631579,16.61842105263158
2430,7923,-47423,16,27,43,37.21,-0.035955813953488375,60.116279069767444
2431,4216,-7896,26,29,55,47.27,-0.01204727272727273,25.09090909090909
2433,3927,-677,17,9,26,65.38,0.027034615384615383,84.5
2434,4205,-5425,23,27,50,46.0,-0.012776000000000001,29.54
2436,6094,-20294,28,20,48,58.33,0.001614583333333337,21.458333333333332
2438,3863,-9333,24,42,66,36.36,-0.029690909090909087,17.893939393939394
2439,24487,-54137,29,22,51,56.86,-0.007454901960784313,21.45098039215686
2440,3378,-9458,23,31,54,42.59,-0.016270370370370373,24.24074074074074
2441,6011,-23161,16,16,32,50.0,-0.0133625,47.75
2442,3347,-3587,26,26,52,50.0,0.002767307692307697,21.134615384615383
2443,3597,-14127,25,41,66,37.88,-0.04029545454545455,18.818181818181817
2444,5187,-2527,33,32,65,50.77,-0.0014723076923076975,15.938461538461539
2449,5400,18400,27,16,43,62.79,0.010267441860465116,25.25581395348837
2450,8432,-41482,15,21,36,41.67,-0.02080555555555556,59.47222222222222
2451,15124,-14724,18,16,34,52.94,-0.0014764705882352944,63.5
2453,2676,-966,19,17,36,52.78,0.0012111111111111107,37.02777777777778
2454,71699,-214699,17,22,39,43.59,-0.006830769230769229,23.512820512820515
2455,12466,-29766,26,27,53,49.06,-0.0011169811320754723,14.754716981132075
2457,5843,-16763,27,28,55,49.09,-0.020419999999999997,20.545454545454547
2458,12480,-27480,24,24,48,50.0,-0.015929166666666664,21.5
2459,7133,-11443,18,21,39,46.15,-0.008541025641025641,36.64102564102564
2460,5785,-23095,23,29,52,44.23,-0.017292307692307694,34.25
2461,4516,-29206,17,26,43,39.53,-0.03277441860465116,32.86046511627907
2462,5553,-13953,21,22,43,48.84,-0.0007441860465116241,41.74418604651163
2464,5338,6062,17,15,32,53.12,0.005765625,47.90625
2465,5354,-19454,27,35,62,43.55,-0.02801935483870968,17.93548387096774
2466,5064,19756,21,13,34,61.76,0.033444117647058826,81.23529411764706
2467,4318,7012,22,16,38,57.89,0.00945,40.28947368421053
2468,2870,15050,25,14,39,64.1,0.03411794871794871,34.76923076923077
2471,3510,-3980,23,19,42,54.76,-0.004161904761904762,42.404761904761905
2472,6977,-16807,24,28,52,46.15,-0.019994230769230768,25.653846153846153
2474,48426,45574,29,20,49,59.18,0.01669795918367347,19.102040816326532
2476,5979,2721,25,16,41,60.98,0.014658536585365858,41.24390243902439
2477,5922,-18502,25,23,48,52.08,-0.010031249999999997,32.104166666666664
2478,9266,-19616,27,25,52,51.92,-0.003159615384615384,22.25
2480,4483,3967,16,14,30,53.33,0.0007300000000000043,70.13333333333334
2481,6898,-25198,23,29,52,44.23,-0.014415384615384616,15.961538461538462
2482,4501,-4901,23,20,43,53.49,0.007072093023255811,40.651162790697676
2483,3646,-7226,18,19,37,48.65,-0.011427027027027031,47.351351351351354
2484,3589,-3669,20,18,38,52.63,0.0017763157894736877,22.289473684210527
2485,9497,-60697,22,25,47,46.81,-0.026236170212765954,31.595744680851062
2486,6333,-20973,27,27,54,50.0,-0.008601851851851854,25.703703703703702
2488,5546,-19916,19,24,43,44.19,-0.014683720930232557,41.906976744186046
2489,5430,-15110,22,28,50,44.0,-0.026634,36.12
2491,4234,-4544,28,42,70,40.0,-0.004240000000000006,11.32857142857143
2492,15430,-58540,24,26,50,48.0,-0.007405999999999999,20.28
2493,3060,170,16,14,30,53.33,0.006793333333333331,59.56666666666667
2495,9934,-40184,26,25,51,50.98,0.0010529411764705879,36.98039215686274
2496,10494,-93234,28,38,66,42.42,-0.024556060606060602,23.606060606060606
2497,8838,-46038,28,28,56,50.0,-0.019839285714285716,22.375
2498,83926,-464626,21,34,55,38.18,-0.03433454545454546,19.254545454545454
2501,3315,-13975,16,23,39,41.03,-0.020238461538461535,45.12820512820513
2504,2683,3127,21,15,36,58.33,0.012086111111111112,45.27777777777778
2505,4046,-10496,22,22,44,50.0,-0.0075295454545454546,29.022727272727273
2506,2360,-530,22,20,42,52.38,-0.019052380952380956,48.19047619047619
2509,5382,-10942,22,27,49,44.9,-0.007936734693877552,36.63265306122449
2511,3127,-18297,15,24,39,38.46,-0.035925641025641025,41.743589743589745
2514,3845,13115,27,17,44,61.36,0.022345454545454547,33.43181818181818
2515,2055,445,21,14,35,60.0,0.010774285714285714,43.08571428571429
2516,2368,-7518,17,25,42,40.48,-0.03185238095238095,46.357142857142854
2520,5082,-2702,27,21,48,56.25,0.0006812500000000013,22.0625
2524,6919,-2969,24,21,45,53.33,0.0022977777777777814,38.666666666666664
2527,3658,4102,24,21,45,53.33,0.006742222222222222,28.77777777777778
2528,3901,-15271,28,34,62,45.16,-0.02997903225806452,26.14516129032258
2530,2947,9213,29,17,46,63.04,0.021695652173913046,24.869565217391305
2534,3351,-8131,16,16,32,50.0,-0.012193750000000001,28.5625
2535,3089,-5759,17,15,32,53.12,-0.0008906250000000025,39.71875
2536,5563,-19463,17,20,37,45.95,-0.014137837837837838,54.108108108108105
2537,2602,-162,19,21,40,47.5,-0.01797,48.55
2538,3717,-11847,23,22,45,51.11,-0.006328888888888884,35.577777777777776
2539,4387,15183,25,15,40,62.5,0.022555,49.675
2540,4364,17216,26,23,49,53.06,-0.01078775510204081,21.224489795918366
2542,7764,-11464,15,19,34,44.12,-0.010941176470588237,28.794117647058822
2543,2446,-4096,20,19,39,51.28,-0.008553846153846157,55.17948717948718
2545,10975,-42075,19,30,49,38.78,-0.01946734693877551,27.551020408163264
2546,3062,-4262,15,18,33,45.45,-0.01600606060606061,37.84848484848485
2547,6230,-32420,27,30,57,47.37,-0.018147368421052634,22.45614035087719
2548,10922,40198,18,14,32,56.25,0.011990624999999998,45.5625
2597,6934,-14684,12,12,24,50.0,-0.010833333333333334,52.541666666666664
2601,6170,-35950,19,27,46,41.3,-0.03153478260869565,27.456521739130434
2603,4084,5506,20,16,36,55.56,0.008749999999999997,41.166666666666664
2605,5694,-29044,15,22,37,40.54,-0.02655135135135135,46.62162162162162
2606,7975,-4425,18,15,33,54.55,0.0003454545454545419,54.63636363636363
2607,3121,-6621,17,17,34,50.0,-0.003476470588235297,52.088235294117645
2608,3698,-18038,11,14,25,44.0,-0.027235999999999993,48.68
2609,4281,-4331,23,22,45,51.11,-0.012531111111111111,39.13333333333333
2610,2633,-10123,16,18,34,47.06,-0.027244117647058825,69.32352941176471
2611,2778,-1818,20,17,37,54.05,0.0008945945945945974,60.648648648648646
2612,7845,-31645,18,18,36,50.0,-0.009708333333333334,38.083333333333336
2613,2629,-15589,14,17,31,45.16,-0.01672580645161291,51.87096774193548
2614,3430,-1950,27,23,50,54.0,-0.0028359999999999995,20.68
2615,7152,21348,14,21,35,40.0,-0.015351428571428575,42.714285714285715
2616,2205,6775,12,7,19,63.16,0.021257894736842104,136.52631578947367
2617,4974,-28924,13,19,32,40.62,-0.027896875,55.8125
2618,3103,11917,21,13,34,61.76,0.03316470588235294,52.55882352941177
2630,1273,-8373,6,6,12,50.0,-0.021741666666666663,35.916666666666664
2633,1042,-4742,2,4,6,33.33,-0.027366666666666668,98.16666666666667
2634,1932,4068,6,4,10,60.0,0.02374,103.3
2636,3979,-1679,10,11,21,47.62,0.002909523809523811,68.0
2637,2966,334,8,7,15,53.33,-0.0004933333333333322,135.0
2642,3160,-9660,7,9,16,43.75,-0.008906250000000001,54.375
2701,2141,3559,16,10,26,61.54,0.01319230769230769,109.11538461538461
2702,4571,12229,21,17,38,55.26,0.013960526315789474,57.86842105263158
2704,4914,-5714,16,14,30,53.33,-0.0031366666666666695,75.83333333333333
2705,3396,8964,22,17,39,56.41,0.009553846153846149,45.205128205128204
2706,3679,1971,17,13,30,56.67,0.0088,80.76666666666667
2707,44551,-217251,14,17,31,45.16,-0.01948387096774194,58.32258064516129
2712,2061,-12911,6,5,11,54.55,-0.022390909090909097,98.0909090909091
2722,2616,10484,8,5,13,61.54,0.021107692307692306,130.07692307692307
2723,33150,-210550,12,20,32,37.5,-0.033321875,27.625
2727,23049,-252149,8,16,24,33.33,-0.04757083333333334,61.5
2731,7234,-59734,4,10,14,28.57,-0.04956428571428572,57.357142857142854
2739,1865,-5315,6,6,12,50.0,-0.004491666666666663,83.0
2748,2801,-5451,6,4,10,60.0,0.0016500000000000009,68.1
2801,2979,3171,17,13,30,56.67,0.006323333333333334,87.2
2809,3130,-12420,15,15,30,50.0,-0.01281,52.833333333333336
2812,1582,-7292,11,13,24,45.83,-0.032058333333333335,96.125
2816,4021,-8801,25,24,49,51.02,-0.002791836734693884,40.714285714285715
2820,1588,4242,14,9,23,60.87,0.016747826086956522,152.52173913043478
2832,3049,1401,15,12,27,55.56,0.008874074074074072,111.77777777777777
2834,2017,5313,18,12,30,60.0,0.031970000000000005,92.43333333333334
2836,2248,72,15,13,28,53.57,0.004699999999999998,91.25
2838,1434,886,12,10,22,54.55,0.011227272727272728,136.95454545454547
2841,2528,642,17,21,38,44.74,-0.008705263157894737,61.23684210526316
2845,2448,1312,17,16,33,51.52,0.0016454545454545463,77.3030303030303
2849,2429,10531,22,11,33,66.67,0.03630909090909091,47.63636363636363
2850,2464,-16564,8,15,23,34.78,-0.04346956521739131,55.869565217391305
2851,2111,-3761,13,12,25,52.0,-0.003303999999999998,71.24
2852,2491,-13911,13,18,31,41.94,-0.02767096774193548,60.70967741935484
2855,2803,-913,15,16,31,48.39,-0.0019290322580645133,52.70967741935484
2867,1322,-1532,7,9,16,43.75,-0.010631250000000002,69.875
2880,2843,4257,16,9,25,64.0,0.014444000000000002,119.68
2881,7129,21221,23,12,35,65.71,0.02940571428571428,48.628571428571426
2882,8220,-15170,16,16,32,50.0,-0.007665625000000001,50.1875
2883,2158,-7968,14,17,31,45.16,-0.019254838709677428,60.32258064516129
2884,3062,13338,18,11,29,62.07,0.020048275862068962,91.62068965517241
2885,3021,2529,19,14,33,57.58,0.014393939393939396,36.696969696969695
2886,4055,28605,22,10,32,68.75,0.04024375,64.875
2887,2930,-10900,15,19,34,44.12,-0.01926176470588235,52.970588235294116
2888,3586,-13286,18,22,40,45.0,-0.017245,35.75
2889,1630,-1820,12,12,24,50.0,-0.009012499999999998,115.29166666666667
2890,2634,-3734,18,17,35,51.43,-0.0032714285714285714,64.42857142857143
2891,3955,-8445,17,16,33,51.52,-0.009906060606060606,47.63636363636363
2892,3163,9337,18,9,27,66.67,0.020492592592592597,66.96296296296296
2897,305,-1995,2,3,5,40.0,-0.04888,195.8
2901,4474,4926,18,15,33,54.55,0.013409090909090909,99.63636363636364
2903,5612,-9462,22,19,41,53.66,-0.006190243902439023,45.926829268292686
2904,3350,-1760,18,23,41,43.9,-0.018897560975609753,57.68292682926829
2905,3776,-11546,19,21,40,47.5,-0.017157500000000003,51.075
2906,2148,9852,20,9,29,68.97,0.03557241379310345,100.27586206896552
2908,3239,4111,17,11,28,60.71,0.009946428571428568,119.78571428571429
2910,5232,26568,24,12,36,66.67,0.03694722222222222,37.05555555555556
2911,4616,3354,24,20,44,54.55,-0.00016363636363636347,40.36363636363637
2912,17084,62116,12,7,19,63.16,0.024194736842105262,137.1578947368421
2913,2981,4699,23,13,36,63.89,0.02070277777777778,30.583333333333332
2915,9409,-8059,16,19,35,45.71,0.00439428571428571,41.714285714285715
2923,2261,4289,11,6,17,64.71,0.014729411764705887,40.588235294117645
2929,8634,-39754,10,16,26,38.46,-0.031123076923076923,27.615384615384617
2936,1882,-12832,5,8,13,38.46,-0.02957692307692308,54.15384615384615
2939,7984,-8434,10,9,19,52.63,-0.009399999999999999,12.947368421052632
3002,3765,-4695,21,20,41,51.22,-0.0003585365853658531,53.73170731707317
3003,8282,-36382,19,26,45,42.22,-0.02703777777777778,43.44444444444444
3004,8305,22045,30,21,51,58.82,0.16475882352941176,20.098039215686274
3005,5176,-23076,18,24,42,42.86,-0.015926190476190476,26.5
3006,19171,-41971,34,31,65,52.31,-0.0013261538461538452,17.692307692307693
3008,456753,-976253,24,25,49,48.98,-0.009453061224489795,16.163265306122447
3010,8098,-29948,15,16,31,48.39,-0.017254838709677416,44.25806451612903
3011,3647,-9557,26,24,50,52.0,-0.012733999999999999,23.26
3013,4863,547,27,20,47,57.45,0.012412765957446812,34.57446808510638
3014,9316,-35316,23,23,46,50.0,-0.012678260869565217,22.847826086956523
3015,6129,-52329,13,26,39,33.33,-0.041910256410256405,35.53846153846154
3016,8889,-10749,28,25,53,52.83,-0.0024754716981132087,15.415094339622641
3017,6917,4033,29,20,49,59.18,0.01393469387755102,18.244897959183675
3018,5426,-24966,29,28,57,50.88,-0.004519298245614032,20.19298245614035
3019,21943,-3593,28,23,51,54.9,0.0005372549019607858,16.529411764705884
3021,3682,-12362,21,30,51,41.18,-0.027966666666666664,26.54901960784314
3022,8580,520,24,16,40,60.0,0.0072450000000000014,42.7
3023,8174,46116,20,13,33,60.61,0.012245454545454542,38.03030303030303
3024,4772,-5492,29,28,57,50.88,-0.0008456140350877187,25.087719298245613
3025,4568,-1818,28,27,55,50.91,0.0035600000000000007,22.727272727272727
3026,12114,-47614,20,19,39,51.28,-0.0073230769230769235,47.87179487179487
3027,4933,227,33,21,54,61.11,0.01375185185185185,32.03703703703704
3028,3485,-10365,15,18,33,45.45,-0.021796969696969697,76.42424242424242
3029,4310,14780,24,18,42,57.14,0.010933333333333333,20.404761904761905
3030,9414,54736,29,15,44,65.91,0.03722954545454546,35.04545454545455
3031,7180,-61650,18,33,51,35.29,-0.04285294117647057,21.058823529411764
3032,5744,-30484,19,31,50,38.0,-0.030912,36.94
3033,3121,-11151,14,16,30,46.67,-0.017226666666666668,85.03333333333333
3034,28526,-186476,17,24,41,41.46,-0.02202439024390244,23.29268292682927
3035,12267,-46517,21,25,46,45.65,-0.020191304347826088,24.543478260869566
3036,5116,11434,17,13,30,56.67,0.01855,51.766666666666666
3037,7750,-41150,23,27,50,46.0,-0.017190000000000004,20.4
3038,4295,-16395,26,27,53,49.06,-0.010150943396226414,21.58490566037736
3040,5621,-6241,24,18,42,57.14,0.007673809523809527,37.45238095238095
3041,10733,11007,36,27,63,57.14,0.007079365079365073,16.428571428571427
3042,8583,-4033,20,19,39,51.28,-0.009030769230769228,33.02564102564103
3043,8254,-25164,37,34,71,52.11,-0.015171830985915489,15.154929577464788
3044,17400,-94100,19,22,41,46.34,-0.021524390243902437,21.170731707317074
3045,7433,39467,13,6,19,68.42,0.025052631578947368,153.31578947368422
3046,5994,-11214,33,38,71,46.48,-0.008643661971830988,22.197183098591548
3047,4625,-14135,24,28,52,46.15,-0.02064038461538462,27.0
3048,6706,-13406,24,27,51,47.06,-0.022060784313725493,33.23529411764706
3049,4153,-21393,18,41,59,30.51,-0.04297627118644068,12.966101694915254
3050,4260,-10330,26,30,56,46.43,-0.021612500000000003,16.892857142857142
3051,7448,-17338,28,38,66,42.42,-0.027469696969696974,9.303030303030303
3052,2801,-8691,22,22,44,50.0,-0.011797727272727272,45.70454545454545
3054,7012,-29252,24,37,61,39.34,-0.02280819672131148,19.62295081967213
3055,5282,1268,24,19,43,55.81,0.0068976744186046495,36.25581395348837
3056,4414,-11824,19,28,47,40.43,-0.020642553191489357,38.42553191489362
3057,6882,-36262,26,35,61,42.62,-0.02711803278688524,21.37704918032787
3058,3866,-18516,22,28,50,44.0,-0.021842,34.06
3059,10970,-54570,27,31,58,46.55,-0.017274137931034488,19.5
3060,15173,-34273,27,26,53,50.94,-0.00046603773584905843,23.754716981132077
3062,9165,-21565,29,30,59,49.15,-0.006427118644067799,17.16949152542373
3090,6543,-16243,18,18,36,50.0,-0.005883333333333334,28.083333333333332
3094,6361,-19211,24,18,42,57.14,-0.0025547619047619043,25.833333333333332
3130,15854,2146,13,10,23,56.52,0.00562608695652174,64.43478260869566
3138,3261,21149,9,14,23,39.13,-0.024069565217391304,37.52173913043478
3149,5381,-34611,14,26,40,35.0,-0.04114249999999999,18.85
3164,6468,4382,16,14,30,53.33,0.004136666666666664,29.433333333333334
3167,4032,3468,10,7,17,58.82,0.006711764705882352,30.470588235294116
3189,16031,-72981,16,21,37,43.24,-0.018405405405405407,27.054054054054053
3209,3737,-1087,15,15,30,50.0,0.004883333333333333,52.733333333333334
3229,4653,-25353,21,27,48,43.75,-0.023881250000000003,29.666666666666668
3231,7660,-3710,23,22,45,51.11,-0.00517555555555555,30.6
3257,6699,5451,13,10,23,56.52,0.01373478260869565,25.217391304347824
3266,4233,-14503,19,22,41,46.34,-0.012331707317073169,45.80487804878049
3296,6575,-17975,24,22,46,52.17,-0.006106521739130434,26.782608695652176
3305,11669,-15719,20,23,43,46.51,-0.010674418604651162,43.93023255813954
3308,2751,5099,21,15,36,58.33,0.010747222222222217,29.444444444444443
3311,13914,-3214,19,25,44,43.18,-0.010059090909090912,23.681818181818183
3312,2920,-13030,17,21,38,44.74,-0.0324921052631579,28.736842105263158
3321,1566,-3546,10,10,20,50.0,-0.004194999999999999,19.05
3338,5350,-20350,10,14,24,41.67,-0.019799999999999998,21.125
3346,4240,-15590,7,11,18,38.89,-0.024572222222222224,33.666666666666664
3356,20717,-68017,21,20,41,51.22,-0.0016804878048780505,31.48780487804878
3376,23228,-83828,18,23,41,43.9,-0.012114634146341464,29.341463414634145
3380,5875,3325,24,22,46,52.17,0.0017282608695652166,25.956521739130434
3383,7003,-28753,23,33,56,41.07,-0.032910714285714286,18.553571428571427
3406,60839,-202839,27,36,63,42.86,-0.020476190476190474,9.619047619047619
3413,7906,-7306,6,4,10,60.0,0.0054900000000000036,20.0
3416,8123,-31773,12,12,24,50.0,-0.012416666666666666,62.791666666666664
3419,4654,-6014,24,19,43,55.81,0.006720930232558139,20.627906976744185
3432,2083,-9443,10,16,26,38.46,-0.02042692307692308,30.653846153846153
3437,2592,-20542,8,11,19,42.11,-0.031547368421052636,17.0
3443,37044,147856,21,17,38,55.26,0.016252631578947373,15.710526315789474
3450,15308,-6648,29,17,46,63.04,0.009956521739130437,20.934782608695652
3454,17635,-94835,18,22,40,45.0,-0.020540000000000003,22.95
3481,8366,-48676,18,29,47,38.3,-0.04333617021276596,23.04255319148936
3494,4694,-4334,27,24,51,52.94,-0.0037058823529411756,18.352941176470587
3501,6253,-14953,11,15,26,42.31,-0.010861538461538462,71.96153846153847
3504,17972,-84572,21,24,45,46.67,-0.015082222222222226,17.866666666666667
3515,17742,-34942,18,17,35,51.43,0.005308571428571431,45.22857142857143
3518,11980,-64180,26,23,49,53.06,-0.0022816326530612245,23.408163265306122
3528,2451,27149,10,3,13,76.92,0.07228461538461539,116.61538461538461
3530,10275,-59485,18,22,40,45.0,0.008582499999999998,19.8
3532,13742,-24242,19,16,35,54.29,0.0038914285714285704,22.514285714285716
3533,16141,16309,16,14,30,53.33,0.0029999999999999983,21.766666666666666
3535,4328,-17818,18,23,41,43.9,-0.020029268292682922,15.658536585365853
3536,2627,-7097,18,24,42,42.86,-0.0031904761904761893,18.523809523809526
3543,7031,-21031,21,25,46,45.65,0.0015369565217391325,45.30434782608695
3545,12389,-40789,23,24,47,48.94,-0.005659574468085104,11.787234042553191
3550,1859,-17389,7,14,21,33.33,-0.045090476190476195,55.904761904761905
3557,5335,-8135,22,23,45,48.89,-0.019975555555555552,13.577777777777778
3563,21510,-92560,10,15,25,40.0,-0.027363999999999996,29.4
3576,4467,-29607,15,21,36,41.67,-0.029616666666666666,19.333333333333332
3583,5080,10970,8,7,15,53.33,0.012093333333333334,30.8
3588,12530,-38130,17,17,34,50.0,-0.017361764705882358,29.5
3591,7893,-47153,18,19,37,48.65,-0.014135135135135136,21.243243243243242
3593,3660,3020,22,20,42,52.38,0.02438095238095238,26.071428571428573
3596,8132,-35082,15,15,30,50.0,-0.01635,19.066666666666666
3605,7353,-62553,12,24,36,33.33,-0.042652777777777776,28.694444444444443
3607,6801,-61911,11,22,33,33.33,-0.04302121212121212,26.515151515151516
3617,8859,-36509,10,12,22,45.45,-0.01817272727272727,56.31818181818182
3622,19749,-124039,18,24,42,42.86,-0.02312619047619048,22.523809523809526
3645,5344,5606,14,11,25,56.0,0.010188,14.92
3653,17470,-10820,11,16,27,40.74,-0.017870370370370366,12.703703703703704
3661,22831,8569,9,11,20,45.0,0.0007399999999999997,8.65
3665,20263,-17413,12,11,23,52.17,0.010317391304347827,14.91304347826087
3669,3035,-12235,10,9,19,52.63,-0.008463157894736844,38.36842105263158
3673,45297,-201047,20,23,43,46.51,-0.026083720930232555,19.53488372093023
3679,8122,-42122,9,14,23,39.13,-0.025143478260869562,47.26086956521739
3682,1284,-7934,7,12,19,36.84,-0.03858421052631578,48.0
3686,3216,-26586,16,23,39,41.03,-0.042048717948717944,19.692307692307693
3694,2605,-955,14,11,25,56.0,0.011699999999999999,31.88
3701,3038,4272,23,21,44,52.27,0.01933863636363637,28.386363636363637
3702,5060,-3610,14,12,26,53.85,0.002396153846153839,51.80769230769231
3703,1241,3309,9,6,15,60.0,0.008940000000000002,91.0
3704,2355,-7005,12,12,24,50.0,-0.014016666666666662,53.25
3705,2638,7412,6,4,10,60.0,0.021029999999999997,231.6
3706,1848,3502,7,5,12,58.33,0.01743333333333334,42.083333333333336
3708,3995,-28695,3,6,9,33.33,-0.029455555555555554,15.666666666666666
3711,3327,11173,5,3,8,62.5,0.014500000000000002,30.125
3712,1200,-10700,2,7,9,22.22,-0.06703333333333333,37.22222222222222
3714,1457,-7657,1,3,4,25.0,-0.032100000000000004,11.75
4104,9355,18345,21,13,34,61.76,0.01365294117647059,69.26470588235294
4106,6367,-23667,18,24,42,42.86,-0.01748571428571429,52.214285714285715
4108,7106,-40906,19,26,45,42.22,-0.02270444444444444,34.044444444444444
4119,9208,49742,19,11,30,63.33,0.03698333333333333,51.1
4133,9413,36537,21,14,35,60.0,0.027597142857142855,40.91428571428571
4137,23744,-154744,9,13,22,40.91,-0.030159090909090917,19.818181818181817
4142,4129,-12129,12,10,22,54.55,-0.013890909090909086,40.36363636363637
4155,5533,-28423,11,17,28,39.29,-0.01919642857142857,29.857142857142858
4164,6542,-63292,7,15,22,31.82,-0.04431818181818181,42.77272727272727
4190,9250,30650,11,8,19,57.89,0.024900000000000005,33.8421052631579
4306,3491,-23301,14,22,36,38.89,-0.03145555555555556,55.0
4414,3619,-11719,20,33,53,37.74,-0.033175471698113204,36.18867924528302
4426,9515,-48325,22,22,44,50.0,-0.013329545454545457,25.09090909090909
4438,8255,-55255,4,8,12,33.33,-0.026308333333333336,61.333333333333336
4439,2326,11674,2,1,3,66.67,0.02566666666666667,97.33333333333333
4526,5428,-42878,12,24,36,33.33,-0.03244166666666667,57.166666666666664
4532,4416,-20266,17,22,39,43.59,-0.0319,43.43589743589744
4536,11463,-51963,7,10,17,41.18,-0.022882352941176468,56.23529411764706
4540,3313,-7523,8,8,16,50.0,-0.006793750000000003,36.8125
4545,3485,23565,12,6,18,66.67,0.043705555555555546,41.55555555555556
4551,10758,-60158,7,9,16,43.75,-0.024199999999999996,13.3125
4552,5119,-31769,6,10,16,37.5,-0.0364375,38.375
4555,2902,-20552,2,7,9,22.22,-0.03297777777777778,61.888888888888886
4557,2834,15066,5,2,7,71.43,0.0362,153.71428571428572
4560,1815,-7615,2,5,7,28.57,-0.017114285714285714,76.71428571428571
4562,1946,-17376,2,10,12,16.67,-0.05515833333333333,104.58333333333333
4564,1759,-22809,2,7,9,22.22,-0.06411111111111112,26.88888888888889
4566,1982,-9882,4,4,8,50.0,-0.0250625,39.75
4571,3098,-27848,2,5,7,28.57,-0.054042857142857136,23.285714285714285
4572,2550,-14550,2,3,5,40.0,-0.02752,18.0
4576,2268,-10468,2,3,5,40.0,-0.023239999999999997,23.2
4581,1087,8813,4,1,5,80.0,0.04868,57.6
4720,2811,1219,18,16,34,52.94,0.006517647058823531,72.02941176470588
4722,3479,2921,16,15,31,51.61,-0.0024000000000000002,79.80645161290323
4737,6486,-31286,7,11,18,38.89,-0.023699999999999995,50.333333333333336
4739,6016,-32266,9,9,18,50.0,-0.022750000000000003,26.666666666666668
4746,10129,2421,16,13,29,55.17,0.01095862068965517,36.206896551724135
4755,1972,4978,5,4,9,55.56,0.0032111111111111108,94.55555555555556
4763,6733,-28233,5,5,10,50.0,-0.018500000000000003,41.3
4764,2123,5377,3,3,6,50.0,0.023883333333333336,59.833333333333336
4766,4659,-36659,2,4,6,33.33,-0.04505,63.5
4807,3698,-44948,5,10,15,33.33,-0.04688666666666667,57.8
4904,5805,33195,13,6,19,68.42,0.040384210526315786,145.52631578947367
4906,12103,-63153,23,29,52,44.23,-0.027225000000000003,26.21153846153846
4912,15239,-36889,12,13,25,48.0,-0.0076440000000000015,27.44
4915,5035,-2585,11,9,20,55.0,0.00803,22.45
4916,3795,-9195,10,12,22,45.45,-0.01681818181818182,27.5
4919,5077,-5677,13,13,26,50.0,-0.0052615384615384625,20.653846153846153
4927,5753,-16703,12,12,24,50.0,-0.0013416666666666692,33.791666666666664
4930,2706,-6576,16,11,27,59.26,0.0005592592592592584,39.77777777777778
4934,3026,-27816,10,23,33,30.3,-0.0580090909090909,18.303030303030305
4935,8262,-9912,12,13,25,48.0,-0.010040000000000002,37.0
4938,6488,36862,15,6,21,71.43,0.042461904761904756,48.80952380952381
4942,3418,-2968,9,9,18,50.0,-0.01043888888888889,69.77777777777777
4943,10106,-115556,6,15,21,28.57,-0.04090476190476191,12.095238095238095
4952,3235,-2035,9,8,17,52.94,0.006129411764705878,23.88235294117647
4956,3082,-1802,15,14,29,51.72,-0.0003482758620689638,27.517241379310345
4958,8112,-21012,9,8,17,52.94,-0.0023117647058823513,41.11764705882353
4960,2896,-10006,11,17,28,39.29,-0.020721428571428568,24.214285714285715
4961,7175,-35375,11,15,26,42.31,-0.011234615384615386,42.07692307692308
4967,2773,-6083,11,14,25,44.0,-0.02194,27.28
4968,15459,-22809,12,11,23,52.17,0.0032217391304347827,12.869565217391305
4976,4342,-12142,10,15,25,40.0,-0.025468,18.56
4977,8776,2824,12,8,20,60.0,0.009680000000000003,18.35
4989,1951,-23471,4,17,21,19.05,-0.07015714285714288,34.523809523809526
4994,21400,6300,16,20,36,44.44,-0.0037388888888888897,20.27777777777778
4999,3693,-29843,5,10,15,33.33,-0.044039999999999996,79.13333333333334
5007,6335,-40635,9,17,26,34.62,-0.03973846153846154,105.15384615384616
5203,18393,-78193,19,17,36,52.78,-0.015127777777777776,51.0
5215,8671,-47321,11,19,30,36.67,-0.029446666666666673,34.36666666666667
5225,5340,-45240,10,16,26,38.46,-0.043342307692307694,30.73076923076923
5234,7065,-12065,10,10,20,50.0,-0.014734999999999998,30.3
5243,3230,-5480,7,8,15,46.67,-0.01784,25.6
5258,2288,1812,12,6,18,66.67,0.021077777777777782,20.61111111111111
5269,49653,-41753,10,10,20,50.0,-0.011179999999999999,10.65
5283,2549,-18619,2,5,7,28.57,-0.02917142857142857,49.285714285714285
5284,3486,-19286,5,7,12,41.67,-0.02716666666666667,98.66666666666667
5285,5349,-19599,7,10,17,41.18,-0.02268235294117647,47.11764705882353
5288,5448,-28648,4,6,10,40.0,-0.02671,59.4
5388,9085,-23455,22,19,41,53.66,0.0035560975609756095,29.878048780487806
5434,12486,10264,22,15,37,59.46,0.010308108108108106,35.810810810810814
5469,6393,-213,26,25,51,50.98,-0.0029725490196078424,30.41176470588235
5471,11382,4818,25,17,42,59.52,0.009983333333333334,44.357142857142854
5484,7226,-5826,32,31,63,50.79,-0.00808095238095238,27.714285714285715
5515,3690,9640,26,17,43,60.47,0.018293023255813952,48.06976744186046
5519,4267,-34367,13,23,36,36.11,-0.036602777777777776,42.69444444444444
5521,3024,-10774,21,22,43,48.84,-0.012132558139534885,41.06976744186046
5522,8440,-64440,15,22,37,40.54,-0.01912162162162162,30.135135135135137
5525,4086,-3426,18,17,35,51.43,0.00582,60.42857142857143
5531,6836,-24226,26,26,52,50.0,-0.008448076923076921,24.596153846153847
5533,2793,-6423,17,13,30,56.67,-0.0061133333333333335,90.0
5534,13167,-47617,18,22,40,45.0,-0.015642499999999997,46.275
5538,2220,-6870,5,7,12,41.67,-0.0128,57.333333333333336
5546,1510,-8610,1,3,4,25.0,-0.036325,55.25
5607,4350,-5100,20,16,36,55.56,0.009966666666666665,45.666666666666664
5608,5875,-12485,18,22,40,45.0,-0.005785,48.35
5706,7722,-1922,16,14,30,53.33,-0.005036666666666665,59.13333333333333
5871,7048,-12448,8,7,15,53.33,0.012919999999999994,23.8
5876,1825,2735,5,3,8,62.5,0.012562499999999997,84.75
5880,842,2308,6,3,9,66.67,0.024066666666666663,149.0
5906,3015,-14635,16,19,35,45.71,-0.013668571428571427,23.885714285714286
5907,5113,-7863,11,13,24,45.83,-0.015325000000000004,49.916666666666664
6005,2654,5056,21,14,35,60.0,0.016085714285714287,51.885714285714286
6024,2764,-16514,5,9,14,35.71,-0.03162142857142857,154.14285714285714
6108,4988,-35588,15,29,44,34.09,-0.03424318181818182,35.15909090909091
6112,4961,-781,19,21,40,47.5,-0.004675000000000001,56.425
6115,7027,-47527,12,21,33,36.36,-0.03008181818181818,84.81818181818181
6116,4249,-19229,26,45,71,36.62,-0.03888169014084506,17.47887323943662
6117,4936,-17786,24,21,45,53.33,0.0019311111111111124,37.355555555555554
6120,5892,-46472,24,31,55,43.64,-0.028685454545454542,21.963636363636365
6128,6614,6636,22,18,40,55.0,0.0056,60.4
6133,3587,-7937,20,23,43,46.51,-0.008579069767441858,46.30232558139535
6136,6464,-41264,17,22,39,43.59,-0.02057692307692308,68.6923076923077
6139,8960,-31110,21,20,41,51.22,-0.009019512195121952,48.46341463414634
6141,6722,1918,26,25,51,50.98,0.0016529411764705907,29.372549019607842
6142,5381,4449,28,28,56,50.0,0.0008196428571428561,19.928571428571427
6152,7861,-29791,28,38,66,42.42,-0.025337878787878788,22.666666666666668
6153,7903,-43383,21,30,51,41.18,-0.021107843137254906,23.627450980392158
6155,7088,-3838,28,22,50,56.0,0.004935999999999999,31.8
6164,4110,-15200,24,26,50,48.0,-0.013874,29.26
6165,5146,-12366,28,28,56,50.0,-0.01565892857142857,22.964285714285715
6166,11609,-2959,24,23,47,51.06,0.0015851063829787275,37.59574468085106
6168,6469,-25519,22,30,52,42.31,-0.027075000000000002,19.826923076923077
6172,3510,-13460,19,30,49,38.78,-0.02846326530612245,12.63265306122449
6176,18453,57147,30,18,48,62.5,0.024347916666666667,28.708333333333332
6177,5352,6688,26,20,46,56.52,0.014013043478260868,23.369565217391305
6183,2557,17133,16,7,23,69.57,0.03776521739130435,86.6086956521739
6184,5292,22708,15,7,22,68.18,0.0279,125.31818181818181
6189,5381,-12991,16,17,33,48.48,-0.01595151515151515,68.78787878787878
6191,6934,-34624,20,26,46,43.48,-0.016134782608695653,34.82608695652174
6192,9912,2438,19,14,33,57.58,0.010584848484848487,46.18181818181818
6196,9302,-3252,24,22,46,52.17,-0.00031521739130434615,29.02173913043478
6197,13270,-32820,29,22,51,56.86,0.00040588235294117367,18.705882352941178
6201,4679,-13879,13,14,27,48.15,-0.005274074074074072,104.25925925925925
6202,9203,22397,18,13,31,58.06,0.006025806451612904,41.70967741935484
6205,6645,-67295,13,28,41,31.71,-0.049297560975609764,36.58536585365854
6206,13840,-7840,19,15,34,55.88,0.005058823529411764,64.38235294117646
6209,9867,-79297,24,28,52,46.15,-0.02187884615384615,17.057692307692307
6213,10151,-41201,17,25,42,40.48,-0.026745238095238093,26.547619047619047
6214,7784,10016,19,14,33,57.58,0.014396969696969695,45.90909090909091
6215,6752,-56572,24,29,53,45.28,-0.021264150943396218,25.452830188679247
6216,7983,-30483,24,20,44,54.55,-0.0022318181818181833,48.61363636363637
6224,11829,-14529,21,21,42,50.0,0.000349999999999998,45.095238095238095
6225,5993,-29383,35,46,81,43.21,-0.01671111111111111,15.592592592592593
6226,3988,2852,34,24,58,58.62,0.00781551724137931,23.96551724137931
6230,21565,-69965,30,28,58,51.72,-0.005318965517241381,18.0
6235,7096,-12916,25,30,55,45.45,-0.011405454545454548,17.181818181818183
6239,18350,30100,24,19,43,55.81,0.01737906976744186,26.651162790697676
6243,10100,-58760,30,31,61,49.18,-0.02062131147540984,15.21311475409836
6251,1982,-4692,13,10,23,56.52,-0.006082608695652173,30.304347826086957
6257,4099,-18749,18,16,34,52.94,-0.013411764705882349,23.61764705882353
6269,15562,39398,25,22,47,53.19,0.005197872340425532,19.893617021276597
6271,17079,-52029,15,17,32,46.88,-0.011618749999999999,16.46875
6277,13756,-69556,15,18,33,45.45,-0.021972727272727276,63.24242424242424
6278,11882,54568,26,14,40,65.0,0.023647499999999995,39.2
6281,5037,-25237,7,11,18,38.89,-0.025472222222222222,135.11111111111111
6282,5384,-35504,18,28,46,39.13,-0.03262826086956523,23.02173913043478
6283,6716,-54286,24,35,59,40.68,-0.02273050847457627,17.135593220338983
6285,17787,-67337,23,26,49,46.94,-0.016987755102040817,23.142857142857142
6288,2542,-8162,14,19,33,42.42,-0.01901515151515151,21.636363636363637
6289,5612,-29162,29,45,74,39.19,-0.029685135135135134,12.527027027027026
6405,3195,-52745,5,16,21,23.81,-0.07345238095238094,29.476190476190474
6409,28664,328336,6,1,7,85.71,0.06895714285714286,56.285714285714285
6412,3870,-9870,6,7,13,46.15,-0.01599230769230769,44.0
6414,28499,-149999,8,11,19,42.11,-0.02611578947368421,10.894736842105264
6415,108126,-210626,7,7,14,50.0,0.01594285714285714,16.928571428571427
6416,8795,-27845,9,8,17,52.94,-0.002923529411764709,30.88235294117647
6431,1921,-7121,7,10,17,41.18,-0.008770588235294117,28.647058823529413
6438,3734,-12684,5,6,11,45.45,-0.0032818181818181805,17.181818181818183
6442,1877,-20377,2,7,9,22.22,-0.05751111111111112,55.22222222222222
6443,1506,-5476,7,11,18,38.89,-0.0249,18.444444444444443
6449,2750,-45800,3,11,14,21.43,-0.0864642857142857,22.071428571428573
6451,11187,-113387,7,14,21,33.33,-0.04543809523809524,14.952380952380953
6456,13755,-21455,11,10,21,52.38,-1.904761904761943e-05,18.142857142857142
6464,3771,-14671,2,4,6,33.33,-0.024366666666666665,266.8333333333333
6477,1980,-8630,5,7,12,41.67,-0.010624999999999996,31.416666666666668
6491,9640,26330,6,5,11,54.55,-0.011590909090909091,39.90909090909091
6504,19700,17500,12,11,23,52.17,0.007634782608695656,43.21739130434783
6505,12814,37186,17,10,27,62.96,0.022818518518518523,62.55555555555556
6515,2125,19375,1,0,1,100.0,0.0558,26.0
6525,3785,-14085,5,5,10,50.0,-0.01982,44.0
6531,14105,-34255,7,8,15,46.67,-0.021633333333333334,11.266666666666667
6533,13034,9666,6,9,15,40.0,-0.0019799999999999957,9.333333333333334
6541,7618,-14318,10,9,19,52.63,0.0010736842105263163,23.736842105263158
6552,3340,-4640,3,7,10,30.0,-0.0036900000000000014,30.3
6558,2127,-24227,3,7,10,30.0,-0.052539999999999996,17.4
6573,2471,-10471,8,9,17,47.06,-0.010417647058823528,18.41176470588235
6579,4778,4522,6,4,10,60.0,0.01186,84.7
6581,3929,-14929,4,4,8,50.0,-0.027237499999999998,49.75
6582,9557,-51057,7,9,16,43.75,-0.014775000000000003,49.625
6591,5343,33257,11,5,16,68.75,0.03705,19.1875
6592,487,6713,1,0,1,100.0,0.0863,31.0
6598,2792,-6292,5,5,10,50.0,0.0017100000000000032,19.3
6605,12544,-93444,11,18,29,37.93,-0.03421379310344828,68.65517241379311
6625,2162,-18812,5,6,11,45.45,-0.024736363636363633,46.09090909090909
6641,1367,-2367,2,2,4,50.0,-0.0019749999999999976,46.5
6655,675,-14725,0,3,3,0.0,-0.11736666666666667,76.66666666666667
6666,6611,-38011,4,8,12,33.33,-0.032049999999999995,28.0
6668,2723,-10523,4,5,9,44.44,-0.0196,11.0
6669,13980,76020,2,1,3,66.67,0.04186666666666666,9.333333333333334
6670,3033,19467,2,1,3,66.67,0.033466666666666665,41.666666666666664
6671,1099,-10549,2,3,5,40.0,-0.04968,37.0
6672,2935,-47435,1,5,6,16.67,-0.08323333333333334,46.166666666666664
6674,1244,-1744,4,4,8,50.0,-0.0033250000000000024,29.0
6698,1164,15086,4,1,5,80.0,0.08106000000000001,20.2
6706,2719,-17719,1,2,3,33.33,-0.031199999999999995,23.333333333333332
6715,2845,27155,3,1,4,75.0,0.059175,37.5
6743,2615,-21715,3,4,7,42.86,-0.03828571428571428,11.428571428571429
6754,508,5792,2,0,2,100.0,0.07100000000000001,176.5
6756,9931,10569,3,2,5,60.0,0.0142,6.2
8011,5078,31482,27,16,43,62.79,0.1914232558139535,71.51162790697674
8016,19794,-33544,22,19,41,53.66,0.0008024390243902442,22.29268292682927
8021,6270,-40520,16,21,37,43.24,-0.022432432432432436,30.18918918918919
8028,3910,-15730,12,19,31,38.71,-0.003006451612903226,11.193548387096774
8033,3392,-14512,20,21,41,48.78,-0.007841463414634145,24.146341463414632
8039,10435,-70635,20,27,47,42.55,-0.0332595744680851,18.4468085106383
8046,22319,-150069,17,24,41,41.46,-0.008890243902439022,20.463414634146343
8070,19950,-110500,18,22,40,45.0,-0.017727499999999997,27.225
8072,17416,-33016,21,17,38,55.26,0.001434210526315792,62.73684210526316
8081,25423,-94023,16,22,38,42.11,-0.018502631578947368,35.18421052631579
8101,4323,-9593,25,30,55,45.45,-0.004887272727272726,24.327272727272728
8103,6913,-50213,13,23,36,36.11,-0.037413888888888885,34.083333333333336
8104,6345,181075,10,19,29,34.48,2.1081137931034486,138.75862068965517
8105,4244,-13934,24,25,49,48.98,-0.012124489795918368,15.142857142857142
8110,2781,-11041,16,22,38,42.11,-0.02739473684210526,19.07894736842105
8112,3640,-11070,17,20,37,45.95,-0.028391891891891893,27.35135135135135
8114,19035,-29285,20,18,38,52.63,0.0041105263157894725,38.23684210526316
8131,4238,-2788,16,12,28,57.14,0.0044249999999999975,41.75
8150,2399,2101,8,6,14,57.14,0.011135714285714285,26.357142857142858
8163,6009,-40459,16,20,36,44.44,-0.022824999999999998,24.88888888888889
8201,3823,-23433,18,19,37,48.65,-0.0251972972972973,35.729729729729726
8210,7621,-6531,17,20,37,45.95,-0.011245945945945942,40.513513513513516
8213,5625,-9675,14,14,28,50.0,-0.004635714285714287,37.67857142857143
8215,3362,-11452,15,16,31,48.39,-0.01170322580645161,18.129032258064516
8222,1725,-25,10,6,16,62.5,0.008525000000000001,46.1875
8249,5499,-5069,21,20,41,51.22,0.0026829268292682938,30.804878048780488
8261,6640,-21060,18,29,47,38.3,-0.029578723404255318,16.404255319148938
8271,2445,-16245,7,10,17,41.18,-0.032123529411764704,53.588235294117645
8341,11127,-62127,4,6,10,40.0,-0.03177000000000001,66.6
8367,788,-14338,1,3,4,25.0,-0.086525,39.5
8374,5792,-13212,20,18,38,52.63,-0.008226315789473684,28.105263157894736
8404,3020,4130,8,9,17,47.06,0.014517647058823531,56.0
8411,4503,-35403,10,16,26,38.46,-0.04415384615384615,36.96153846153846
8422,13615,-52615,6,8,14,42.86,-0.018492857142857144,105.64285714285714
8429,5087,-26327,9,17,26,34.62,-0.044965384615384615,31.96153846153846
8442,2617,10433,5,4,9,55.56,0.03162222222222223,101.88888888888889
8443,1554,-16604,3,12,15,20.0,-0.05468,90.66666666666667
8454,46104,-324104,8,7,15,53.33,-0.0041400000000000005,37.266666666666666
8462,10284,-24284,6,6,12,50.0,-0.006000000000000001,33.416666666666664
8463,1828,-2478,6,6,12,50.0,-0.007016666666666667,60.25
8464,25175,64825,11,5,16,68.75,0.01883125,25.625
8466,4831,-63031,2,11,13,15.38,-0.06453846153846153,45.0
8467,3125,-6125,7,7,14,50.0,0.0021499999999999952,61.42857142857143
8473,2656,-19906,3,7,10,30.0,-0.046290000000000005,96.9
8478,5204,-31304,8,7,15,53.33,0.000746666666666671,28.2
8480,5815,2285,4,5,9,44.44,-0.007711111111111107,109.55555555555556
8481,2269,-5719,4,3,7,57.14,-0.005742857142857145,54.142857142857146
8482,5513,6587,6,4,10,60.0,0.009720000000000001,41.4
8488,1523,-19573,3,10,13,23.08,-0.05233846153846154,47.0
8499,7069,38431,6,6,12,50.0,0.019758333333333333,24.25
8926,2498,16002,16,6,22,72.73,0.04851363636363637,115.22727272727273
8940,3922,1118,18,17,35,51.43,0.004014285714285715,63.142857142857146
8996,9061,-20911,21,19,40,52.5,-0.007824999999999995,23.35
9802,5586,-6636,6,8,14,42.86,-0.01013571428571429,40.42857142857143
9902,2336,-3506,19,16,35,54.29,0.004205714285714284,38.885714285714286
9904,5339,-13739,16,16,32,50.0,-0.008550000000000002,67.21875
9905,3460,-1210,14,13,27,51.85,0.0076481481481481435,91.33333333333333
9906,4888,16152,33,25,58,56.9,0.005112068965517241,13.206896551724139
9907,3007,1253,21,14,35,60.0,0.008771428571428572,42.714285714285715
9908,1798,4902,10,6,16,62.5,0.019512500000000002,143.0
9910,15517,-667,16,15,31,51.61,-0.006064516129032258,50.87096774193548
9911,3499,8601,18,13,31,58.06,0.013803225806451613,28.096774193548388
9912,3770,-13210,29,29,58,50.0,-0.016446551724137937,28.810344827586206
9914,21175,-54125,17,17,34,50.0,-0.004935294117647058,30.852941176470587
9917,4804,21696,11,5,16,68.75,0.029812500000000002,136.75
9918,1715,15885,8,2,10,80.0,0.05502,241.4
9919,4113,16487,20,18,38,52.63,0.022368421052631583,60.31578947368421
9921,24270,-86770,15,14,29,51.72,-0.0017413793103448268,49.275862068965516
9924,4721,4399,16,14,30,53.33,0.0026733333333333383,85.36666666666666
9925,2826,-76,10,8,18,55.56,0.004238888888888894,128.27777777777777
9926,2496,11654,11,3,14,78.57,0.03367142857142856,180.35714285714286
9927,5463,-27363,14,18,32,43.75,-0.019993749999999998,52.3125
9928,3369,-6419,20,26,46,43.48,-0.011632608695652174,33.608695652173914
9929,2785,-4115,25,22,47,53.19,-0.003363829787234042,46.46808510638298
9930,5621,-2421,13,9,22,59.09,0.00668181818181818,105.13636363636364
9931,2334,12066,11,4,15,73.33,0.041253333333333336,154.86666666666667
9933,6833,12517,20,15,35,57.14,0.012639999999999998,46.31428571428572
9934,5931,-21081,21,26,47,44.68,-0.02565957446808511,38.808510638297875
9935,4729,-25789,26,32,58,44.83,-0.016360344827586214,27.913793103448278
9937,3746,15154,13,8,21,61.9,0.017657142857142854,162.23809523809524
9938,9136,-55806,17,23,40,42.5,-0.028044999999999997,27.65
9939,8451,-10601,17,18,35,48.57,-0.005845714285714287,44.8
9940,9649,-59399,15,23,38,39.47,-0.029818421052631577,39.89473684210526
9941,9100,21900,17,12,29,58.62,0.014910344827586207,64.75862068965517
9942,8065,-56165,11,17,28,39.29,-0.027092857142857144,70.28571428571429
9943,6043,23507,20,11,31,64.52,0.026948387096774197,77.87096774193549
9944,5423,-7123,18,23,41,43.9,-0.005829268292682926,51.926829268292686
9945,6029,-19399,15,19,34,44.12,-0.02103823529411765,37.11764705882353
9946,3365,-35525,9,33,42,21.43,-0.05435,28.714285714285715
9955,7097,3003,25,17,42,59.52,0.015480952380952376,28.38095238095238
9958,4394,52806,16,9,25,64.0,0.022895999999999993,45.76
1312A,2616,3904,13,10,23,56.52,0.006334782608695651,111.73913043478261
2002A,3096,4054,8,6,14,57.14,0.011457142857142858,228.57142857142858
2836A,140,-40,0,1,1,0.0,-0.0017,52.0
2838A,312,-312,0,1,1,0.0,-0.0058,1068.0
2881A,368,1032,1,0,1,100.0,0.0167,1809.0
2881B,364,-1364,0,1,1,0.0,-0.0217,822.0
2882A,364,-264,0,1,1,0.0,-0.0043,1451.0
2882B,364,236,1,0,1,100.0,0.0038,822.0
2887E,310,1290,1,0,1,100.0,0.0249,1443.0
2887F,303,-2203,0,1,1,0.0,-0.0413,823.0
2888A,248,-1748,0,1,1,0.0,-0.0402,597.0
2888B,245,255,1,0,1,100.0,0.0061,501.0
2891B,369,-669,0,1,1,0.0,-0.0106,1067.0
2891C,359,-559,0,1,1,0.0,-0.0091,823.0
2897A,139,-999,1,1,2,50.0,-0.0481,328.0
3702A,292,-142,0,1,1,0.0,-0.0029,596.0
5871A,0,0,0,0,0,0.0,,
9941A,306,-806,0,1,1,0.0,-0.0153,823.0
1240,1444,-194,2,3,5,40.0,-0.00498,59.4
1258,2843,-9413,9,12,21,42.86,-0.02536190476190476,50.04761904761905
1259,7643,-46543,5,10,15,33.33,-0.030019999999999998,139.86666666666667
1264,9361,-18861,3,4,7,42.86,-0.004057142857142858,115.14285714285714
1268,7237,-45917,3,7,10,30.0,-0.027739999999999997,121.8
1336,3265,-20235,15,19,34,44.12,-0.029461764705882354,44.3235294117647
1565,76784,-545384,11,21,32,34.38,-0.031915625,25.25
1569,6745,-39475,19,28,47,40.43,-0.028997872340425522,24.23404255319149
1570,3753,-5653,24,17,41,58.54,0.007846341463414633,38.36585365853659
1580,14636,-21536,11,14,25,44.0,-0.008104000000000009,42.72
1584,2960,-23650,13,20,33,39.39,-0.03395454545454546,34.63636363636363
1586,2753,-24603,6,12,18,33.33,-0.03785000000000001,50.5
1591,3706,-28156,10,15,25,40.0,-0.02724,40.76
1593,4520,-8120,8,8,16,50.0,-0.0060750000000000005,61.3125
1595,7106,-17606,12,13,25,48.0,-0.007043999999999997,50.52
1599,4237,-15687,7,11,18,38.89,-0.020050000000000002,48.388888888888886
1742,5406,-14336,18,23,41,43.9,-0.0032829268292682884,29.5609756097561
1752,4337,963,12,10,22,54.55,0.004331818181818184,54.0
1777,7098,-9748,11,11,22,50.0,-0.01161363636363636,83.81818181818181
1781,8113,-20033,31,32,63,49.21,0.005342857142857141,19.873015873015873
1784,8977,-26377,19,20,39,48.72,-0.004871794871794869,30.435897435897434
1785,13101,2969,19,22,41,46.34,-0.014802439024390247,27.414634146341463
1788,5636,17664,7,4,11,63.64,0.02016363636363636,140.27272727272728
1796,2688,-10688,5,9,14,35.71,-0.021399999999999995,28.5
1799,4906,10974,26,19,45,57.78,0.017066666666666667,18.0
1813,3901,-3051,14,11,25,56.0,0.0030760000000000036,58.64
1815,3571,5059,22,18,40,55.0,0.0050175,23.175
2035,3897,-14897,9,13,22,40.91,-0.019386363636363643,114.63636363636364
2061,2455,-10215,10,18,28,35.71,-0.015146428571428573,24.321428571428573
2063,4471,13929,14,8,22,63.64,0.03415000000000001,72.95454545454545
2064,1014,-3314,5,6,11,45.45,-0.019354545454545454,83.45454545454545
2065,1065,13035,4,1,5,80.0,0.08236,60.8
2066,8148,-39698,8,9,17,47.06,-0.02424705882352941,57.05882352941177
2067,1565,-8985,7,10,17,41.18,-0.02088235294117647,47.529411764705884
2070,2061,-14901,6,4,10,60.0,-0.008590000000000004,111.5
2221,2490,-10460,8,16,24,33.33,-0.024491666666666672,32.166666666666664
2230,1495,395,10,7,17,58.82,0.0044058823529411735,63.1764705882353
2235,5823,-64873,3,12,15,20.0,-0.053359999999999984,58.06666666666667
2596,1837,-12887,6,12,18,33.33,-0.03732222222222223,83.11111111111111
2640,10387,-38637,11,12,23,47.83,-0.017343478260869568,32.65217391304348
2641,1191,-1591,9,9,18,50.0,-0.015627777777777782,42.333333333333336
2643,1508,-9358,2,5,7,28.57,-0.03687142857142857,57.42857142857143
2718,3632,2118,12,9,21,57.14,0.004714285714285714,45.714285714285715
2719,2507,-4917,13,16,29,44.83,-0.025199999999999997,31.413793103448278
2724,3348,-37658,9,20,29,31.03,-0.04973793103448275,29.96551724137931
2726,7143,-39693,9,13,22,40.91,-0.0277909090909091,28.136363636363637
2729,15085,22415,6,5,11,54.55,0.012581818181818189,103.63636363636364
2732,6765,-17265,5,8,13,38.46,-0.013615384615384613,31.153846153846153
2734,3534,-5134,12,13,25,48.0,0.009544,25.48
2736,1872,-6272,8,10,18,44.44,-0.001038888888888887,36.77777777777778
2740,2792,-9072,10,12,22,45.45,-0.008663636363636363,20.136363636363637
2743,1458,-15538,4,8,12,33.33,-0.034533333333333326,26.166666666666668
2745,2847,-19887,5,10,15,33.33,-0.043019999999999996,32.6
2752,2224,-21224,1,2,3,33.33,-0.06586666666666667,37.333333333333336
2754,770,930,1,1,2,50.0,0.004449999999999999,21.0
2755,348,5852,1,0,1,100.0,0.1068,145.0
2916,2248,-15848,8,13,21,38.1,-0.03789047619047619,100.85714285714286
2924,4471,-14721,8,10,18,44.44,-0.001911111111111112,92.94444444444444
2926,9886,-132886,3,13,16,18.75,-0.06895000000000001,120.875
2937,580,-7730,1,4,5,20.0,-0.06334,93.0
3064,16722,-18822,31,36,67,46.27,0.00465373134328358,14.611940298507463
3066,2907,-19737,16,24,40,40.0,-0.028025,25.55
3067,3835,7615,19,15,34,55.88,0.014370588235294121,57.029411764705884
3071,3197,-1737,22,20,42,52.38,-0.005473809523809528,28.261904761904763
3073,5366,9644,30,25,55,54.55,0.012539999999999999,14.054545454545455
3078,5852,-18282,25,23,48,52.08,-0.012095833333333332,23.083333333333332
3081,34884,-7884,11,12,23,47.83,-0.0015826086956521727,17.043478260869566
3083,24799,-146099,25,31,56,44.64,-0.01766785714285715,18.785714285714285
3085,6606,-39486,23,45,68,33.82,-0.0019985294117647176,12.647058823529411
3086,4739,-21949,20,27,47,42.55,-0.03598936170212765,18.319148936170212
3088,7705,-10455,18,16,34,52.94,-0.0044676470588235285,50.6764705882353
3089,5041,1709,33,25,58,56.9,0.026174137931034482,13.413793103448276
3092,5517,-16257,17,19,36,47.22,-0.012875000000000004,28.694444444444443
3093,6918,-33568,13,14,27,48.15,-0.01904074074074074,77.03703703703704
3095,5883,-45373,20,38,58,34.48,-0.03690689655172413,12.689655172413794
3105,19924,-48374,11,11,22,50.0,0.00156363636363636,19.045454545454547
3114,3473,-14433,17,19,36,47.22,-0.01471111111111111,34.80555555555556
3115,3521,-1281,20,24,44,45.45,-0.0009704545454545444,35.06818181818182
3118,3846,6804,12,9,21,57.14,0.014971428571428566,90.61904761904762
3122,1370,-12530,6,9,15,40.0,-0.04004666666666666,17.733333333333334
3128,4521,-10651,22,22,44,50.0,-0.002722727272727273,24.954545454545453
3131,26420,-45920,12,14,26,46.15,-0.010384615384615383,27.884615384615383
3141,5286,6564,12,8,20,60.0,-0.0013750000000000034,18.4
3147,1895,1045,5,8,13,38.46,0.04586923076923076,340.15384615384613
3152,40390,-167490,19,20,39,48.72,-0.014541025641025645,18.23076923076923
3162,4612,-13462,21,31,52,40.38,-0.014023076923076925,36.42307692307692
3163,6719,-31019,13,14,27,48.15,-0.01478518518518519,14.148148148148149
3169,7278,-23878,10,16,26,38.46,-0.032123076923076935,38.69230769230769
3171,3256,-20906,15,26,41,36.59,-0.03526341463414634,39.853658536585364
3176,11373,-70873,12,18,30,40.0,-0.015936666666666672,23.533333333333335
3178,3925,-6145,15,21,36,41.67,-0.013027777777777775,31.86111111111111
3188,5843,-36823,22,29,51,43.14,-0.01714705882352941,23.19607843137255
3191,5190,-2250,29,26,55,52.73,0.00804181818181818,15.454545454545455
3202,4985,-8345,25,28,53,47.17,-0.009973584905660374,22.9811320754717
3205,18561,-19031,28,34,62,45.16,-0.006772580645161291,18.370967741935484
3206,4418,-2108,20,17,37,54.05,0.001594594594594595,34.810810810810814
3207,3409,-15419,19,27,46,41.3,-0.021430434782608695,19.543478260869566
3211,13907,-42357,16,16,32,50.0,-0.005634375000000004,36.59375
3213,11014,-69414,12,22,34,35.29,-0.039858823529411766,39.35294117647059
3217,5933,-43183,16,23,39,41.03,-0.028425641025641026,33.46153846153846
3218,13807,35443,21,20,41,51.22,-0.0018780487804878076,26.804878048780488
3219,6816,4844,26,28,54,48.15,0.006566666666666661,19.48148148148148
3221,6366,17174,30,20,50,60.0,0.019246000000000003,23.42
3224,6346,5974,28,25,53,52.83,-0.003920754716981135,27.245283018867923
3226,5777,-39797,11,22,33,33.33,-0.03361515151515151,46.15151515151515
3227,29617,-379817,12,29,41,29.27,-0.05925609756097561,20.536585365853657
3228,16710,-96910,26,22,48,54.17,0.0004979166666666673,17.625
3230,4321,-17811,26,24,50,52.0,-0.016414,18.98
3232,5595,-23995,24,27,51,47.06,-0.00666078431372549,15.627450980392156
3234,4146,-21596,10,13,23,43.48,-0.02165217391304348,17.043478260869566
3236,4411,-6771,23,23,46,50.0,-0.007093478260869565,18.956521739130434
3252,5710,-10180,27,33,60,45.0,-0.02554166666666667,25.883333333333333
3259,5937,-18387,19,28,47,40.43,-0.0180531914893617,23.106382978723403
3260,16006,-55826,27,30,57,47.37,-0.013489473684210529,16.42105263157895
3264,4257,-7607,16,16,32,50.0,-0.006015624999999999,28.65625
3265,5001,-6031,23,16,39,58.97,0.005215384615384618,16.358974358974358
3268,8073,-42503,27,29,56,48.21,-0.010662500000000002,15.25
3272,6824,-35124,11,16,27,40.74,-0.027770370370370372,15.925925925925926
3276,3990,-10970,24,30,54,44.44,-0.01852962962962963,27.01851851851852
3284,3153,-1813,19,22,41,46.34,-0.0009170731707317079,46.65853658536585
3285,2531,3769,12,9,21,57.14,0.01240952380952381,28.095238095238095
3287,3280,230,23,18,41,56.1,0.004068292682926832,20.170731707317074
3288,6384,-18634,26,30,56,46.43,-0.020242857142857142,14.696428571428571
3289,12762,-8112,26,21,47,55.32,0.0060127659574468065,19.659574468085108
3290,3882,-7862,22,22,44,50.0,0.006772727272727272,28.045454545454547
3293,43876,-35726,18,22,40,45.0,-0.02128,21.95
3294,4143,-16873,19,20,39,48.72,-0.014802564102564099,22.974358974358974
3297,4587,-37377,16,20,36,44.44,-0.03231388888888889,35.388888888888886
3303,5055,-11885,20,18,38,52.63,0.0022421052631578947,27.263157894736842
3306,6952,-61902,16,27,43,37.21,-0.03553953488372093,15.790697674418604
3310,3911,-4411,13,18,31,41.94,-0.012709677419354842,29.35483870967742
3313,7600,-32410,23,30,53,43.4,-0.023028301886792446,18.32075471698113
3317,7082,-49612,16,23,39,41.03,-0.03608205128205129,13.025641025641026
3322,2362,148,15,17,32,46.88,0.0002875000000000013,30.625
3323,6186,-37686,14,20,34,41.18,-0.03542941176470588,26.235294117647058
3324,16642,-74182,25,29,54,46.3,-0.011631481481481484,15.87037037037037
3325,6078,-8718,24,24,48,50.0,-0.0024291666666666684,20.479166666666668
3332,3721,-21271,8,10,18,44.44,-0.027355555555555546,108.72222222222223
3339,5693,-13033,36,30,66,54.55,0.001784848484848488,15.0
3354,4705,-21215,23,23,46,50.0,-0.005980434782608694,17.847826086956523
3360,3379,-6039,25,18,43,58.14,0.004786046511627909,22.72093023255814
3362,7451,-13651,23,24,47,48.94,-0.004606382978723404,20.4468085106383
3363,4160,-8610,15,12,27,55.56,0.0009925925925925927,35.55555555555556
3372,3019,-19429,17,26,43,39.53,-0.03580697674418605,26.209302325581394
3373,7392,-57792,15,26,41,36.59,-0.03600731707317073,35.53658536585366
3374,4908,8292,8,5,13,61.54,0.01214615384615385,13.153846153846153
3379,3199,-15309,15,13,28,53.57,-0.010060714285714286,25.214285714285715
3388,11714,-58614,11,17,28,39.29,-0.02293571428571429,62.25
3390,4392,-11812,16,18,34,47.06,-0.01171176470588235,34.88235294117647
3402,4552,-30992,16,21,37,43.24,-0.03125675675675676,26.37837837837838
3426,2341,-15991,4,5,9,44.44,-0.04163333333333333,115.66666666666667
3434,2546,6944,23,12,35,65.71,0.024317142857142853,25.2
3438,17524,-27374,20,23,43,46.51,-0.012448837209302326,30.790697674418606
3441,5517,-2217,17,17,34,50.0,-0.0015205882352941188,18.88235294117647
3444,2712,3238,12,8,20,60.0,0.005239999999999998,47.3
3455,4827,-23327,12,15,27,44.44,-0.020555555555555556,20.296296296296298
3465,6229,-23149,18,18,36,50.0,0.019066666666666666,23.333333333333332
3466,8295,-38695,27,26,53,50.94,-0.0085188679245283,31.67924528301887
3479,6917,20683,15,11,26,57.69,0.015811538461538464,35.19230769230769
3483,12576,-130236,18,31,49,36.73,-0.03529591836734693,17.3265306122449
3484,5137,-41287,11,19,30,36.67,-0.03327,41.93333333333333
3489,3608,-7128,24,18,42,57.14,0.006123809523809522,30.333333333333332
3490,9010,-50160,18,26,44,40.91,-0.025918181818181816,20.477272727272727
3491,12533,12867,18,15,33,54.55,0.010033333333333333,27.393939393939394
3492,2186,-8086,6,11,17,35.29,-0.010852941176470591,18.0
3498,10677,-33677,26,28,54,48.15,-0.0050222222222222205,19.75925925925926
3499,5383,-35683,20,24,44,45.45,-0.015431818181818185,25.522727272727273
3508,11284,-53824,21,25,46,45.65,-0.023256521739130433,13.934782608695652
3511,5347,-3197,17,15,32,53.12,0.00021249999999999871,28.625
3512,5982,2618,23,22,45,51.11,0.006180000000000001,19.644444444444446
3516,2640,-4200,19,14,33,57.58,0.006363636363636358,28.303030303030305
3520,7193,-26003,18,25,43,41.86,-0.022279069767441866,17.46511627906977
3521,3675,-12625,18,22,40,45.0,-0.010387500000000004,37.075
3522,4245,-23235,19,23,42,45.24,-0.02531190476190476,19.476190476190474
3523,7713,-32323,24,32,56,42.86,-0.0050392857142857175,21.017857142857142
3526,9514,-19214,16,17,33,48.48,-0.009884848484848486,34.45454545454545
3527,20286,-125186,14,22,36,38.89,-0.03782777777777777,21.166666666666668
3529,50100,202100,14,7,21,66.67,0.03773809523809522,21.666666666666668
3531,3631,-10731,14,15,29,48.28,-0.012806896551724133,52.62068965517241
3537,3980,-3030,15,13,28,53.57,-0.004221428571428571,23.25
3540,8270,-7840,23,22,45,51.11,-0.008597777777777779,19.42222222222222
3541,11664,-92214,15,18,33,45.45,-0.02273333333333333,28.96969696969697
3546,22290,-156240,18,25,43,41.86,-0.031023255813953494,20.046511627906977
3548,7378,-8528,21,18,39,53.85,0.007935897435897432,17.487179487179485
3551,5733,-14883,11,14,25,44.0,-0.007991999999999997,48.76
3552,23243,-155493,13,21,34,38.24,-0.02568823529411765,15.029411764705882
3555,6405,-29275,18,20,38,47.37,-0.02633947368421053,13.157894736842104
3556,8853,-31853,16,13,29,55.17,-0.010924137931034484,30.689655172413794
3558,11745,-101945,6,10,16,37.5,-0.03994375,30.6875
3564,4752,-25752,9,14,23,39.13,-0.02346086956521739,36.0
3567,1871,-13701,8,10,18,44.44,-0.035833333333333335,46.888888888888886
3570,8573,22577,14,9,23,60.87,0.025352173913043476,56.82608695652174
3577,4803,-6703,13,11,24,54.17,0.005045833333333336,50.0
3580,5137,-25427,16,25,41,39.02,-0.02485121951219512,22.585365853658537
3581,1231,-3331,6,7,13,46.15,-0.007576923076923082,23.307692307692307
3587,7695,-64895,6,15,21,28.57,-0.048452380952380955,33.142857142857146
3594,3411,-6311,11,10,21,52.38,0.002500000000000005,32.76190476190476
3597,1112,7118,8,4,12,66.67,0.064,229.25
3609,2915,-165,14,12,26,53.85,0.006030769230769229,31.307692307692307
3611,23525,62875,15,7,22,68.18,0.030172727272727275,44.86363636363637
3615,6258,-43358,14,19,33,42.42,-0.019806060606060612,17.606060606060606
3623,6734,-6514,21,18,39,53.85,-0.0024051282051282055,19.666666666666668
3624,3007,-16207,10,12,22,45.45,-0.018145454545454544,35.40909090909091
3625,3216,-18436,17,17,34,50.0,-0.01173235294117647,26.58823529411765
3628,10713,-109263,12,17,29,41.38,-0.023451724137931035,45.06896551724138
3629,5207,-18757,15,23,38,39.47,0.015315789473684204,15.947368421052632
3630,11151,-102251,16,24,40,40.0,-0.0309525,13.375
3631,5719,-8919,14,17,31,45.16,-0.005203225806451614,26.322580645161292
3632,4727,10883,21,14,35,60.0,0.03251999999999999,21.285714285714285
3642,3497,-4247,17,16,33,51.52,-0.0002090909090909134,27.333333333333332
3646,2839,-21489,8,16,24,33.33,-0.04684166666666667,30.541666666666668
3652,3152,-13402,13,12,25,52.0,-0.015364000000000004,49.04
3663,2732,13868,14,8,22,63.64,0.0371,31.954545454545453
3664,3598,-1958,19,17,36,52.78,0.005788888888888891,18.27777777777778
3666,3645,-27595,12,15,27,44.44,-0.0342925925925926,12.333333333333334
3672,1829,-8569,7,9,16,43.75,-0.03450625,36.0
3675,3006,-12906,8,8,16,50.0,-0.015006249999999999,24.6875
3680,8431,-11581,5,11,16,31.25,-0.04213125,22.375
3684,2622,-4822,6,6,12,50.0,-0.00664166666666667,59.666666666666664
3685,5756,-6,18,17,35,51.43,0.017962857142857138,20.82857142857143
3687,12308,-81908,15,16,31,48.39,-0.01105483870967741,21.70967741935484
3689,4761,-45711,9,12,21,42.86,-0.03185238095238095,42.523809523809526
3691,70349,-438449,21,25,46,45.65,-0.018928260869565217,17.565217391304348
3693,13855,13395,17,17,34,50.0,0.0004294117647058808,15.588235294117647
3707,2074,25836,11,5,16,68.75,0.05752500000000001,12.3125
3709,809,2541,4,3,7,57.14,0.021600000000000005,30.857142857142858
3710,475,-2455,2,6,8,25.0,-0.04516250000000001,26.375
3713,1203,-3253,3,3,6,50.0,-0.014083333333333331,20.333333333333332
4102,6261,4739,25,21,46,54.35,0.01654130434782609,39.67391304347826
4105,15497,-81847,17,23,40,42.5,-0.023335,43.0
4107,13040,-62280,22,20,42,52.38,-0.005488095238095239,29.476190476190474
4109,5042,-21792,22,25,47,46.81,-0.012385106382978725,33.0
4111,4018,13582,20,14,34,58.82,0.026985294117647062,71.82352941176471
4113,3653,-16383,21,27,48,43.75,-0.02351666666666667,28.666666666666668
4114,5944,3856,25,16,41,60.98,0.014760975609756097,35.609756097560975
4116,2522,-12272,5,8,13,38.46,-0.030076923076923077,59.30769230769231
4120,9743,-43143,18,20,38,47.37,-0.014876315789473685,40.28947368421053
4121,4807,-8877,24,22,46,52.17,-0.01318478260869565,27.108695652173914
4123,11752,18048,25,21,46,54.35,0.009330434782608693,37.95652173913044
4126,12134,-51084,20,20,40,50.0,-0.009377499999999995,49.45
4127,3975,15025,24,16,40,60.0,0.026332500000000002,32.9
4128,7106,19554,23,19,42,54.76,0.01385,34.07142857142857
4129,7344,-20144,21,17,38,55.26,-0.0018184210526315766,44.36842105263158
4130,4825,-18825,11,13,24,45.83,-0.007462499999999997,28.25
4131,6365,-5355,29,33,62,46.77,-0.011719354838709672,14.14516129032258
4138,8278,-8928,11,9,20,55.0,-0.004095000000000002,72.75
4139,8343,-70293,8,19,27,29.63,-0.03933333333333334,61.111111111111114
4147,14538,-71538,9,11,20,45.0,-0.027165000000000005,22.7
4153,5561,-18861,12,11,23,52.17,-0.0020869565217391285,28.956521739130434
4154,4073,6227,15,12,27,55.56,0.010574074074074073,28.555555555555557
4157,3029,-4579,12,10,22,54.55,-0.008636363636363635,31.363636363636363
4160,3052,-352,10,9,19,52.63,0.007047368421052629,31.157894736842106
4161,6086,-6736,10,11,21,47.62,-0.008161904761904763,60.95238095238095
4162,20600,8350,14,13,27,51.85,0.0030185185185185176,24.037037037037038
4163,14680,-14380,12,10,22,54.55,-0.0028954545454545452,45.40909090909091
4167,1626,-17726,3,10,13,23.08,-0.06017692307692308,41.61538461538461
4168,9221,-5571,18,17,35,51.43,0.008600000000000002,23.885714285714286
4171,7048,-23298,8,11,19,42.11,-0.026410526315789475,27.57894736842105
4173,2759,-14459,10,10,20,50.0,-0.015900000000000004,38.5
4174,23523,-69123,10,11,21,47.62,-0.0170952380952381,18.904761904761905
4175,5315,19285,8,5,13,61.54,0.023769230769230768,101.23076923076923
4183,959,-5109,3,6,9,33.33,-0.027488888888888882,61.333333333333336
4188,2079,-2879,8,8,16,50.0,-0.01175,47.0625
4192,4631,-13331,10,13,23,43.48,-0.01859565217391304,30.26086956521739
4198,2642,6128,14,16,30,46.67,0.051923333333333335,27.2
4205,4976,10074,12,5,17,70.59,0.036717647058823535,144.2941176470588
4207,2277,-4647,15,17,32,46.88,-0.010596875000000002,70.53125
4303,3397,-387,24,16,40,60.0,-0.0031700000000000035,20.65
4304,3807,-11267,28,35,63,44.44,-0.015765079365079367,19.206349206349206
4305,3157,6083,17,10,27,62.96,0.020207407407407403,105.11111111111111
4401,9075,-1345,21,16,37,56.76,0.013305405405405406,44.567567567567565
4402,2952,-6052,20,35,55,36.36,-0.039389090909090915,18.30909090909091
4406,2339,551,21,17,38,55.26,0.006239473684210526,62.44736842105263
4413,3126,-10706,21,32,53,39.62,-0.023452830188679247,15.150943396226415
4416,13835,27315,16,15,31,51.61,0.02115483870967742,65.6774193548387
4417,4527,3123,20,17,37,54.05,0.0075891891891891935,70.75675675675676
4419,5399,-1639,30,29,59,50.85,0.028079661016949156,17.47457627118644
4420,3975,17525,17,12,29,58.62,0.029296551724137927,96.65517241379311
4430,3014,-2914,8,9,17,47.06,-0.007270588235294117,85.6470588235294
4432,4738,-50188,8,14,22,36.36,-0.04360000000000001,34.13636363636363
4433,3478,25872,14,6,20,70.0,0.04601499999999999,44.6
4502,7532,-7672,29,31,60,48.33,-0.0016516666666666678,28.783333333333335
4503,4982,-5392,25,31,56,44.64,-0.00319107142857143,17.571428571428573
4506,2609,7731,14,9,23,60.87,0.014000000000000002,85.52173913043478
4510,3569,-9729,17,29,46,36.96,-0.022456521739130434,35.108695652173914
4513,2966,-2016,20,18,38,52.63,0.005102631578947368,41.94736842105263
4523,6259,12531,25,22,47,53.19,0.0010765957446808487,35.1063829787234
4527,3713,-2963,18,15,33,54.55,0.0027606060606060593,67.45454545454545
4528,6137,-25157,18,19,37,48.65,-0.008294594594594591,37.67567567567568
4529,4550,-4870,26,24,50,52.0,0.009133999999999998,26.48
4530,3964,-14144,28,35,63,44.44,-0.007901587301587302,18.555555555555557
4533,3705,-15425,21,20,41,51.22,-0.010121951219512194,38.48780487804878
4534,4500,-13280,22,34,56,39.29,-0.018901785714285715,30.285714285714285
4535,7388,-88,15,14,29,51.72,-0.0012103448275862091,99.17241379310344
4538,1091,2089,6,6,12,50.0,0.017666666666666667,54.583333333333336
4541,2145,-5345,6,8,14,42.86,-0.006657142857142861,55.0
4542,2914,-24014,7,12,19,36.84,-0.035268421052631574,14.894736842105264
4543,1136,214,7,4,11,63.64,0.0024090909090909098,52.90909090909091
4549,5839,-70439,3,9,12,25.0,-0.06196666666666666,29.0
4550,1179,8021,6,4,10,60.0,0.04319,63.1
4554,2403,-5153,8,9,17,47.06,-0.005552941176470589,36.1764705882353
4556,1683,5467,5,4,9,55.56,0.02102222222222222,124.33333333333333
4561,1344,4556,5,4,9,55.56,0.016822222222222225,37.55555555555556
4563,2851,-561,4,6,10,40.0,-0.016220000000000005,84.6
4568,2108,-4808,4,2,6,66.67,-0.007799999999999999,80.83333333333333
4580,1614,-214,1,2,3,33.33,-0.0007999999999999998,99.0
4609,3301,-15421,16,26,42,38.1,-0.026530952380952384,26.88095238095238
4702,3973,-5583,27,30,57,47.37,-0.006898245614035089,18.964912280701753
4706,2024,-4574,14,11,25,56.0,0.0004200000000000012,109.76
4707,3890,-3800,24,18,42,57.14,0.0013785714285714287,38.95238095238095
4711,2927,-13977,14,19,33,42.42,-0.021460606060606062,87.12121212121212
4712,5519,-31339,20,43,63,31.75,-0.038263492063492055,20.142857142857142
4714,3241,-14841,21,23,44,47.73,-0.023238636363636368,27.522727272727273
4716,4371,-291,24,19,43,55.81,0.01591162790697674,29.372093023255815
4721,8635,-54335,16,26,42,38.1,-0.0431595238095238,34.333333333333336
4726,5506,-13156,14,16,30,46.67,-0.004596666666666666,23.633333333333333
4728,4930,3170,12,8,20,60.0,0.012620000000000003,32.5
4729,3861,-19181,16,25,41,39.02,-0.013751219512195122,22.78048780487805
4735,4747,-3247,11,9,20,55.0,0.002880000000000005,33.7
4736,14219,62381,15,10,25,60.0,0.017995999999999998,31.32
4741,9944,-26184,13,19,32,40.62,-0.020553125,44.78125
4743,9551,-33451,14,12,26,53.85,0.0021461538461538454,20.423076923076923
4744,6908,-23588,13,21,34,38.24,-0.025564705882352937,26.647058823529413
4745,6686,-31886,10,12,22,45.45,-0.015940909090909092,49.40909090909091
4747,3007,-33857,3,9,12,25.0,-0.05375833333333333,166.33333333333334
4754,2026,-9776,4,4,8,50.0,-0.019650000000000004,77.25
4760,2226,-6946,3,3,6,50.0,-0.008066666666666672,67.5
4767,529,2671,3,1,4,75.0,0.036449999999999996,35.5
4804,6388,-61608,13,22,35,37.14,-0.037891428571428576,24.34285714285714
4806,3816,-35066,10,14,24,41.67,-0.0104625,16.625
4903,3620,-23190,20,30,50,40.0,-0.02948,15.8
4905,5149,4971,18,15,33,54.55,0.008875757575757577,43.60606060606061
4907,4306,4914,32,26,58,55.17,0.021198275862068967,25.810344827586206
4908,8516,-48366,23,27,50,46.0,-0.019443999999999996,19.38
4909,8692,-25342,25,25,50,50.0,-0.004770000000000001,34.48
4911,10384,-43684,13,21,34,38.24,-0.025405882352941177,29.205882352941178
4924,2921,-6791,19,10,29,65.52,0.006927586206896551,21.06896551724138
4931,2475,-12785,9,15,24,37.5,0.06849583333333333,66.125
4933,7612,-56862,8,20,28,28.57,-0.040853571428571434,27.928571428571427
4939,2215,-11955,10,15,25,40.0,-0.03559999999999999,24.52
4944,3896,-18816,17,22,39,43.59,-0.03037179487179487,11.205128205128204
4945,249,351,1,0,1,100.0,0.0083,4.0
4946,9440,-8090,19,18,37,51.35,0.0027621621621621616,29.2972972972973
4950,2464,-17804,11,16,27,40.74,-0.0236962962962963,34.407407407407405
4953,4850,8050,9,8,17,52.94,0.0036588235294117643,35.411764705882355
4966,47602,-138602,10,9,19,52.63,-0.003157894736842105,11.68421052631579
4971,8054,25996,13,8,21,61.9,0.020242857142857146,17.19047619047619
4972,2205,5045,7,5,12,58.33,0.025866666666666666,127.83333333333333
4973,3155,-11655,11,13,24,45.83,-0.006775000000000001,35.625
4974,2766,-5516,6,6,12,50.0,-0.014391666666666669,39.25
4979,5664,-38164,13,17,30,43.33,-0.0364,15.1
4987,4940,-30440,6,8,14,42.86,-0.023814285714285722,88.35714285714286
4991,6057,-657,10,9,19,52.63,-0.0029631578947368425,22.736842105263158
4995,3720,-22070,6,12,18,33.33,-0.029355555555555555,56.27777777777778
5009,4747,-17547,18,19,37,48.65,-0.008521621621621622,28.89189189189189
5011,4337,-12787,24,28,52,46.15,-0.02612884615384615,32.67307692307692
5013,3254,-23674,11,21,32,34.38,-0.040546874999999996,53.8125
5014,3645,-17665,20,29,49,40.82,-0.026455102040816327,24.79591836734694
5015,3991,-16091,16,18,34,47.06,-0.015044117647058826,48.6764705882353
5016,4471,-8321,16,15,31,51.61,0.0007096774193548385,65.90322580645162
5102,1977,1113,13,11,24,54.17,0.0018916666666666641,91.58333333333333
5201,5280,-8210,26,25,51,50.98,-0.0003431372549019605,23.392156862745097
5202,4090,1630,26,26,52,50.0,-0.0009980769230769205,25.307692307692307
5205,6513,-61473,30,39,69,43.48,-0.019552173913043484,17.47826086956522
5206,3300,-17500,22,32,54,40.74,-0.02451851851851852,28.90740740740741
5209,5690,-10690,10,17,27,37.04,-0.03168148148148147,72.62962962962963
5210,2702,-1162,21,21,42,50.0,-0.0036928571428571414,29.738095238095237
5211,7014,-17614,23,22,45,51.11,-0.009262222222222226,31.77777777777778
5212,4505,-4755,16,20,36,44.44,-0.008147222222222222,38.97222222222222
5213,4322,8608,24,22,46,52.17,0.007286956521739128,35.17391304347826
5220,1769,-6169,5,6,11,45.45,-0.02090909090909091,53.72727272727273
5223,1915,-17065,2,6,8,25.0,-0.0420375,22.25
5227,3577,-26157,9,16,25,36.0,-0.028432000000000002,17.12
5230,5158,-35008,8,13,21,38.1,-0.03314285714285714,54.76190476190476
5245,6526,-29376,9,9,18,50.0,-0.011344444444444442,23.77777777777778
5251,3490,50,11,10,21,52.38,0.012104761904761905,45.285714285714285
5263,24861,-175261,9,14,23,39.13,-0.021047826086956524,26.391304347826086
5272,4017,-26467,11,11,22,50.0,-0.01085454545454545,20.727272727272727
5274,81802,43198,11,4,15,73.33,0.04686000000000001,11.066666666666666
5276,1538,-7988,7,10,17,41.18,-0.021823529411764707,55.23529411764706
5278,11348,-62448,12,15,27,44.44,-0.012807407407407411,15.88888888888889
5281,3033,-20983,8,8,16,50.0,-0.029050000000000006,32.25
5287,21933,3067,8,8,16,50.0,0.00704375,53.3125
5289,8818,36382,8,5,13,61.54,0.01946923076923077,27.384615384615383
5291,1195,2605,6,6,12,50.0,0.03973333333333333,25.416666666666668
5299,5776,5034,8,12,20,40.0,-0.014055000000000007,29.95
5301,8185,10375,39,40,79,49.37,0.00042151898734177037,22.518987341772153
5302,4169,-13269,29,25,54,53.7,-0.0013092592592592583,17.40740740740741
5306,14356,23774,25,22,47,53.19,0.003797872340425532,38.06382978723404
5309,3230,-16940,19,26,45,42.22,-0.025302222222222222,18.066666666666666
5310,7519,6061,35,34,69,50.72,0.01659565217391304,18.884057971014492
5312,8211,-5161,15,10,25,60.0,0.005932000000000004,89.52
5314,3917,-7647,28,37,65,43.08,-0.023335384615384615,17.092307692307692
5315,3241,-15611,18,30,48,37.5,-0.03307291666666667,19.4375
5321,6333,-22363,30,38,68,44.12,-0.022469117647058827,14.367647058823529
5324,4539,-16379,18,33,51,35.29,-0.033019607843137254,40.529411764705884
5328,3580,-4770,29,30,59,49.15,-0.010937288135593224,21.559322033898304
5340,3740,-19310,22,24,46,47.83,-0.02378260869565217,27.0
5344,3401,-13341,22,31,53,41.51,-0.0166622641509434,23.81132075471698
5345,4203,2867,39,31,70,55.71,0.0037600000000000008,17.6
5347,7631,-19221,24,19,43,55.81,0.004304651162790697,17.25581395348837
5348,4993,6787,37,29,66,56.06,0.02658333333333334,21.893939393939394
5351,6004,-28474,19,34,53,35.85,-0.042535849056603764,14.39622641509434
5353,2990,1550,22,19,41,53.66,0.008087804878048782,23.609756097560975
5355,3769,-12069,28,27,55,50.91,-0.012514545454545459,26.12727272727273
5356,6672,-65592,21,28,49,42.86,-0.03125102040816327,34.265306122448976
5364,5639,-35319,30,29,59,50.85,-0.013016949152542373,20.35593220338983
5371,9301,-25501,24,25,49,48.98,-0.013661224489795919,21.20408163265306
5381,3288,-3718,31,31,62,50.0,-0.014119354838709679,15.483870967741936
5383,3808,3302,26,21,47,55.32,0.007678723404255317,27.404255319148938
5386,7250,-11720,26,33,59,44.07,-0.012738983050847457,27.627118644067796
5392,17373,10897,28,22,50,56.0,0.006209999999999997,23.74
5398,5234,-9904,23,29,52,44.23,-0.013673076923076925,30.557692307692307
5403,3303,12897,14,12,26,53.85,0.009365384615384617,92.1923076923077
5410,2878,11412,21,17,38,55.26,0.018889473684210522,33.23684210526316
5425,6507,-14077,26,21,47,55.32,0.0001276595744680858,22.893617021276597
5426,3038,8822,26,13,39,66.67,0.02858717948717948,53.76923076923077
5432,3477,-4327,23,25,48,47.92,-0.019064583333333333,14.916666666666666
5438,6119,-21719,23,23,46,50.0,-0.006006521739130432,47.608695652173914
5439,5826,-13086,22,21,43,51.16,-0.0027139534883720926,35.95348837209303
5443,4638,4052,24,22,46,52.17,0.004756521739130439,18.52173913043478
5450,5220,-2810,31,26,57,54.39,0.0038140350877193,29.12280701754386
5452,5761,-32891,28,30,58,48.28,-0.010462068965517242,26.75862068965517
5455,4720,12580,40,34,74,54.05,0.07097162162162163,9.797297297297296
5457,7020,-15520,24,29,53,45.28,-0.015167924528301888,16.867924528301888
5460,3885,8075,26,20,46,56.52,0.017189130434782606,42.391304347826086
5464,5659,-3819,26,22,48,54.17,0.0022583333333333344,43.333333333333336
5465,4039,171,31,26,57,54.39,0.01800526315789474,26.63157894736842
5468,4424,-9434,33,38,71,46.48,-0.0070690140845070405,16.492957746478872
5474,14940,15970,28,26,54,51.85,0.006811111111111107,15.037037037037036
5475,4285,-17615,29,34,63,46.03,-0.014222222222222225,14.666666666666666
5478,23222,-24322,27,28,55,49.09,-0.005501818181818186,23.672727272727272
5481,4869,-23259,21,34,55,38.18,-0.028032727272727265,28.036363636363635
5483,19634,-66834,22,26,48,45.83,-0.01440833333333333,13.895833333333334
5487,4325,475,21,17,38,55.26,0.002939473684210525,38.18421052631579
5488,4197,-24547,24,28,52,46.15,-0.012467307692307694,33.75
5489,6967,-37517,13,19,32,40.62,-0.021996875,65.28125
5490,9686,-35936,19,30,49,38.78,-0.019595918367346934,26.081632653061224
5493,4016,12624,17,17,34,50.0,0.011467647058823527,51.470588235294116
5498,3431,-11441,23,27,50,46.0,-0.017864,25.16
5508,5887,-17737,16,12,28,57.14,-0.0007142857142857154,55.107142857142854
5511,2759,13491,17,7,24,70.83,0.03401666666666667,77.75
5512,3155,-8575,20,23,43,46.51,-0.012272093023255815,41.46511627906977
5514,3236,10734,21,15,36,58.33,0.020833333333333336,43.888888888888886
5516,2866,12664,22,17,39,56.41,0.029120512820512826,48.46153846153846
5520,2911,9689,15,8,23,65.22,0.01632173913043478,131.0
5523,3664,-18424,21,25,46,45.65,-0.015547826086956517,34.47826086956522
5529,4935,-14655,27,28,55,49.09,-0.003252727272727272,25.854545454545455
5530,8830,-24300,20,20,40,50.0,-0.008715000000000002,42.025
5536,15837,84963,13,7,20,65.0,0.028035000000000004,61.45
5543,1220,2680,4,4,8,50.0,0.0324625,101.875
5601,2088,8572,14,6,20,70.0,0.036415,94.95
5603,2240,-910,16,15,31,51.61,0.007951612903225805,60.58064516129032
5604,3889,-21989,10,12,22,45.45,-0.012577272727272725,88.27272727272727
5609,4712,4288,16,15,31,51.61,0.007496774193548389,59.70967741935484
5701,3610,-1560,30,30,60,50.0,0.0025516666666666682,26.65
5703,3290,3360,13,13,26,50.0,0.01120769230769231,97.88461538461539
5704,3947,10153,16,13,29,55.17,0.016282758620689657,85.17241379310344
5820,2075,-11145,12,22,34,35.29,-0.0356235294117647,68.6470588235294
5864,1353,-1003,10,10,20,50.0,-0.008049999999999998,73.05
5878,1334,6966,4,1,5,80.0,0.03356,325.6
5902,3197,-2567,22,26,48,45.83,-0.011354166666666665,43.645833333333336
5903,13693,48957,12,5,17,70.59,0.03751764705882353,150.1764705882353
5904,33596,-91096,15,16,31,48.39,-0.009038709677419356,48.58064516129032
5905,3035,-10735,17,21,38,44.74,-0.02551578947368421,36.68421052631579
6015,2808,1342,25,20,45,55.56,0.0037266666666666663,28.266666666666666
6016,2548,3252,24,15,39,61.54,0.018428205128205127,35.84615384615385
6020,3104,4036,17,16,33,51.52,0.011893939393939394,56.696969696969695
6021,2410,-2260,16,16,32,50.0,-0.003471875000000001,37.40625
6023,3848,8202,9,7,16,56.25,0.021256249999999997,171.0
6026,722,-362,5,5,10,50.0,0.0018000000000000006,58.8
6101,7467,-32367,34,44,78,43.59,-0.024228205128205126,16.564102564102566
6103,6234,-5904,38,39,77,49.35,0.003737662337662335,12.064935064935066
6104,11095,-94745,20,36,56,35.71,-0.03771428571428571,18.5
6109,3217,-9887,22,25,47,46.81,-0.017017021276595747,39.170212765957444
6111,11448,912,32,25,57,56.14,0.014610526315789471,16.56140350877193
6113,3692,-3992,27,28,55,49.09,0.0026454545454545455,28.581818181818182
6114,7447,-15677,31,28,59,52.54,-0.0019711864406779626,22.11864406779661
6118,4186,-1786,27,25,52,51.92,-0.00421923076923077,18.596153846153847
6121,33867,162333,27,15,42,64.29,0.03563333333333333,23.047619047619047
6122,3202,9268,25,18,43,58.14,0.018758139534883724,43.46511627906977
6123,5829,-24619,20,24,44,45.45,-0.018945454545454547,27.045454545454547
6124,8729,-43909,26,33,59,44.07,-0.017322033898305084,26.694915254237287
6125,5163,-20483,20,21,41,48.78,-0.01879512195121951,32.63414634146341
6126,4845,-29845,21,22,43,48.84,-0.017793023255813948,36.651162790697676
6127,3953,-14083,22,29,51,43.14,-0.0183921568627451,16.254901960784313
6129,7192,-38672,28,32,60,46.67,-0.025679999999999998,16.0
6130,10561,-71191,28,41,69,40.58,0.12083623188405797,35.17391304347826
6134,8687,-52957,32,35,67,47.76,-0.015540298507462686,21.865671641791046
6138,10603,24647,26,19,45,57.78,0.012779999999999998,17.57777777777778
6140,3046,2224,22,21,43,51.16,0.008751162790697674,32.27906976744186
6143,12195,-51825,30,27,57,52.63,-0.0075140350877192985,20.596491228070175
6144,3030,2510,23,22,45,51.11,0.012580000000000001,41.0
6146,17064,-56814,16,18,34,47.06,0.000941176470588237,70.05882352941177
6147,10051,36239,27,18,45,60.0,0.009808888888888884,16.866666666666667
6148,3407,-12817,23,32,55,41.82,-0.030139999999999997,18.654545454545456
6150,13910,-93820,29,44,73,39.73,-0.026200000000000005,12.657534246575343
6151,5476,-22886,20,23,43,46.51,-0.01667674418604651,47.74418604651163
6154,4923,-24573,12,20,32,37.5,-0.015359375000000001,109.9375
6156,5503,-10573,28,40,68,41.18,-0.02703529411764706,17.470588235294116
6158,10097,-8117,29,27,56,51.79,0.0014589285714285704,22.035714285714285
6160,10147,37653,31,21,52,59.62,0.016080769230769232,34.28846153846154
6161,4604,-4744,30,26,56,53.57,0.0016821428571428593,26.017857142857142
6163,3774,-3394,25,21,46,54.35,0.0004152173913043487,28.434782608695652
6167,3751,-2331,35,26,61,57.38,0.002937704918032787,16.21311475409836
6169,9974,-15424,35,29,64,54.69,0.0130890625,18.5
6170,6381,-8751,28,24,52,53.85,0.002659615384615387,33.21153846153846
6171,2751,-4721,16,20,36,44.44,-0.011330555555555556,36.111111111111114
6173,6629,-11129,28,26,54,51.85,0.0035425925925925915,24.25925925925926
6174,3600,-7410,24,27,51,47.06,0.011819607843137256,30.41176470588235
6175,5182,-25722,26,31,57,45.61,-0.01810175438596491,25.842105263157894
6179,7057,-21807,25,27,52,48.08,-0.015200000000000003,34.07692307692308
6180,12078,34272,36,21,57,63.16,0.024105263157894734,24.526315789473685
6182,10570,-40770,21,24,45,46.67,-0.02464666666666667,17.044444444444444
6185,6479,-41079,22,27,49,44.9,-0.032228571428571426,33.57142857142857
6186,5375,-25785,22,36,58,37.93,-0.029282758620689662,23.56896551724138
6187,12629,-50929,26,33,59,44.07,-0.01602372881355932,22.305084745762713
6188,14046,-115146,22,30,52,42.31,-0.029375000000000002,27.5
6190,3469,-16049,20,26,46,43.48,-0.024526086956521743,29.97826086956522
6194,6201,-11151,15,21,36,41.67,-0.013769444444444444,67.55555555555556
6195,10259,-66799,23,33,56,41.07,-0.030208928571428564,32.94642857142857
6198,6096,6724,37,29,66,56.06,0.015703030303030302,20.833333333333332
6199,5008,-10288,27,34,61,44.26,-0.012116393442622954,24.098360655737704
6203,13517,-82117,19,24,43,44.19,-0.01882093023255814,39.13953488372093
6204,6286,-44536,15,23,38,39.47,-0.02143684210526316,59.21052631578947
6207,6984,-31334,22,23,45,48.89,-0.014891111111111112,34.4
6208,4741,-9611,21,19,40,52.5,-0.011267500000000003,28.65
6210,5668,-26158,15,22,37,40.54,-0.028237837837837843,37.24324324324324
6212,5341,-37521,19,29,48,39.58,-0.036283333333333334,36.770833333333336
6217,8625,16085,32,31,63,50.79,0.005290476190476189,20.46031746031746
6218,4951,-9501,18,20,38,47.37,-0.006397368421052631,45.8421052631579
6219,3725,-20125,19,33,52,36.54,-0.03561730769230769,31.76923076923077
6220,5967,-17257,25,26,51,49.02,-0.010474509803921568,23.980392156862745
6221,4498,9462,21,20,41,51.22,0.005387804878048776,39.21951219512195
6222,3757,4213,31,24,55,56.36,0.0025690909090909098,23.927272727272726
6223,17984,-57584,19,26,45,42.22,-0.021424444444444437,18.933333333333334
6227,5169,-2919,23,19,42,54.76,0.0005214285714285708,36.476190476190474
6228,4219,-5499,29,33,62,46.77,-0.0013145161290322584,22.70967741935484
6229,5071,-1321,29,24,53,54.72,0.004928301886792453,23.77358490566038
6231,17331,-79881,25,30,55,45.45,-0.01805818181818182,16.490909090909092
6233,10135,-56805,33,36,69,47.83,-0.021105797101449275,15.289855072463768
6234,8842,-36442,23,25,48,47.92,-0.020972916666666664,30.333333333333332
6236,6595,14115,35,33,68,51.47,0.03286617647058824,13.397058823529411
6237,16167,-110527,28,30,58,48.28,-0.011712068965517238,17.551724137931036
6240,5007,-33837,27,36,63,42.86,-0.02234603174603174,18.38095238095238
6241,5137,-4887,28,33,61,45.9,-0.007685245901639341,20.0
6242,4809,-17419,23,25,48,47.92,-0.0027687500000000025,26.520833333333332
6244,34206,-52056,31,36,67,46.27,-0.01264328358208955,15.119402985074627
6245,8707,-3887,24,22,46,52.17,0.001349999999999997,22.67391304347826
6246,4989,-17289,34,38,72,47.22,-0.011477777777777781,19.23611111111111
6247,3065,-14265,14,20,34,41.18,-0.013755882352941177,80.55882352941177
6248,4974,-20384,23,31,54,42.59,-0.010842592592592593,32.74074074074074
6259,4481,-15541,30,39,69,43.48,-0.013395652173913043,13.855072463768115
6261,13450,-22200,21,19,40,52.5,0.00018999999999999573,39.775
6263,8220,-26770,15,19,34,44.12,-0.02307941176470588,42.94117647058823
6264,7506,-366,29,36,65,44.62,-0.009272307692307689,30.56923076923077
6265,3354,-6004,24,21,45,53.33,-0.010935555555555556,33.84444444444444
6266,3043,-7043,19,21,40,47.5,-0.005895,32.25
6270,4795,-5055,20,18,38,52.63,0.0021184210526315785,45.86842105263158
6274,8441,-45481,23,19,42,54.76,-0.007519047619047618,23.166666666666668
6275,3032,-5452,15,19,34,44.12,-0.019049999999999997,34.0
6276,4547,-21217,21,33,54,38.89,-0.032537037037037045,25.48148148148148
6279,14542,-542,21,15,36,58.33,0.00474722222222222,38.25
6284,7236,-11086,21,20,41,51.22,-0.013612195121951217,19.024390243902438
6287,3857,-3487,33,38,71,46.48,0.00047042253521126584,14.225352112676056
6290,7383,-48883,17,26,43,39.53,-0.03885116279069767,31.86046511627907
6291,4930,-11430,33,34,67,49.25,-0.005895522388059701,11.104477611940299
6292,4511,-4281,20,17,37,54.05,0.002340540540540538,47.24324324324324
6294,12651,-52461,24,35,59,40.68,-0.04496271186440678,26.084745762711865
6404,3415,-41645,9,19,28,32.14,-0.04998214285714286,21.035714285714285
6411,7515,-38815,6,10,16,37.5,-0.043818750000000004,20.6875
6417,2140,-9240,3,4,7,42.86,-0.010657142857142856,79.42857142857143
6418,1700,-2970,8,9,17,47.06,-0.004452941176470586,65.70588235294117
6419,2520,750,10,13,23,43.48,-0.007947826086956522,36.391304347826086
6425,4510,-37540,8,15,23,34.78,-0.03543043478260868,28.956521739130434
6426,9782,-17932,11,13,24,45.83,0.00028750000000000303,14.458333333333334
6432,2084,-484,7,7,14,50.0,-0.0005714285714285726,21.071428571428573
6435,4952,13548,6,3,9,66.67,0.011111111111111113,21.22222222222222
6441,7941,-57281,10,15,25,40.0,-0.036416,20.36
6446,9442,54258,9,5,14,64.29,0.04006428571428571,30.928571428571427
6457,5178,6272,8,4,12,66.67,0.017791666666666664,58.916666666666664
6461,2958,-10898,11,9,20,55.0,-0.000519999999999999,25.45
6462,15410,-95410,7,11,18,38.89,-0.02447777777777778,11.277777777777779
6465,5748,-61998,5,17,22,22.73,-0.059227272727272726,31.40909090909091
6469,2500,-25000,2,4,6,33.33,-0.05006666666666667,53.833333333333336
6470,3032,3268,9,4,13,69.23,0.01868461538461538,36.30769230769231
6472,8641,859,5,4,9,55.56,0.011811111111111113,27.666666666666668
6482,3339,-17089,7,9,16,43.75,-0.01588125,40.0625
6485,4208,-30008,6,9,15,40.0,-0.026920000000000003,32.0
6486,3777,22973,7,4,11,63.64,0.036218181818181816,31.181818181818183
6488,30849,-6349,9,5,14,64.29,0.028228571428571436,20.571428571428573
6492,7976,-10076,7,7,14,50.0,-0.006400000000000004,29.285714285714285
6494,3870,-31520,4,9,13,30.77,-0.04591538461538462,19.76923076923077
6496,3523,-22773,4,9,13,30.77,-0.04268461538461539,82.6923076923077
6499,8940,-71390,7,12,19,36.84,-0.03287368421052632,37.36842105263158
6506,1243,-693,7,6,13,53.85,0.006892307692307692,132.53846153846155
6508,3788,-5238,14,11,25,56.0,0.000663999999999999,94.2
6509,3674,-19274,18,16,34,52.94,-0.01720882352941176,38.14705882352941
6510,76456,-84456,8,11,19,42.11,-0.003821052631578948,21.68421052631579
6512,1763,-12763,5,9,14,35.71,-0.030828571428571424,57.642857142857146
6514,3766,-4366,9,7,16,56.25,0.0036437500000000046,36.0
6516,11450,-45360,7,10,17,41.18,-0.0208764705882353,29.58823529411765
6523,9069,-37569,8,8,16,50.0,-0.004899999999999996,28.5
6527,1514,41626,2,3,5,40.0,0.22366000000000003,312.0
6530,953,-873,6,4,10,60.0,-0.006019999999999996,55.7
6532,2418,-5868,5,6,11,45.45,-0.015636363636363636,21.0
6535,2631,-4731,7,7,14,50.0,0.0004428571428571377,40.642857142857146
6538,10919,-38719,7,12,19,36.84,-0.02683157894736843,30.105263157894736
6542,6659,4791,10,10,20,50.0,0.010720000000000004,25.65
6547,4271,48149,6,3,9,66.67,0.06403333333333333,70.33333333333333
6548,12629,-66629,4,8,12,33.33,-0.023983333333333332,35.5
6556,2092,-2892,6,4,10,60.0,-0.01156,65.5
6560,4748,-31248,6,11,17,35.29,-0.030241176470588237,27.647058823529413
6561,7370,-20370,3,2,5,60.0,0.004400000000000001,59.0
6568,13923,-144923,4,12,16,25.0,-0.05029375,12.875
6569,10255,-53255,5,7,12,41.67,-0.01774166666666667,62.083333333333336
6570,1964,-1294,6,5,11,54.55,0.002390909090909089,55.72727272727273
6574,6248,-43348,4,8,12,33.33,-0.036208333333333335,93.5
6576,4423,11217,8,4,12,66.67,0.015175,20.0
6577,2130,11470,4,2,6,66.67,0.04020000000000001,66.5
6578,1080,-330,4,5,9,44.44,0.012833333333333329,57.22222222222222
6588,3990,-38090,3,8,11,27.27,-0.04177272727272727,27.454545454545453
6589,2689,-17789,4,5,9,44.44,-0.006711111111111109,43.0
6590,1234,11116,3,2,5,60.0,0.053559999999999997,43.0
6593,1142,-3992,3,4,7,42.86,-0.0075857142857142885,81.71428571428571
6594,1845,-23095,3,9,12,25.0,-0.06548333333333334,31.916666666666668
6596,2932,-1152,6,4,10,60.0,0.00515,47.7
6603,3331,-5801,20,23,43,46.51,-0.009795348837209306,31.27906976744186
6609,5614,-14314,19,20,39,48.72,-0.005915384615384618,48.12820512820513
6612,1849,23551,4,1,5,80.0,0.07734,54.4
6613,5380,40620,5,1,6,83.33,0.05463333333333333,102.33333333333333
6615,6918,-768,10,7,17,58.82,0.011511764705882357,29.352941176470587
6616,1088,-13088,3,7,10,30.0,-0.062370000000000016,35.0
6624,1522,-15022,2,5,7,28.57,-0.041628571428571425,40.57142857142857
6629,1539,-4439,2,3,5,40.0,-0.01232,43.2
6640,1533,6467,3,1,4,75.0,0.0177,17.25
6642,527,-10827,0,2,2,0.0,-0.0953,33.0
6643,9595,-66095,3,3,6,50.0,-0.033583333333333326,19.666666666666668
6649,874,-6674,3,3,6,50.0,-0.03168333333333334,49.666666666666664
6651,487,-13487,0,1,1,0.0,-0.145,49.0
6654,2787,-9637,4,5,9,44.44,-0.0075666666666666625,30.0
6661,263,-6013,0,2,2,0.0,-0.12210000000000001,100.5
6662,946,-9196,2,3,5,40.0,-0.04478000000000001,158.0
6664,1376,724,3,1,4,75.0,0.010950000000000001,65.25
6667,749,5501,2,1,3,66.67,0.037733333333333334,25.333333333333332
6679,7721,-54721,2,3,5,40.0,-0.05389999999999999,10.4
6680,1618,3882,3,2,5,60.0,0.016980000000000002,102.6
6683,9178,36822,4,3,7,57.14,0.028928571428571432,10.714285714285714
6690,3979,-41479,1,5,6,16.67,-0.05118333333333334,32.666666666666664
6697,447,1403,2,0,2,100.0,0.0188,206.5
6703,1093,1907,1,1,2,50.0,0.021650000000000003,158.0
6712,8885,55115,6,1,7,85.71,0.048485714285714285,19.571428571428573
6716,0,0,0,0,0,0.0,,
6727,417,5683,1,0,1,100.0,0.0853,13.0
6728,0,0,0,0,0,0.0,,
6732,25657,-34157,4,5,9,44.44,-0.012588888888888882,20.11111111111111
6733,435,3515,2,1,3,66.67,0.05046666666666667,53.333333333333336
6747,2773,-20773,1,1,2,50.0,-0.0359,15.0
6751,1818,-16068,2,4,6,33.33,-0.05303333333333333,45.0
6752,1012,4288,2,1,3,66.67,0.02713333333333334,52.0
6762,1525,-15025,0,1,1,0.0,-0.0554,253.0
6767,186,2114,1,0,1,100.0,0.0705,29.0
6803,7358,31642,5,2,7,71.43,0.030928571428571434,255.28571428571428
7402,5628,832,9,11,20,45.0,0.004245000000000004,33.35
7556,1287,14713,2,0,2,100.0,0.0716,15.5
8024,4551,-1921,21,17,38,55.26,-0.0018947368421052648,29.42105263157895
8027,3204,15946,9,6,15,60.0,0.0243,29.533333333333335
8032,4890,-3330,18,19,37,48.65,-0.009559459459459463,57.24324324324324
8034,3406,1454,30,19,49,61.22,0.010844897959183673,21.081632653061224
8038,6083,-26233,11,14,25,44.0,-0.022004000000000003,23.84
8040,5270,-5670,26,18,44,59.09,0.0020681818181818145,18.295454545454547
8042,7628,-45128,18,24,42,42.86,-0.02663571428571429,37.476190476190474
8043,5980,-28740,19,26,45,42.22,-0.028491111111111113,29.4
8044,26236,-185786,18,22,40,45.0,-0.0158225,19.45
8047,3024,-10244,21,16,37,56.76,-0.013075675675675679,52.32432432432432
8048,4187,7313,18,11,29,62.07,0.018655172413793105,34.96551724137931
8049,4045,-2635,28,25,53,52.83,-0.00017735849056603784,21.132075471698112
8050,10727,-47377,17,19,36,47.22,-0.01955833333333333,40.69444444444444
8054,10696,-86446,19,23,42,45.24,-0.029545238095238097,35.166666666666664
8059,2993,-343,22,20,42,52.38,0.009295238095238098,21.547619047619047
8064,5756,-24736,23,25,48,47.92,-0.013741666666666668,21.854166666666668
8066,10991,-25761,24,30,54,44.44,-0.04087962962962962,21.574074074074073
8067,4004,-10324,26,33,59,44.07,-0.009711864406779661,28.64406779661017
8068,10752,-32882,32,38,70,45.71,-0.006625714285714287,11.357142857142858
8069,7863,-16873,26,26,52,50.0,-0.010675,10.903846153846153
8071,5295,-18105,25,32,57,43.86,-0.021877192982456148,26.087719298245613
8074,4280,-9800,21,21,42,50.0,-0.006023809523809524,44.523809523809526
8076,30434,-102134,21,27,48,43.75,-0.012229166666666666,22.083333333333332
8077,5536,-31256,26,39,65,40.0,-0.020209230769230768,18.984615384615385
8080,4286,-5186,28,23,51,54.9,0.007607843137254904,20.745098039215687
8083,8411,-24811,7,11,18,38.89,-0.006411111111111114,107.44444444444444
8084,5732,-25062,19,26,45,42.22,-0.008697777777777776,35.86666666666667
8085,3440,-9850,20,27,47,42.55,-0.024882978723404257,21.46808510638298
8086,8752,-75102,12,19,31,38.71,-0.03309677419354839,17.967741935483872
8087,3534,-1354,26,24,50,52.0,0.002961999999999999,28.08
8088,5767,-28667,23,32,55,41.82,-0.02223818181818182,15.054545454545455
8089,1013,-8763,2,9,11,18.18,-0.07777272727272726,34.72727272727273
8091,8055,-46805,13,18,31,41.94,-0.031538709677419355,27.806451612903224
8092,4045,-7675,21,27,48,43.75,-0.003908333333333336,39.958333333333336
8093,3741,-9851,26,25,51,50.98,-0.007472549019607841,26.607843137254903
8096,4810,-13280,22,22,44,50.0,-0.009984090909090908,23.545454545454547
8097,4249,3241,29,30,59,49.15,0.0009288135593220347,19.135593220338983
8099,3843,-2593,17,15,32,53.12,0.0007343749999999972,42.875
8107,4669,-25829,17,25,42,40.48,-0.024471428571428568,19.404761904761905
8109,7285,-18485,14,13,27,51.85,-0.003374074074074075,54.55555555555556
8111,4976,-27416,27,28,55,49.09,-0.01855454545454545,20.454545454545453
8121,9119,-8829,30,27,57,52.63,-0.007084210526315791,14.596491228070175
8147,3303,-6003,9,9,18,50.0,-0.003927777777777782,26.72222222222222
8155,7174,-26224,9,13,22,40.91,-0.035490909090909094,20.954545454545453
8171,2509,8451,16,12,28,57.14,0.014053571428571431,23.0
8176,1367,-3157,11,9,20,55.0,-0.019689999999999996,20.95
8182,3393,-11893,12,16,28,42.86,-0.026050000000000007,35.82142857142857
8183,2888,-10448,20,23,43,46.51,-0.015474418604651163,26.25581395348837
8234,5845,-3745,16,19,35,45.71,-0.00972571428571428,36.77142857142857
8240,12097,-48447,23,24,47,48.94,-0.012489361702127659,23.74468085106383
8255,24962,-44762,21,19,40,52.5,-0.012304999999999998,34.1
8277,6382,-23362,25,39,64,39.06,-0.0393921875,11.796875
8279,7481,12119,8,5,13,61.54,0.018807692307692307,28.615384615384617
8284,2725,43115,5,5,10,50.0,0.14987,257.1
8289,1807,-3917,13,10,23,56.52,-0.003960869565217385,55.608695652173914
8291,1659,4771,20,10,30,66.67,0.034179999999999995,24.466666666666665
8299,52903,-129803,25,23,48,52.08,-0.010029166666666667,14.9375
8342,1625,-5575,3,3,6,50.0,-0.01826666666666667,146.83333333333334
8349,7037,-61487,11,16,27,40.74,-0.031818518518518524,57.666666666666664
8354,2682,-6562,14,16,30,46.67,-0.017153333333333336,84.7
8358,3271,-41441,10,15,25,40.0,-0.042056,42.84
8383,7055,-6355,20,19,39,51.28,-0.004735897435897435,39.92307692307692
8390,4877,6423,19,13,32,59.38,0.006606249999999998,42.40625
8401,2456,-21926,11,14,25,44.0,-0.029348,54.12
8403,3975,-17975,11,10,21,52.38,-0.01634285714285714,71.47619047619048
8409,3883,1867,12,12,24,50.0,0.017062499999999998,45.875
8410,4935,-19035,10,15,25,40.0,-0.024031999999999994,28.0
8415,845,2105,3,2,5,60.0,0.028199999999999996,104.6
8416,9587,8213,8,6,14,57.14,0.0031142857142857144,48.5
8418,2528,-11288,9,15,24,37.5,-0.0230125,68.83333333333333
8420,846,-2796,3,4,7,42.86,-0.002700000000000004,37.142857142857146
8421,1796,-2156,11,10,21,52.38,-0.0018428571428571441,55.23809523809524
8423,2974,-6424,11,12,23,47.83,-0.005165217391304345,64.6086956521739
8424,1759,-5359,3,4,7,42.86,-0.009342857142857144,130.0
8426,4912,-40262,10,18,28,35.71,-0.035342857142857134,42.535714285714285
8431,4521,-6771,8,8,16,50.0,-0.0009374999999999974,11.5
8432,8870,-41720,9,15,24,37.5,-0.02351666666666667,49.0
8433,6800,-73200,6,10,16,37.5,-0.051868750000000005,40.0625
8435,1728,13022,4,2,6,66.67,0.046533333333333336,273.1666666666667
8436,22485,-47685,9,11,20,45.0,-0.010004999999999997,22.1
8437,11297,-58797,5,7,12,41.67,-0.0231,43.666666666666664
8440,1444,-17084,5,9,14,35.71,-0.048335714285714294,53.214285714285715
8444,9144,-118344,5,13,18,27.78,-0.07610555555555554,35.5
8446,9739,-122939,5,13,18,27.78,-0.0630111111111111,33.388888888888886
8450,7135,965,10,13,23,43.48,-0.011373913043478259,34.30434782608695
8455,2171,-5821,7,8,15,46.67,0.0008533333333333356,45.46666666666667
8472,3688,-41938,5,13,18,27.78,-0.04723333333333333,44.166666666666664
8476,2236,-8386,9,7,16,56.25,-0.0009312500000000007,26.75
8477,3348,-28148,4,11,15,26.67,-0.04106666666666667,37.06666666666667
8489,13654,-39444,10,14,24,41.67,0.005316666666666661,14.708333333333334
8905,2327,-1727,11,13,24,45.83,-0.0009958333333333323,69.20833333333333
8906,2371,3789,21,17,38,55.26,0.011071052631578947,47.28947368421053
8908,2608,5692,10,7,17,58.82,0.01985882352941176,83.3529411764706
8916,5142,-6352,18,19,37,48.65,-0.006986486486486485,60.648648648648646
8917,3271,23329,12,3,15,80.0,0.04378666666666667,194.26666666666668
8921,1645,6085,10,10,20,50.0,0.025984999999999998,87.65
8923,1689,3741,10,9,19,52.63,0.00785789473684211,185.42105263157896
8924,8134,-45734,16,23,39,41.03,-0.022987179487179484,57.05128205128205
8927,2760,13440,20,13,33,60.61,0.03416060606060606,68.0909090909091
8928,4634,-25144,18,28,46,39.13,-0.032132608695652175,30.41304347826087
8929,5140,-15990,22,21,43,51.16,-0.00916279069767442,30.372093023255815
8930,2479,-13299,15,19,34,44.12,-0.02798529411764706,42.55882352941177
8931,3010,19390,20,9,29,68.97,0.041600000000000005,71.96551724137932
8932,2631,1319,21,17,38,55.26,0.009642105263157893,37.473684210526315
8933,3787,-21167,20,29,49,40.82,-0.027632653061224487,36.42857142857143
8935,3525,-9685,24,32,56,42.86,-0.02331964285714286,26.964285714285715
8936,6237,-39657,19,31,50,38.0,-0.04339799999999999,27.32
8937,4664,1766,26,21,47,55.32,0.013002127659574465,36.148936170212764
8938,8117,-66917,12,22,34,35.29,-0.03541176470588235,44.588235294117645
8941,18355,-87935,26,44,71,36.62,-0.02870281690140845,26.87323943661972
8942,9763,-46313,17,19,36,47.22,-0.02121111111111111,44.583333333333336
9949,5428,-2228,22,19,41,53.66,0.0033365853658536607,49.146341463414636
9950,2630,-8000,15,13,28,53.57,-0.011928571428571429,67.60714285714286
9951,12754,-146444,9,28,37,24.32,-0.06354864864864865,36.91891891891892
9960,4732,-1612,17,21,38,44.74,0.004021052631578951,55.36842105263158
9962,3142,-17782,14,22,36,38.89,-0.03371666666666666,40.388888888888886
8916A,583,-4433,0,2,2,0.0,-0.04215,326.0
4148,3776,-30326,6,7,13,46.15,-0.046200000000000005,28.307692307692307
6781,11061,-117061,1,1,2,50.0,-0.048350000000000004,11.0
6776,0,0,0,0,0,0.0,,
2211,300,4050,1,0,1,100.0,0.0845,30.0
6768,0,0,0,0,0,0.0,,
3357,3420,141500,4,6,10,40.0,0.5719199999999999,264.4
6741,5693,-27693,3,3,6,50.0,-0.026666666666666672,6.833333333333333
2250,1078,5922,1,1,2,50.0,0.04645,17.0
5236,1328,-14828,0,2,2,0.0,-0.06085,8.5
1522A,261,339,1,0,1,100.0,0.0077,100.0
6684,1772,-29272,0,3,3,0.0,-0.08339999999999999,18.333333333333332
2753,788,12712,1,0,1,100.0,0.1021,41.0
2348A,220,-170,0,1,1,0.0,-0.0045,39.0
6790,255,-5505,0,1,1,0.0,-0.1159,65.0
6788,2981,-31981,1,3,4,25.0,-0.04127499999999999,11.25
2947,651,-1651,0,1,1,0.0,-0.0147,0.0
4440,240,-4590,0,1,1,0.0,-0.1034,36.0
5222,2513,-6053,4,5,9,44.44,-0.01858888888888889,17.444444444444443
2881C,348,-948,0,1,1,0.0,-0.0158,42.0
6761,652,7848,1,0,1,100.0,0.0747,45.0
6806,539,-339,0,1,1,0.0,-0.0037,32.0
2945,610,-810,1,1,2,50.0,-0.0017500000000000016,9.5
6770,0,0,0,0,0,0.0,,
6792,554,-5954,0,1,1,0.0,-0.0602,2.0
4770,0,0,0,0,0,0.0,,
2883B,0,0,0,0,0,0.0,,
6691,0,0,0,0,0,0.0,,
3592,17276,-70146,11,17,28,39.29,-0.03249285714285714,23.5
6719,0,0,0,0,0,0.0,,
2756,0,0,0,0,0,0.0,,
5244,1091,-3941,6,8,14,42.86,-0.01722142857142857,64.28571428571429
6693,0,0,0,0,0,0.0,,
8112A,0,0,0,0,0,0.0,,
8438,1522,9118,4,5,9,44.44,0.0585888888888889,326.8888888888889
6829,0,0,0,0,0,0.0,,
4923,1307,-30377,1,11,12,8.33,-0.11555,116.75
6763,0,0,0,0,0,0.0,,
4558,385,24405,1,2,3,33.33,0.49953333333333333,662.0
3349,1828,-8398,7,12,19,36.84,-0.024873684210526315,180.73684210526315
6804,0,0,0,0,0,0.0,,
4768,0,0,0,0,0,0.0,,
6807,0,0,0,0,0,0.0,,
6721,0,0,0,0,0,0.0,,
6735,0,0,0,0,0,0.0,,
4583,0,0,0,0,0,0.0,,
6799,0,0,0,0,0,0.0,,
6585,353,7997,1,0,1,100.0,0.148,1862.0
5228,795,-4455,2,4,6,33.33,-0.026816666666666666,51.166666666666664
6546,386,-3686,1,3,4,25.0,-0.050775,35.0
6796,0,0,0,0,0,0.0,,
6550,2082,55448,4,4,8,50.0,0.29603750000000006,243.875
4577,0,0,0,0,0,0.0,,
