代號,總成本,總損益(淨),獲利次數,損失次數,總交易次數,勝率%,平均報酬,平均持倉時間(日)
1101,4385,17415,16,8,24,66.67,0.02794166666666667,46.375
1102,4287,34563,17,6,23,73.91,0.05294782608695652,75.17391304347827
1103,2399,5921,17,10,27,62.96,0.019311111111111116,48.666666666666664
1104,2346,3304,15,9,24,62.5,0.01580416666666667,81.58333333333333
1108,1232,4838,13,6,19,68.42,0.03773684210526316,88.57894736842105
1109,1015,3435,8,5,13,61.54,0.010084615384615385,54.07692307692308
1110,1117,4583,10,5,15,66.67,0.02955333333333333,31.933333333333334
1201,3181,8589,15,8,23,65.22,0.026517391304347823,53.30434782608695
1203,0,0,0,0,0,0.0,,
1210,3250,7050,13,8,21,61.9,0.019419047619047617,52.523809523809526
1213,2346,-4876,12,12,24,50.0,-0.008037500000000005,63.916666666666664
1215,3199,-12459,13,11,24,54.17,-0.0063208333333333285,48.125
1216,3899,37501,12,3,15,80.0,0.06242,98.0
1217,1772,1648,16,11,27,59.26,0.01118888888888889,48.851851851851855
1218,2056,20314,19,6,25,76.0,0.048796000000000006,53.32
1219,958,7392,9,3,12,75.0,0.04533333333333334,41.583333333333336
1220,953,-3,7,7,14,50.0,-0.006814285714285711,111.71428571428571
1225,3064,12146,15,8,23,65.22,0.02876086956521739,48.47826086956522
1227,5671,-10221,11,8,19,57.89,0.012005263157894736,128.6315789473684
1229,2444,5306,11,10,21,52.38,-0.005823809523809525,91.33333333333333
1231,2669,-5799,11,8,19,57.89,0.013105263157894734,45.31578947368421
1232,3482,9968,7,5,12,58.33,0.008333333333333333,124.16666666666667
1233,2004,-7904,4,5,9,44.44,-0.013944444444444445,317.0
1234,2703,-10193,9,12,21,42.86,-0.0312047619047619,100.76190476190476
1235,1979,13771,8,4,12,66.67,0.031366666666666675,52.25
1236,1375,3175,8,6,14,57.14,0.015492857142857138,126.0
1256,18195,-125695,7,7,14,50.0,-0.00359285714285714,36.5
1301,7169,25281,11,6,17,64.71,0.02254705882352941,63.411764705882355
1303,6988,18912,13,7,20,65.0,0.018025,74.75
1304,2896,-276,18,11,29,62.07,0.012358620689655174,41.172413793103445
1305,2354,-8664,13,13,26,50.0,-0.02155769230769231,23.5
1307,3822,2228,16,11,27,59.26,0.009922222222222221,72.07407407407408
1308,3548,7802,17,12,29,58.62,0.010472413793103447,55.93103448275862
1309,2244,-3044,14,15,29,48.28,-0.01077241379310345,35.827586206896555
1310,3195,8935,20,11,31,64.52,0.02294193548387097,32.193548387096776
1312,2370,-1830,15,13,28,53.57,0.006903571428571427,20.178571428571427
1313,2688,-4438,17,15,32,53.12,0.00037812499999999825,50.375
1314,3040,-10260,18,18,36,50.0,-0.01938888888888889,36.388888888888886
1315,1967,19483,6,6,12,50.0,0.011050000000000004,50.666666666666664
1316,1193,-6123,10,7,17,58.82,0.007717647058823527,36.76470588235294
1319,6865,-3815,17,16,33,51.52,-0.0020575757575757546,33.696969696969695
1321,4476,10624,18,13,31,58.06,0.013348387096774193,61.45161290322581
1323,3285,8045,14,8,22,63.64,0.025218181818181817,68.95454545454545
1324,2258,-8358,12,15,27,44.44,-0.009037037037037033,58.333333333333336
1325,4055,-10445,12,12,24,50.0,-0.0093875,57.625
1326,6283,46567,12,5,17,70.59,0.03566470588235294,55.94117647058823
1337,3611,-22611,6,17,23,26.09,-0.06137391304347825,49.08695652173913
1338,5330,-41030,6,6,12,50.0,-0.02449166666666666,55.5
1339,2016,-19616,3,5,8,37.5,-0.0418875,56.375
1340,4654,-47554,6,11,17,35.29,-0.03921176470588235,58.05882352941177
1341,0,0,0,0,0,0.0,,
1342,318,4682,1,0,1,100.0,0.0923,35.0
1402,3625,2175,14,9,23,60.87,0.010504347826086958,63.869565217391305
1409,1339,6841,15,5,20,75.0,0.041354999999999996,55.45
1410,1526,6854,11,5,16,68.75,0.03509375,102.9375
1413,1754,26,14,18,32,43.75,-0.005034375000000004,34.84375
1414,1720,2850,18,11,29,62.07,0.02451379310344827,38.310344827586206
1416,2343,-7873,15,16,31,48.39,-0.006506451612903225,39.096774193548384
1417,1875,2675,18,12,30,60.0,0.015283333333333331,54.766666666666666
1418,1096,-1736,10,10,20,50.0,-0.01884,35.8
1419,2843,557,9,10,19,47.37,-0.013978947368421056,28.789473684210527
1423,1334,2026,12,10,22,54.55,0.0062090909090909115,56.27272727272727
1432,1486,-2316,8,9,17,47.06,-0.0005882352941176475,28.941176470588236
1434,2474,-4824,9,8,17,52.94,0.00043529411764705824,99.47058823529412
1435,1379,8471,13,9,22,59.09,0.04019090909090909,32.22727272727273
1436,1617,8873,12,1,13,92.31,0.0741076923076923,128.92307692307693
1437,2965,-6445,13,17,30,43.33,-0.014510000000000004,38.766666666666666
1438,529,-3349,4,6,10,40.0,-0.03529,20.3
1439,2727,-2737,13,11,24,54.17,0.005670833333333333,38.125
1440,1846,-7166,13,11,24,54.17,-0.009379166666666668,61.666666666666664
1441,1525,2805,14,11,25,56.0,0.054368,41.32
1442,2165,-11845,9,11,20,45.0,-0.020009999999999997,65.1
1443,1280,-1090,12,12,24,50.0,-0.008266666666666663,30.875
1444,2169,1321,17,16,33,51.52,-0.007742424242424241,36.03030303030303
1445,1163,-1763,10,9,19,52.63,-0.00813157894736842,65.0
1446,2979,7631,15,12,27,55.56,0.03156296296296296,36.96296296296296
1447,1978,-4068,17,14,31,54.84,-0.0015516129032258075,43.03225806451613
1449,1298,-2338,11,12,23,47.83,-0.013756521739130428,22.391304347826086
1451,2553,-15383,8,13,21,38.1,-0.03021428571428571,63.904761904761905
1452,2215,-7015,13,15,28,46.43,-0.019667857142857147,48.142857142857146
1453,721,4529,10,2,12,83.33,0.07194166666666665,40.166666666666664
1454,1216,4964,15,5,20,75.0,0.04084,54.7
1455,2070,-9320,14,18,32,43.75,-0.021815624999999998,50.53125
1456,1008,-5898,4,14,18,22.22,-0.05747777777777779,24.38888888888889
1457,1710,3540,17,10,27,62.96,0.007929629629629628,48.370370370370374
1459,1698,5232,16,9,25,64.0,0.018444000000000002,44.76
1460,1699,-7639,11,15,26,42.31,-0.030834615384615384,50.03846153846154
1463,1754,-5884,12,13,25,48.0,-0.026951999999999997,31.2
1464,2366,174,17,9,26,65.38,0.015923076923076922,48.30769230769231
1465,1359,13251,13,4,17,76.47,0.059576470588235286,97.05882352941177
1466,2331,-6551,12,15,27,44.44,-0.020477777777777775,37.888888888888886
1467,1836,8154,16,9,25,64.0,0.033964,43.36
1468,1050,2130,8,6,14,57.14,0.013385714285714289,80.35714285714286
1470,229,-389,2,2,4,50.0,-0.002525000000000003,33.0
1471,3463,-4283,19,18,37,51.35,-0.007702702702702704,25.945945945945947
1472,2345,-9715,8,17,25,32.0,-0.029348,24.88
1473,4959,-4559,14,14,28,50.0,-0.006721428571428571,96.96428571428571
1474,1622,-5972,11,13,24,45.83,-0.022362500000000004,75.375
1475,1329,2991,8,8,16,50.0,0.004981249999999999,13.375
1476,13886,75934,8,6,14,57.14,0.011478571428571432,27.142857142857142
1477,15038,-13788,12,10,22,54.55,-0.0001318181818181812,53.40909090909091
1503,2524,1376,8,6,14,57.14,1.4285714285716677e-05,112.0
1504,2404,1686,13,9,22,59.09,0.011636363636363637,54.86363636363637
1506,2573,-21023,10,16,26,38.46,-0.033830769230769234,34.42307692307692
1512,1919,7181,19,12,31,61.29,0.03395806451612904,37.096774193548384
1513,2870,27080,19,5,24,79.17,0.0472875,74.45833333333333
1514,2087,9133,20,10,30,66.67,0.02315,41.53333333333333
1515,4477,-46127,13,15,28,46.43,-0.01126785714285714,37.57142857142857
1516,1213,-6213,8,9,17,47.06,-0.026052941176470584,44.529411764705884
1517,1747,-15467,10,15,25,40.0,-0.03722000000000001,58.4
1519,3695,21305,18,10,28,64.29,0.029160714285714286,43.25
1521,8033,16607,18,12,30,60.0,0.018556666666666662,46.333333333333336
1522,4319,-11119,20,16,36,55.56,-0.007863888888888889,50.638888888888886
1524,1722,2298,13,11,24,54.17,0.011708333333333333,61.125
1525,9518,-35468,14,19,33,42.42,-0.02221818181818182,51.09090909090909
1526,2229,-7129,12,8,20,60.0,0.03579,18.05
1527,8153,-19103,14,17,31,45.16,-0.0184258064516129,37.935483870967744
1528,1693,-10293,8,14,22,36.36,-0.03220909090909091,42.36363636363637
1529,1204,586,12,9,21,57.14,0.006357142857142857,16.80952380952381
1530,5156,-2656,13,10,23,56.52,0.008234782608695652,57.21739130434783
1531,3797,-8427,14,14,28,50.0,-0.0020071428571428558,52.392857142857146
1532,6411,-6111,17,17,34,50.0,-0.0008411764705882364,53.55882352941177
1533,5637,-4867,14,17,31,45.16,0.006174193548387099,24.612903225806452
1535,3520,5130,10,6,16,62.5,0.022068749999999998,57.9375
1536,5509,-22159,9,12,21,42.86,-0.013166666666666665,26.38095238095238
1537,7964,18436,15,11,26,57.69,-0.003376923076923077,65.8076923076923
1538,4863,-39653,15,22,37,40.54,-0.021337837837837832,24.027027027027028
1539,2839,-7429,14,13,27,51.85,-0.0013925925925925915,36.370370370370374
1540,2839,-8939,11,12,23,47.83,0.0038304347826086963,86.04347826086956
1541,3752,9458,12,15,27,44.44,-0.012103703703703709,24.666666666666668
1558,6292,-48892,3,8,11,27.27,-0.05679090909090909,99.0909090909091
1560,9174,-56974,10,15,25,40.0,-0.035284,25.48
1568,2063,-1113,9,7,16,56.25,0.004537500000000001,29.4375
1582,8617,2383,12,9,21,57.14,0.009214285714285715,50.23809523809524
1583,4107,15343,9,5,14,64.29,0.029378571428571428,52.285714285714285
1587,1163,-7373,4,5,9,44.44,-0.039055555555555545,67.66666666666667
1589,6619,-46119,9,6,15,60.0,0.00944,48.93333333333333
1590,17148,-23648,7,6,13,53.85,0.009276923076923075,12.384615384615385
1597,4444,-2494,7,6,13,53.85,-0.016530769230769224,31.153846153846153
1598,3288,-8988,6,6,12,50.0,-0.010750000000000001,38.75
1603,1312,8,10,9,19,52.63,-0.005599999999999998,58.526315789473685
1604,2279,13281,22,8,30,73.33,0.03908666666666667,45.96666666666667
1605,1843,-983,13,11,24,54.17,0.004712499999999999,31.958333333333332
1608,1969,-3469,12,17,29,41.38,-0.015344827586206896,51.03448275862069
1609,1998,-2298,17,14,31,54.84,-0.0008451612903225793,48.67741935483871
1611,2374,10756,19,10,29,65.52,0.03981724137931035,48.86206896551724
1612,1563,-6013,10,9,19,52.63,-0.009705263157894741,65.52631578947368
1614,2595,5955,12,5,17,70.59,0.02750588235294117,109.41176470588235
1615,1256,-7856,6,10,16,37.5,-0.03459374999999999,54.8125
1616,1650,2720,16,11,27,59.26,0.01864074074074074,31.85185185185185
1617,1424,616,10,9,19,52.63,-0.00495263157894737,65.57894736842105
1618,2165,8845,18,10,28,64.29,0.028771428571428576,26.714285714285715
1626,3132,-2882,8,7,15,53.33,0.0021333333333333343,31.933333333333334
1701,1957,12823,13,6,19,68.42,0.03235263157894737,66.26315789473684
1702,5129,-18029,14,16,30,46.67,-0.010680000000000002,56.56666666666667
1707,9303,9757,9,8,17,52.94,0.006876470588235291,50.411764705882355
1708,2202,-13332,8,6,14,57.14,-0.003907142857142854,111.21428571428571
1709,1246,-3246,7,8,15,46.67,-0.004693333333333327,132.8
1710,3669,-669,14,11,25,56.0,0.001811999999999999,54.32
1711,2194,12086,15,6,21,71.43,0.048023809523809524,53.57142857142857
1712,1794,4246,14,10,24,58.33,0.0119625,52.041666666666664
1713,1558,12442,14,6,20,70.0,0.04521499999999999,40.85
1714,1942,7348,18,9,27,66.67,0.03624074074074075,50.2962962962963
1717,4003,8847,16,8,24,66.67,0.018587500000000003,58.708333333333336
1718,1963,-5663,14,15,29,48.28,-0.01709655172413793,43.13793103448276
1720,3372,7428,12,9,21,57.14,0.01227142857142857,89.57142857142857
1721,1443,3947,14,7,21,66.67,0.03872857142857143,44.857142857142854
1722,5859,-18159,8,9,17,47.06,-0.016758823529411767,89.29411764705883
1723,12558,16642,13,8,21,61.9,0.013566666666666675,81.95238095238095
1725,1426,3224,8,6,14,57.14,0.021071428571428567,93.35714285714286
1726,4015,7535,8,5,13,61.54,0.014392307692307694,86.07692307692308
1727,1883,-18163,7,11,18,38.89,-0.034688888888888894,115.05555555555556
1730,2715,-7535,10,6,16,62.5,0.001899999999999999,51.0625
1731,1421,3149,10,7,17,58.82,0.023094117647058824,33.8235294117647
1732,1455,2085,11,8,19,57.89,0.01564210526315789,61.94736842105263
1733,7917,-15417,17,15,32,53.12,-0.004709375000000002,65.34375
1734,3117,3583,13,8,21,61.9,0.015214285714285711,86.66666666666667
1735,1810,2800,12,7,19,63.16,0.013957894736842101,45.78947368421053
1736,10405,-52055,13,14,27,48.15,-0.017029629629629627,35.03703703703704
1737,3199,17201,15,7,22,68.18,0.03392272727272727,69.63636363636364
1760,0,0,0,0,0,0.0,,
1762,3487,-27387,6,8,14,42.86,-0.035492857142857145,54.357142857142854
1773,2675,18825,5,2,7,71.43,0.0453,84.14285714285714
1776,413,-2913,2,2,4,50.0,-0.035875,188.5
1783,1887,13313,8,3,11,72.73,0.05886363636363636,29.454545454545453
1786,6143,38557,13,5,18,72.22,0.04368333333333333,20.38888888888889
1789,2712,-23012,5,7,12,41.67,-0.029975,93.33333333333333
1795,7031,23119,12,6,18,66.67,0.03890555555555556,32.888888888888886
1802,3147,-20927,8,17,25,32.0,-0.043596,55.44
1805,1660,-2200,13,13,26,50.0,-0.016603846153846146,20.576923076923077
1806,2057,-8297,14,15,29,48.28,-0.013224137931034479,45.58620689655172
1808,0,0,0,0,0,0.0,,
1809,2164,636,16,12,28,57.14,0.01168214285714286,41.964285714285715
1810,1648,1872,15,10,25,60.0,0.015983999999999998,39.76
1817,1009,-2209,2,3,5,40.0,-0.012139999999999998,241.6
1903,6376,-976,16,12,28,57.14,0.00337857142857143,49.285714285714285
1904,1848,3862,12,9,21,57.14,0.009471428571428572,67.80952380952381
1905,1969,-2729,15,11,26,57.69,-0.003138461538461536,70.61538461538461
1906,1946,2224,13,13,26,50.0,-0.0016499999999999987,31.346153846153847
1907,1550,-5050,9,12,21,42.86,-0.02041904761904763,60.857142857142854
1909,3028,2582,18,18,36,50.0,-0.0056361111111111134,42.111111111111114
2002,2964,-23314,7,12,19,36.84,-0.03636315789473684,115.78947368421052
2006,3485,1215,13,10,23,56.52,0.009330434782608695,83.1304347826087
2007,2020,-4620,17,18,35,48.57,-0.01726857142857143,33.42857142857143
2008,1187,-3807,9,9,18,50.0,-0.02115,34.0
2009,2039,-4949,14,13,27,51.85,-0.0013962962962962965,48.48148148148148
2010,1259,-1699,8,7,15,53.33,-0.0006666666666666663,122.0
2012,1441,-1531,9,7,16,56.25,0.018749999999999992,64.875
2013,2808,26542,17,4,21,80.95,0.06733333333333334,85.57142857142857
2014,2044,-6404,13,13,26,50.0,-0.005776923076923078,46.0
2015,4575,30325,12,5,17,70.59,0.043929411764705883,60.88235294117647
2017,1624,4806,16,9,25,64.0,0.026712000000000003,55.44
2020,2458,42,13,8,21,61.9,0.01724761904761905,92.42857142857143
2022,1970,-3830,18,15,33,54.55,-0.004087878787878791,46.63636363636363
2023,1826,-2526,13,10,23,56.52,-0.0051956521739130465,72.6086956521739
2024,1464,1116,12,12,24,50.0,0.0040666666666666655,35.5
2025,1530,-1860,12,16,28,42.86,-0.03198928571428571,21.142857142857142
2027,3974,-9224,15,15,30,50.0,0.0027766666666666686,35.666666666666664
2028,2222,-1072,15,16,31,48.39,-0.0027774193548387115,35.25806451612903
2029,4070,-10420,12,15,27,44.44,-0.014366666666666665,72.4074074074074
2030,2487,-4727,12,13,25,48.0,-0.011216000000000002,37.68
2031,4189,-6639,15,13,28,53.57,-0.007246428571428571,38.464285714285715
2032,2678,-15288,12,16,28,42.86,-0.02568214285714285,43.107142857142854
2033,1640,20590,14,5,19,73.68,0.09173684210526316,63.21052631578947
2034,3575,11575,16,9,25,64.0,0.023952,40.68
2038,1661,-5121,8,9,17,47.06,-0.01122941176470588,57.8235294117647
2049,27248,-79748,9,12,21,42.86,-0.0093047619047619,18.857142857142858
2059,27986,89014,13,7,20,65.0,0.031795,36.55
2062,4604,-41154,9,12,21,42.86,-0.03452380952380952,73.04761904761905
2069,841,-8191,2,5,7,28.57,-0.049314285714285706,86.14285714285714
2101,4222,15328,13,8,21,61.9,0.02395714285714285,60.857142857142854
2102,2890,-8250,13,16,29,44.83,-0.006934482758620685,49.03448275862069
2103,5203,-5103,13,13,26,50.0,0.00605,58.96153846153846
2104,4367,-317,15,13,28,53.57,0.0009535714285714281,52.0
2105,7222,-472,13,11,24,54.17,-0.0002375000000000016,61.833333333333336
2106,3841,-16691,10,12,22,45.45,-0.008422727272727273,64.0909090909091
2107,2201,-8501,10,10,20,50.0,-0.011224999999999999,74.4
2108,3588,-31088,11,12,23,47.83,-0.014734782608695653,53.608695652173914
2109,2488,6422,20,14,34,58.82,0.025032352941176474,32.6764705882353
2114,5563,-2263,7,6,13,53.85,0.00524615384615385,108.76923076923077
2115,2822,-22372,4,7,11,36.36,-0.03548181818181818,63.36363636363637
2201,5230,-15630,12,15,27,44.44,-0.015662962962962962,55.925925925925924
2204,5556,6064,15,17,32,46.88,0.012465625,39.0625
2206,2159,11911,12,6,18,66.67,0.044172222222222224,49.666666666666664
2207,22531,29569,12,6,18,66.67,0.021722222222222226,49.94444444444444
2208,2119,-13719,7,11,18,38.89,-0.03102222222222223,74.22222222222223
2227,24749,54051,11,13,24,45.83,-0.008679166666666663,85.25
2228,7918,-51218,5,8,13,38.46,-0.02166153846153846,57.84615384615385
2231,21677,-133427,8,12,20,40.0,-0.017554999999999998,27.55
2233,4437,-27287,5,5,10,50.0,-0.026039999999999997,49.0
2236,1577,-9927,2,6,8,25.0,-0.051025,44.0
2239,5693,-21693,4,5,9,44.44,-0.03002222222222222,39.0
2241,1438,-32968,1,4,5,20.0,-0.09962000000000001,51.6
2243,663,-3213,2,3,5,40.0,-0.018920000000000003,22.0
2247,2525,-38525,0,2,2,0.0,-0.083,207.5
2301,4519,2031,11,9,20,55.0,0.006539999999999997,48.45
2302,1688,662,19,11,30,63.33,0.01771666666666667,33.86666666666667
2303,1046,-5796,4,8,12,33.33,-0.03831666666666667,47.166666666666664
2305,1542,4458,14,13,27,51.85,0.021344444444444447,26.48148148148148
2308,8673,-5973,8,5,13,61.54,0.00863076923076923,46.15384615384615
2312,1735,-2175,13,12,25,52.0,-0.00408,65.0
2313,2591,11479,17,9,26,65.38,0.03303076923076924,25.96153846153846
2314,2553,-3933,14,13,27,51.85,-0.012051851851851854,18.88888888888889
2316,2807,17013,17,10,27,62.96,0.02930740740740741,37.851851851851855
2317,11913,33587,13,6,19,68.42,0.02893684210526316,60.526315789473685
2321,2009,-1639,15,15,30,50.0,-0.0053100000000000005,23.333333333333332
2323,1988,6642,20,11,31,64.52,0.026377419354838706,36.74193548387097
2324,2661,5539,12,7,19,63.16,0.01716842105263158,52.31578947368421
2327,12845,67855,16,10,26,61.54,0.022838461538461537,28.653846153846153
2328,5942,1958,21,15,36,58.33,0.008241666666666668,32.166666666666664
2329,1661,-4241,13,11,24,54.17,0.0010416666666666675,26.416666666666668
2330,7796,-17696,6,1,7,85.71,0.06305714285714285,31.285714285714285
2331,4705,8765,23,15,38,60.53,0.0070921052631579,23.236842105263158
2332,4600,5510,20,14,34,58.82,0.015238235294117648,35.23529411764706
2337,1988,-18998,7,18,25,28.0,-0.057631999999999996,23.08
2338,2173,10737,15,7,22,68.18,0.027809090909090905,59.27272727272727
2340,3162,11138,23,11,34,67.65,0.021547058823529416,23.61764705882353
2342,2638,4992,20,14,34,58.82,0.013247058823529414,15.882352941176471
2344,1868,-3798,12,14,26,46.15,-0.021288461538461537,17.5
2345,6658,11452,17,10,27,62.96,0.03435185185185185,37.925925925925924
2347,5901,2099,13,10,23,56.52,0.00987391304347826,67.0
2348,2652,16098,12,6,18,66.67,0.03832222222222223,16.77777777777778
2349,2147,-1697,20,15,35,57.14,0.0059285714285714315,33.457142857142856
2351,6061,15139,16,13,29,55.17,0.010555172413793102,24.620689655172413
2352,3468,5982,18,11,29,62.07,0.012251724137931037,28.0
2353,6534,-60834,13,22,35,37.14,-0.021522857142857142,33.25714285714286
2354,14554,46046,16,11,27,59.26,0.009025925925925927,43.2962962962963
2355,4812,-19212,11,14,25,44.0,-0.024628000000000004,39.76
2356,2487,2563,13,10,23,56.52,0.008113043478260867,69.69565217391305
2357,16547,-54097,7,9,16,43.75,-0.019025,51.0
2358,2824,-5324,16,20,36,44.44,-0.014738888888888892,22.52777777777778
2359,2521,6559,21,10,31,67.74,0.022361290322580635,27.322580645161292
2360,6962,31988,12,7,19,63.16,0.016626315789473677,30.0
2362,4560,-10510,14,9,23,60.87,0.0011434782608695682,40.56521739130435
2363,3033,3397,24,14,38,63.16,0.017892105263157886,28.657894736842106
2364,1530,5530,20,9,29,68.97,0.03885517241379311,15.586206896551724
2365,4154,-20164,16,16,32,50.0,-0.010253124999999998,46.625
2367,2684,11786,19,10,29,65.52,0.03453448275862069,25.93103448275862
2368,2282,1858,15,11,26,57.69,-0.0009923076923076947,17.5
2369,2746,-886,20,15,35,57.14,0.005114285714285714,33.65714285714286
2371,1882,2678,15,11,26,57.69,0.007734615384615385,26.26923076923077
2373,4813,36787,10,7,17,58.82,0.04391764705882353,116.3529411764706
2374,4126,-28426,12,17,29,41.38,-0.028524137931034484,41.44827586206897
2375,3137,-32617,15,17,32,46.88,-0.022759375,22.40625
2376,5739,-13539,12,13,25,48.0,-0.00958,38.28
2377,6440,26160,20,10,30,66.67,0.02544666666666667,36.6
2379,16876,-70526,16,10,26,61.54,0.019365384615384614,23.884615384615383
2380,2647,-9057,12,18,30,40.0,-0.020466666666666668,33.96666666666667
2382,9064,16286,16,10,26,61.54,0.01878846153846154,46.61538461538461
2383,3472,31978,10,5,15,66.67,0.03724,39.6
2385,8696,-6546,13,14,27,48.15,-0.0007518518518518526,37.370370370370374
2387,4408,-7508,17,15,32,53.12,-0.003181249999999999,40.71875
2388,5262,-3762,19,14,33,57.58,0.01033030303030303,20.09090909090909
2390,2496,3714,17,15,32,53.12,0.015078124999999998,26.5
2392,9254,-11154,16,13,29,55.17,0.0007413793103448273,45.206896551724135
2393,8694,7606,16,12,28,57.14,0.013710714285714288,22.357142857142858
2395,9632,12618,7,5,12,58.33,0.023375000000000003,41.25
2397,4875,-8225,12,9,21,57.14,0.004538095238095239,48.38095238095238
2399,2858,-5978,15,16,31,48.39,-0.003412903225806452,24.129032258064516
2401,4904,-17924,17,18,35,48.57,-0.006568571428571428,32.714285714285715
2402,3913,117,17,14,31,54.84,0.003170967741935483,17.677419354838708
2404,6427,-11527,12,14,26,46.15,-0.017188461538461538,46.65384615384615
2405,3865,-25145,19,23,42,45.24,-0.023314285714285714,20.5
2406,3772,-2652,23,18,41,56.1,0.005721951219512195,17.463414634146343
2408,5281,-30461,12,19,31,38.71,-0.032964516129032256,19.225806451612904
2409,3868,-20888,11,19,30,36.67,-0.03145,32.233333333333334
2412,3024,53176,6,0,6,100.0,0.12054999999999999,544.6666666666666
2413,3224,-4474,20,18,38,52.63,-0.003963157894736845,27.81578947368421
2414,2279,4671,14,9,23,60.87,0.018873913043478262,80.08695652173913
2415,2557,-12947,11,15,26,42.31,-0.02103076923076924,35.69230769230769
2417,4703,17537,18,11,29,62.07,0.025493103448275864,29.275862068965516
2419,1836,2774,13,9,22,59.09,0.0041545454545454516,26.09090909090909
2420,4362,-10032,13,15,28,46.43,-0.0052107142857142855,55.142857142857146
2421,3611,9089,16,10,26,61.54,0.016203846153846152,35.38461538461539
2423,2401,-9551,9,11,20,45.0,-0.02045,62.75
2424,1773,7197,13,6,19,68.42,0.0334578947368421,20.94736842105263
2425,3393,11677,18,15,33,54.55,0.011796969696969696,18.78787878787879
2426,3262,-18612,17,17,34,50.0,-0.011605882352941174,21.294117647058822
2427,2113,2007,20,10,30,66.67,0.016823333333333336,37.166666666666664
2428,5456,-9106,9,11,20,45.0,-0.017135000000000004,43.95
2429,947,-8577,6,7,13,46.15,-0.004692307692307685,7.6923076923076925
2430,4881,-28781,9,15,24,37.5,-0.031049999999999994,61.916666666666664
2431,2278,-5548,15,14,29,51.72,-0.004696551724137928,28.275862068965516
2433,3048,11602,10,5,15,66.67,0.040240000000000005,123.0
2434,2472,-82,14,15,29,48.28,-0.017206896551724138,26.24137931034483
2436,4100,-29400,14,18,32,43.75,-0.028056249999999998,22.53125
2438,1481,-2451,12,11,23,52.17,-0.004569565217391308,26.434782608695652
2439,12512,22838,14,12,26,53.85,0.0064923076923076905,24.653846153846153
2440,2032,-5582,18,15,33,54.55,-0.008775757575757576,27.757575757575758
2441,3550,-12100,8,10,18,44.44,-0.012144444444444446,71.72222222222223
2442,2110,1590,18,13,31,58.06,0.015619354838709677,33.774193548387096
2443,2344,-6274,17,25,42,40.48,-0.03376428571428571,20.11904761904762
2444,2737,8293,15,17,32,46.88,0.017537499999999998,17.96875
2449,2783,-3133,12,10,22,54.55,-0.008222727272727272,24.272727272727273
2450,5846,-26496,11,10,21,52.38,0.006861904761904761,103.0
2451,13423,-6323,16,14,30,53.33,-0.0055866666666666695,51.6
2453,2241,-1261,16,14,30,53.33,-0.0029633333333333326,44.43333333333333
2454,55337,-640337,11,16,27,40.74,-0.035866666666666665,28.925925925925927
2455,6258,-5068,14,13,27,51.85,-0.005107407407407407,17.296296296296298
2457,3864,-17844,18,19,37,48.65,-0.017878378378378385,22.7027027027027
2458,8683,-2083,17,12,29,58.62,0.01647586206896552,30.724137931034484
2459,5905,-7155,16,16,32,50.0,-0.006018749999999999,41.4375
2460,3529,-11789,17,15,32,53.12,-0.010687499999999999,36.84375
2461,3280,-28910,12,19,31,38.71,-0.03767741935483871,32.32258064516129
2462,3287,11813,13,11,24,54.17,0.014474999999999997,52.791666666666664
2464,4244,11856,15,8,23,65.22,0.019095652173913045,44.34782608695652
2465,3116,-16546,19,17,36,52.78,-0.0036694444444444457,23.166666666666668
2466,4708,19442,18,12,30,60.0,0.027076666666666662,81.93333333333334
2467,3120,790,13,11,24,54.17,0.005137499999999995,49.875
2468,1155,-4095,6,10,16,37.5,-0.014799999999999999,31.1875
2471,2285,6735,15,10,25,60.0,0.023208000000000003,47.32
2472,4437,-16327,15,17,32,46.88,-0.018159375,26.125
2474,23687,-53437,12,11,23,52.17,-0.017595652173913047,22.391304347826086
2476,3573,977,16,10,26,61.54,0.011465384615384612,59.07692307692308
2477,3090,-1800,14,12,26,53.85,-0.0013730769230769213,26.076923076923077
2478,5011,-32011,14,18,32,43.75,-0.024959375000000002,27.5625
2480,3462,3288,13,9,22,59.09,0.009859090909090908,73.0909090909091
2481,3875,11975,19,8,27,70.37,0.04951481481481482,19.77777777777778
2482,2929,10821,18,10,28,64.29,0.032039285714285715,48.32142857142857
2483,2421,949,12,12,24,50.0,0.001829166666666664,47.583333333333336
2484,2770,-4770,15,14,29,51.72,-0.011310344827586206,27.75862068965517
2485,7035,-32335,17,19,36,47.22,-0.01858888888888889,36.80555555555556
2486,3495,-13695,15,15,30,50.0,-0.0027066666666666667,29.333333333333332
2488,4473,-10673,17,17,34,50.0,-0.008185294117647058,58.64705882352941
2489,4463,-13233,20,19,39,51.28,-0.010615384615384615,43.282051282051285
2491,1593,-6923,11,12,23,47.83,-0.007943478260869564,12.08695652173913
2492,8315,17875,14,16,30,46.67,-0.007356666666666666,22.833333333333332
2493,3058,4072,18,12,30,60.0,0.01401,44.833333333333336
2495,6483,27817,19,13,32,59.38,0.019262500000000005,53.09375
2496,8297,51723,15,7,22,68.18,0.03761363636363636,41.54545454545455
2497,3755,-28505,10,12,22,45.45,-0.032131818181818185,26.954545454545453
2498,37618,-104918,18,15,33,54.55,0.0076333333333333305,23.545454545454547
2501,1827,-427,10,10,20,50.0,0.0010100000000000011,52.15
2504,1990,7130,20,8,28,71.43,0.03516785714285715,38.714285714285715
2505,0,0,0,0,0,0.0,,
2506,1186,2204,12,6,18,66.67,0.01877777777777778,76.05555555555556
2509,3103,-17493,10,18,28,35.71,-0.03245,62.57142857142857
2511,2097,-4057,14,12,26,53.85,0.0022038461538461535,45.0
2514,1466,-3416,9,8,17,52.94,-0.006923529411764708,62.64705882352941
2515,1582,5638,18,8,26,69.23,0.034969230769230766,54.23076923076923
2516,1902,-3532,15,18,33,45.45,-0.01896969696969697,53.84848484848485
2520,3633,677,18,13,31,58.06,0.006532258064516128,27.225806451612904
2524,3538,-28888,9,12,21,42.86,-0.0322047619047619,57.95238095238095
2527,1997,893,10,11,21,47.62,0.0009714285714285715,35.476190476190474
2528,820,4460,6,3,9,66.67,0.043500000000000004,79.55555555555556
2530,1385,-1485,9,13,22,40.91,-0.02821363636363636,29.863636363636363
2534,2644,-4054,12,13,25,48.0,-0.011072000000000002,30.28
2535,2249,11381,13,8,21,61.9,0.02666666666666667,67.04761904761905
2536,4382,-7782,15,14,29,51.72,-0.008303448275862066,68.41379310344827
2537,1207,-417,10,8,18,55.56,0.011472222222222224,40.111111111111114
2538,2275,-17925,12,13,25,48.0,-0.011528,33.96
2539,1089,8751,6,1,7,85.71,0.05634285714285714,141.28571428571428
2540,1219,12421,8,3,11,72.73,0.023372727272727267,33.72727272727273
2542,4528,10482,13,7,20,65.0,0.02919,32.85
2543,1364,456,12,10,22,54.55,0.012568181818181817,37.22727272727273
2545,7287,-58537,13,18,31,41.94,-0.01767096774193548,38.12903225806452
2546,2450,17810,12,8,20,60.0,0.0257,54.05
2547,3820,-23900,14,19,33,42.42,-0.02776060606060606,34.303030303030305
2548,7822,15678,14,8,22,63.64,0.015877272727272726,54.40909090909091
2597,3000,-6000,6,7,13,46.15,-0.007984615384615385,64.3076923076923
2601,5286,7554,23,16,39,58.97,0.0031692307692307684,27.384615384615383
2603,2522,-8472,11,14,25,44.0,-0.014116,35.12
2605,3729,-7829,14,12,26,53.85,0.0031115384615384633,60.15384615384615
2606,5197,-12297,11,11,22,50.0,-0.010363636363636365,74.18181818181819
2607,2416,8434,15,9,24,62.5,0.029529166666666665,68.625
2608,2703,-5473,11,8,19,57.89,0.008342105263157895,84.57894736842105
2609,3292,-4902,14,17,31,45.16,-0.025125806451612897,36.41935483870968
2610,2053,-6333,13,12,25,52.0,-0.009316,71.8
2611,2214,4836,18,11,29,62.07,0.020606896551724135,57.89655172413793
2612,6781,4669,17,13,30,56.67,0.010466666666666664,46.63333333333333
2613,1721,629,10,9,19,52.63,0.004363157894736844,56.578947368421055
2614,2106,2764,16,12,28,57.14,0.00038571428571428735,30.392857142857142
2615,3072,9378,11,8,19,57.89,0.004426315789473688,44.63157894736842
2616,2156,3244,10,7,17,58.82,0.014523529411764706,154.52941176470588
2617,4084,-16084,13,13,26,50.0,-0.01253076923076923,62.76923076923077
2618,1476,-3166,9,7,16,56.25,-0.012781250000000001,41.5
2630,916,-7816,4,4,8,50.0,-0.023450000000000006,54.125
2633,1056,-9706,2,4,6,33.33,-0.0416,187.5
2634,1750,-5000,4,5,9,44.44,-0.007088888888888891,85.22222222222223
2636,2544,4356,7,7,14,50.0,-0.007964285714285717,63.07142857142857
2637,1693,-13093,3,6,9,33.33,-0.03671111111111111,81.33333333333333
2642,2125,-10025,5,6,11,45.45,-0.013136363636363639,80.27272727272727
2701,1508,1042,11,7,18,61.11,0.010433333333333331,86.61111111111111
2702,3076,-7926,13,12,25,52.0,-0.007155999999999999,68.64
2704,3942,3208,15,8,23,65.22,0.022230434782608693,98.30434782608695
2705,2928,7282,20,14,34,58.82,0.01721764705882353,49.794117647058826
2706,2394,7256,13,7,20,65.0,0.019185,137.1
2707,41245,19755,12,12,24,50.0,-0.002658333333333332,61.5
2712,1071,-14871,2,4,6,33.33,-0.06348333333333334,23.0
2722,940,7510,4,1,5,80.0,0.04719999999999999,49.4
2723,22015,-114815,8,13,21,38.1,-0.03483809523809524,30.714285714285715
2727,17745,-56245,10,8,18,55.56,-0.004555555555555555,74.22222222222223
2731,8426,6674,9,7,16,56.25,0.004368749999999999,53.125
2739,1109,4441,4,3,7,57.14,0.03485714285714286,92.42857142857143
2748,2016,8284,5,2,7,71.43,0.03145714285714286,67.28571428571429
2801,1695,3005,9,7,16,56.25,0.0082,107.4375
2809,2859,-8329,13,11,24,54.17,0.0027958333333333307,50.25
2812,1336,-716,12,8,20,60.0,0.007219999999999999,142.6
2816,2505,-4715,13,15,28,46.43,-0.008371428571428568,38.142857142857146
2820,1046,2904,9,6,15,60.0,0.010459999999999999,162.66666666666666
2832,1706,8094,10,5,15,66.67,0.03828666666666667,110.06666666666666
2834,1139,5251,11,6,17,64.71,0.05500588235294118,148.41176470588235
2836,1707,-4057,10,11,21,47.62,-0.010561904761904764,109.66666666666667
2838,1085,4545,10,6,16,62.5,0.02783125,131.75
2841,1408,-1268,11,11,22,50.0,-0.010777272727272727,68.54545454545455
2845,2174,616,16,14,30,53.33,0.0004566666666666663,83.66666666666667
2849,1604,14716,16,5,21,76.19,0.0853285714285714,66.38095238095238
2850,3328,1592,15,13,28,53.57,-0.0007035714285714304,66.39285714285714
2851,1668,3822,10,8,18,55.56,0.017977777777777773,72.61111111111111
2852,1711,-9311,8,12,20,40.0,-0.02936500000000001,95.3
2855,3007,-2707,17,15,32,53.12,0.004771874999999998,56.03125
2867,997,1063,7,5,12,58.33,0.00431666666666667,114.16666666666667
2880,1923,16027,13,3,16,81.25,0.0565875,161.1875
2881,4245,36105,15,5,20,75.0,0.0512,63.5
2882,5555,9695,10,9,19,52.63,0.01125263157894737,88.73684210526316
2883,1434,-9684,8,12,20,40.0,-0.03379,92.6
2884,2302,12808,15,6,21,71.43,0.029138095238095237,82.80952380952381
2885,2084,5166,13,9,22,59.09,0.025200000000000004,51.27272727272727
2886,2251,15999,12,4,16,75.0,0.042425,100.5
2887,2356,-3996,15,10,25,60.0,0.003932000000000004,73.4
2888,2940,-1990,15,16,31,48.39,-0.011380645161290321,58.87096774193548
2889,1157,-1877,9,8,17,52.94,-0.01216470588235294,90.6470588235294
2890,1485,2265,11,8,19,57.89,0.012368421052631579,75.05263157894737
2891,3375,19825,19,7,26,73.08,0.04101153846153845,67.34615384615384
2892,2004,29446,15,1,16,93.75,0.0906,118.375
2897,246,-1226,2,2,4,50.0,-0.029775,291.0
2901,2642,6558,10,8,18,55.56,0.014566666666666665,78.5
2903,3531,3519,18,11,29,62.07,0.013403448275862073,40.89655172413793
2904,2188,-10678,6,16,22,27.27,-0.03517272727272727,85.72727272727273
2905,2960,-6390,14,15,29,48.28,-0.006089655172413792,44.37931034482759
2906,1258,6212,12,5,17,70.59,0.034964705882352946,72.23529411764706
2908,1817,-1767,9,7,16,56.25,-0.003787499999999999,143.6875
2910,0,0,0,0,0,0.0,,
2911,2934,-11604,13,15,28,46.43,-0.012525000000000005,25.535714285714285
2912,10322,33778,6,3,9,66.67,0.039044444444444444,118.11111111111111
2913,2239,-2619,15,11,26,57.69,0.015053846153846156,36.34615384615385
2915,8343,5257,17,12,29,58.62,0.0070310344827586215,49.10344827586207
2923,1766,16034,10,3,13,76.92,0.05828461538461538,39.38461538461539
2929,4827,-24037,3,11,14,21.43,-0.06357142857142857,43.5
2936,915,-7415,2,4,6,33.33,-0.04756666666666667,75.83333333333333
2939,3899,-33749,3,5,8,37.5,-0.012424999999999997,13.25
3002,2539,-16689,11,16,27,40.74,-0.018892592592592593,52.44444444444444
3003,5760,-7060,14,14,28,50.0,-0.0075642857142857135,36.75
3004,4357,31933,12,6,18,66.67,0.03288333333333334,34.666666666666664
3005,3768,-4718,14,14,28,50.0,-0.00404285714285714,23.892857142857142
3006,9829,1971,17,16,33,51.52,0.002157575757575754,21.848484848484848
3008,136897,1061103,10,8,18,55.56,0.006061111111111111,23.055555555555557
3010,5221,-35921,9,12,21,42.86,-0.03639523809523809,70.52380952380952
3011,1508,9622,16,6,22,72.73,0.04474545454545455,27.636363636363637
3013,4015,-19765,18,20,38,47.37,-0.011005263157894737,30.55263157894737
3014,5235,-14085,11,11,22,50.0,-0.013727272727272722,47.90909090909091
3015,4613,-5513,14,12,26,53.85,-0.004615384615384611,60.26923076923077
3016,4675,-5775,14,12,26,53.85,0.006230769230769232,18.23076923076923
3017,3927,-16687,15,15,30,50.0,-0.007529999999999998,23.266666666666666
3018,1778,-3788,10,7,17,58.82,0.021958823529411763,30.176470588235293
3019,12415,-23915,14,13,27,51.85,0.0020740740740740737,19.51851851851852
3021,1596,-4896,7,8,15,46.67,-0.00515333333333333,21.8
3022,6132,18668,14,12,26,53.85,0.021042307692307693,48.03846153846154
3023,7551,51879,11,7,18,61.11,0.016427777777777777,43.44444444444444
3024,3414,-3594,21,18,39,53.85,-0.006674358974358974,34.97435897435897
3025,2147,5453,14,9,23,60.87,0.02759565217391305,22.347826086956523
3026,7587,43763,14,10,24,58.33,0.03254583333333333,40.166666666666664
3027,3279,-5009,18,16,34,52.94,-0.007811764705882355,30.147058823529413
3028,2373,-133,11,11,22,50.0,-0.006845454545454549,102.86363636363636
3029,2402,18118,16,8,24,66.67,0.03545416666666667,34.208333333333336
3030,5862,9688,16,10,26,61.54,0.01678846153846154,42.53846153846154
3031,6341,-23341,19,19,38,50.0,-0.011081578947368421,26.55263157894737
3032,3457,-8967,14,17,31,45.16,-0.006899999999999999,38.0
3033,2098,-1098,9,9,18,50.0,0.0007999999999999991,143.88888888888889
3034,16354,-15804,12,11,23,52.17,-0.010686956521739127,22.956521739130434
3035,6539,43511,18,7,25,72.0,0.036904,24.88
3036,4267,25183,15,8,23,65.22,0.03237391304347826,71.82608695652173
3037,5755,-10255,18,13,31,58.06,0.002290322580645159,29.967741935483872
3038,2644,-18724,14,19,33,42.42,-0.023303030303030298,27.393939393939394
3040,4672,-10742,19,17,36,52.78,-0.004213888888888887,39.166666666666664
3041,6315,-15285,19,20,39,48.72,-0.013956410256410253,20.384615384615383
3042,5171,-9871,15,10,25,60.0,0.007355999999999997,45.32
3043,5069,-17069,17,15,32,53.12,0.004600000000000003,18.34375
3044,7982,60718,14,6,20,70.0,0.043875000000000004,21.35
3045,6011,46789,9,3,12,75.0,0.04133333333333334,127.66666666666667
3046,3765,5805,20,20,40,50.0,-0.0006000000000000005,27.775
3047,2928,-8658,16,17,33,48.48,-0.01584545454545454,32.60606060606061
3048,3992,-24422,14,18,32,43.75,-0.037515625,36.96875
3049,2333,-18733,11,22,33,33.33,-0.042648484848484845,16.181818181818183
3050,2835,-11275,18,20,38,47.37,-0.02584736842105263,29.236842105263158
3051,4147,10163,19,13,32,59.38,0.019221875,19.71875
3052,1828,512,15,12,27,55.56,0.007592592592592591,47.18518518518518
3054,3084,-12004,12,12,24,50.0,0.009141666666666659,42.166666666666664
3055,3512,13338,18,11,29,62.07,0.01393793103448276,46.58620689655172
3056,2325,915,11,9,20,55.0,0.005930000000000002,44.75
3057,5153,-2883,24,20,44,54.55,0.0030022727272727297,22.40909090909091
3058,2700,-28510,11,23,34,32.35,-0.051652941176470596,42.26470588235294
3059,4999,-29199,11,15,26,42.31,-0.029553846153846156,43.26923076923077
3060,8920,-14520,15,13,28,53.57,0.005117857142857141,34.142857142857146
3062,4844,-24694,15,16,31,48.39,-0.01736451612903226,30.580645161290324
3090,4106,7394,12,8,20,60.0,0.012305,62.1
3094,3308,-13708,11,11,22,50.0,-0.010936363636363631,32.04545454545455
3130,7704,-8404,5,6,11,45.45,-0.01424545454545455,39.54545454545455
3138,4694,-86654,11,12,23,47.83,-0.020169565217391303,31.26086956521739
3149,2302,-25182,6,11,17,35.29,-0.043523529411764704,27.764705882352942
3164,4046,30804,13,6,19,68.42,0.04684210526315789,26.42105263157895
3167,2705,-7705,6,6,12,50.0,-0.00040833333333332886,44.666666666666664
3189,5447,-12747,8,6,14,57.14,-0.0018357142857142877,19.857142857142858
3209,3066,-666,13,11,24,54.17,0.004325000000000005,45.833333333333336
3229,3228,152,14,16,30,46.67,-0.004356666666666664,22.333333333333332
3231,3532,-6282,13,10,23,56.52,0.00022173913043478248,43.30434782608695
3257,4662,-8062,8,10,18,44.44,-0.010738888888888893,20.444444444444443
3266,1917,-10727,5,13,18,27.78,-0.025588888888888887,33.55555555555556
3296,3648,-28448,10,14,24,41.67,-0.027795833333333336,22.916666666666668
3305,7021,1629,13,15,28,46.43,-0.013274999999999997,62.357142857142854
3308,1419,-3479,8,8,16,50.0,-0.0021312499999999995,28.75
3311,11350,39250,24,8,32,75.0,0.052259375,24.46875
3312,1484,-11274,7,11,18,38.89,-0.03835555555555556,23.444444444444443
3321,1072,-4852,4,7,11,36.36,-0.021245454545454543,32.72727272727273
3338,3123,-16073,4,9,13,30.77,-0.050646153846153834,28.076923076923077
3346,2899,6001,5,6,11,45.45,0.003854545454545454,38.09090909090909
3356,15010,-53910,13,16,29,44.83,-0.01870344827586207,41.86206896551724
3376,13946,38354,16,7,23,69.57,0.03585217391304347,39.95652173913044
3380,3965,2185,18,12,30,60.0,0.008736666666666667,27.633333333333333
3383,2339,-16029,8,12,20,40.0,-0.038395,24.4
3406,36348,32252,20,17,37,54.05,-0.0029378378378378408,17.972972972972972
3413,6509,36691,7,2,9,77.78,0.04826666666666666,17.666666666666668
3416,7649,5251,13,8,21,61.9,0.010990476190476193,66.23809523809524
3419,3015,-21415,13,14,27,48.15,-0.01794074074074074,27.22222222222222
3432,1594,-14844,9,10,19,47.37,-0.039347368421052624,28.842105263157894
3437,1920,-7670,7,5,12,58.33,0.003974999999999999,17.583333333333332
3443,20955,70145,14,8,22,63.64,0.017368181818181814,26.272727272727273
3450,7912,-48792,13,12,25,52.0,-0.015800000000000005,23.0
3454,12351,-64001,14,14,28,50.0,-0.008117857142857144,29.285714285714285
3481,2177,-9087,6,10,16,37.5,-0.034249999999999996,39.4375
3494,2450,-20230,12,15,27,44.44,-0.018377777777777778,32.48148148148148
3501,4738,3412,11,8,19,57.89,0.010884210526315788,66.3157894736842
3504,10774,-77574,12,16,28,42.86,-0.028371428571428572,20.357142857142858
3515,6425,-20975,7,6,13,53.85,-0.009923076923076915,74.46153846153847
3518,6349,-44549,11,16,27,40.74,-0.01573333333333334,33.77777777777778
3528,1716,11684,6,3,9,66.67,0.0408,78.0
3530,5319,-52199,6,15,21,28.57,-0.060619047619047614,24.952380952380953
3532,5639,-5789,7,10,17,41.18,-0.006835294117647062,20.0
3533,9669,-1569,8,8,16,50.0,-0.0068562499999999995,39.875
3535,2250,-3350,10,12,22,45.45,0.012272727272727275,21.09090909090909
3536,1408,472,12,8,20,60.0,0.013800000000000003,20.4
3543,3307,-25377,8,11,19,42.11,-0.008878947368421057,91.73684210526316
3545,7058,-50308,12,13,25,48.0,-0.016043999999999996,22.28
3550,1413,-4113,7,8,15,46.67,-0.00405333333333333,59.666666666666664
3557,2657,-6867,9,14,23,39.13,-0.0038130434782608683,41.21739130434783
3563,14560,102490,11,10,21,52.38,0.006380952380952376,29.666666666666668
3576,3634,-11824,15,12,27,55.56,-0.0095037037037037,26.444444444444443
3583,3835,25965,8,3,11,72.73,0.046754545454545465,40.0
3588,7604,-86404,7,12,19,36.84,-0.04516315789473685,33.26315789473684
3591,3432,-5882,11,7,18,61.11,0.008377777777777777,23.88888888888889
3593,2658,-22398,10,20,30,33.33,-0.025333333333333333,26.7
3596,5249,-43699,6,11,17,35.29,-0.0503,31.58823529411765
3605,5246,-36446,10,11,21,47.62,-0.023804761904761905,41.76190476190476
3607,3961,-29481,7,11,18,38.89,-0.031905555555555555,28.77777777777778
3617,5637,29463,8,4,12,66.67,0.03269166666666667,68.0
3622,9702,-14242,12,11,23,52.17,0.000417391304347826,27.608695652173914
3645,4831,-21381,10,13,23,43.48,-0.018686956521739132,25.304347826086957
3653,11517,-18067,9,10,19,47.37,-0.010673684210526314,16.63157894736842
3661,7571,-16071,5,4,9,55.56,0.013466666666666668,17.88888888888889
3665,7132,-41832,4,4,8,50.0,-0.008137500000000004,20.875
3669,2396,-12746,5,8,13,38.46,-0.022999999999999996,36.53846153846154
3673,28633,-192783,12,12,24,50.0,-0.0191875,26.5
3679,4558,-7458,7,8,15,46.67,-0.0030200000000000005,57.0
3682,972,-3492,7,7,14,50.0,-0.009071428571428572,43.57142857142857
3686,2612,-27082,11,16,27,40.74,-0.025488888888888894,25.11111111111111
3694,1868,11682,13,5,18,72.22,0.043666666666666666,45.111111111111114
3701,893,2997,6,6,12,50.0,-0.018108333333333334,7.833333333333333
3702,4071,14869,13,7,20,65.0,0.023195,63.6
3703,1015,-2705,7,6,13,53.85,0.0006692307692307681,81.92307692307692
3704,2345,-7495,12,12,24,50.0,-0.011729166666666666,27.666666666666668
3705,2167,-12367,3,5,8,37.5,-0.0292375,224.0
3706,1045,1355,4,3,7,57.14,0.024057142857142857,60.857142857142854
3708,2721,56879,6,0,6,100.0,0.13633333333333333,37.666666666666664
3711,1675,14425,3,1,4,75.0,0.046024999999999996,33.25
3712,736,3864,4,2,6,66.67,0.026633333333333332,46.333333333333336
3714,1115,-7915,1,2,3,33.33,-0.034466666666666666,5.666666666666667
4104,8435,11515,16,13,29,55.17,0.007341379310344833,68.41379310344827
4106,4108,4342,14,11,25,56.0,0.013152000000000004,43.52
4108,6470,-720,22,18,40,55.0,0.0018425000000000026,37.125
4119,7020,48080,12,6,18,66.67,0.029938888888888886,65.38888888888889
4133,4247,-1397,8,8,16,50.0,0.009212499999999997,53.375
4137,16911,-42911,8,8,16,50.0,-0.008199999999999999,32.5
4142,2744,15956,12,4,16,75.0,0.03934375,29.375
4155,3911,-4961,8,9,17,47.06,-0.007952941176470591,47.23529411764706
4164,4371,-14771,8,7,15,53.33,-4.666666666666708e-05,88.0
4190,6964,5736,10,5,15,66.67,0.010920000000000001,40.4
4306,2511,-5341,11,15,26,42.31,-0.017369230769230772,57.57692307692308
4414,1761,-10751,9,16,25,36.0,-0.041072,46.92
4426,5256,-14356,9,11,20,45.0,-0.010645000000000002,31.55
4438,6943,-36443,4,6,10,40.0,-0.02365,68.8
4439,3762,-11262,3,2,5,60.0,-0.006560000000000003,26.2
4526,4609,-11309,13,15,28,46.43,-0.009746428571428573,63.07142857142857
4532,2462,-4192,9,10,19,47.37,-0.004747368421052628,63.78947368421053
4536,4564,14636,5,2,7,71.43,0.022728571428571424,64.42857142857143
4540,3632,24388,10,3,13,76.92,0.03644615384615385,23.76923076923077
4545,1879,14571,6,2,8,75.0,0.0627,36.875
4551,4811,31789,4,2,6,66.67,0.030233333333333334,13.666666666666666
4552,2790,-24790,3,7,10,30.0,-0.04884,64.7
4555,620,-9220,0,2,2,0.0,-0.0813,203.5
4557,3585,15915,6,3,9,66.67,0.03174444444444444,148.11111111111111
4560,1988,21112,6,1,7,85.71,0.06738571428571428,35.57142857142857
4562,804,-424,2,3,5,40.0,-0.00476,120.6
4564,2320,-21070,3,7,10,30.0,-0.04825,27.6
4566,1295,-12095,2,3,5,40.0,-0.04182,45.2
4571,2283,-33583,1,4,5,20.0,-0.06222000000000001,59.6
4572,2210,-25110,1,3,4,25.0,-0.055049999999999995,26.25
4576,2004,12796,3,1,4,75.0,0.052099999999999994,24.0
4581,369,-5269,0,2,2,0.0,-0.07400000000000001,149.0
4720,2235,2335,15,11,26,57.69,0.010823076923076923,77.84615384615384
4722,2035,-6395,7,11,18,38.89,-0.035261111111111104,71.5
4737,7597,19403,11,9,20,55.0,0.0298,48.15
4739,3638,-16938,5,5,10,50.0,-0.01634,33.3
4746,7500,-52350,8,14,22,36.36,-0.032650000000000005,37.40909090909091
4755,2330,27070,9,2,11,81.82,0.062127272727272725,49.09090909090909
4763,4694,9506,5,2,7,71.43,0.028700000000000003,49.285714285714285
4764,1459,-5199,2,2,4,50.0,-0.006675000000000006,67.5
4766,4162,11838,3,2,5,60.0,0.0225,85.0
4807,702,-30692,1,2,3,33.33,-0.07553333333333333,38.0
4904,4425,16975,10,4,14,71.43,0.04208571428571428,174.71428571428572
4906,8344,-19244,21,16,37,56.76,-0.0001918918918918955,34.4054054054054
4912,8085,-53535,7,9,16,43.75,-0.017181250000000002,33.8125
4915,2703,797,6,4,10,60.0,0.009250000000000005,27.9
4916,2955,-10505,8,9,17,47.06,-0.011699999999999999,28.294117647058822
4919,2410,-35210,3,9,12,25.0,-0.07721666666666667,27.583333333333332
4927,4452,10948,10,8,18,55.56,0.005055555555555557,43.05555555555556
4930,1949,-8939,10,8,18,55.56,-0.005516666666666666,23.27777777777778
4934,1572,-11702,9,11,20,45.0,-0.027135000000000003,21.4
4935,5895,7555,11,10,21,52.38,0.005566666666666668,43.95238095238095
4938,4292,5158,8,5,13,61.54,0.008084615384615383,56.15384615384615
4942,1652,-21402,2,7,9,22.22,-0.06425555555555557,64.33333333333333
4943,5034,-16334,5,6,11,45.45,-0.00950909090909091,12.181818181818182
4952,2698,20202,10,4,14,71.43,0.0469,42.785714285714285
4956,1739,5741,11,6,17,64.71,0.02894705882352941,22.235294117647058
4958,4205,23595,7,2,9,77.78,0.04594444444444444,29.444444444444443
4960,1208,12492,9,2,11,81.82,0.05771818181818181,38.54545454545455
4961,5633,-25203,9,11,20,45.0,-0.023469999999999998,67.5
4967,2477,-18907,7,13,20,35.0,-0.038675,25.55
4968,6467,-79217,3,7,10,30.0,-0.04586,13.3
4976,3132,-15232,8,8,16,50.0,-0.013131249999999999,33.6875
4977,7150,12650,10,7,17,58.82,0.011594117647058826,35.588235294117645
4989,1263,-11683,3,8,11,27.27,-0.05310909090909091,35.09090909090909
4994,8124,-9224,8,8,16,50.0,-0.0073,14.3125
4999,2996,-22546,4,8,12,33.33,-0.03716666666666667,89.75
5007,5253,-13603,9,12,21,42.86,-0.00991904761904762,135.71428571428572
5203,10526,-23426,9,12,21,42.86,0.0027666666666666725,65.9047619047619
5215,6253,-36853,8,13,21,38.1,-0.026552380952380952,44.714285714285715
5225,2455,-3805,5,5,10,50.0,0.011049999999999999,17.0
5234,4824,22776,10,4,14,71.43,0.03159285714285715,44.714285714285715
5243,1906,-9256,5,4,9,55.56,-0.0075666666666666695,34.888888888888886
5258,699,1151,3,3,6,50.0,0.005599999999999994,21.0
5269,23394,-11944,7,5,12,58.33,0.005891666666666666,13.583333333333334
5283,585,6295,2,1,3,66.67,0.0872,79.33333333333333
5284,1618,1782,3,2,5,60.0,0.009060000000000002,154.4
5285,2450,-1550,4,3,7,57.14,0.012042857142857143,39.42857142857143
5288,2920,15580,3,2,5,60.0,0.02468,44.0
5388,5094,8956,13,10,23,56.52,0.004856521739130436,44.52173913043478
5434,9061,2639,16,10,26,61.54,0.005846153846153847,36.11538461538461
5469,4004,7366,19,13,32,59.38,0.015637500000000002,39.96875
5471,6990,-32440,13,13,26,50.0,-0.015761538461538462,45.38461538461539
5484,3757,4483,18,15,33,54.55,0.005430303030303029,34.84848484848485
5515,2746,1704,18,11,29,62.07,0.013913793103448277,58.48275862068966
5519,2590,2760,13,10,23,56.52,0.01825652173913044,52.391304347826086
5521,1640,-1400,12,11,23,52.17,-0.0013043478260869564,55.08695652173913
5522,7080,8620,16,11,27,59.26,0.014788888888888893,37.03703703703704
5525,2110,-11880,8,9,17,47.06,-0.004894117647058821,62.76470588235294
5531,3626,19634,19,8,27,70.37,0.03301481481481481,29.037037037037038
5533,1730,-11430,7,10,17,41.18,-0.03190588235294117,58.05882352941177
5534,11184,11316,19,13,32,59.38,0.014778125,53.84375
5538,1439,611,3,4,7,42.86,0.008014285714285715,118.28571428571429
5546,784,1016,1,1,2,50.0,0.025099999999999997,58.0
5607,2345,-19745,8,12,20,40.0,-0.033415,57.5
5608,4343,-24093,13,16,29,44.83,-0.021665517241379304,70.27586206896552
5706,5048,30652,13,7,20,65.0,0.029135,74.45
5871,5770,29430,7,4,11,63.64,0.02007272727272727,29.454545454545453
5876,1552,10998,5,2,7,71.43,0.03337142857142857,96.0
5880,750,6600,6,1,7,85.71,0.05697142857142857,194.42857142857142
5906,1390,-6710,7,9,16,43.75,-0.029400000000000003,34.4375
5907,3329,10871,9,7,16,56.25,0.0002625000000000023,59.75
6005,2067,8553,19,7,26,73.08,0.03951538461538461,67.88461538461539
6024,2695,-9745,7,6,13,53.85,-0.0099,130.84615384615384
6108,3995,-14445,15,19,34,44.12,-0.01815,44.529411764705884
6112,3681,4039,17,12,29,58.62,0.009179310344827588,68.24137931034483
6115,4857,-27357,9,13,22,40.91,-0.02724545454545455,107.86363636363636
6116,2714,-12484,20,23,43,46.51,-0.021293023255813955,22.906976744186046
6117,3689,-38489,13,13,26,50.0,-0.0065653846153846136,27.73076923076923
6120,3864,-18774,16,18,34,47.06,-0.009850000000000001,20.529411764705884
6128,5862,-5012,16,17,33,48.48,-0.006536363636363636,65.06060606060606
6133,2153,-10553,9,14,23,39.13,-0.024513043478260863,35.21739130434783
6136,5028,-33978,15,15,30,50.0,-0.009596666666666668,88.93333333333334
6139,7099,-20299,14,16,30,46.67,-0.019546666666666664,47.46666666666667
6141,4313,-14373,16,16,32,50.0,-0.014203125,38.9375
6142,3264,4166,20,14,34,58.82,0.018523529411764706,26.176470588235293
6152,4842,1718,18,18,36,50.0,-0.006844444444444443,30.47222222222222
6153,5228,-16078,16,15,31,51.61,-0.007416129032258064,23.903225806451612
6155,4378,-15528,13,15,28,46.43,-0.00474642857142857,33.0
6164,2333,-12033,12,14,26,46.15,-0.015365384615384612,29.807692307692307
6165,3553,1367,17,16,33,51.52,0.012672727272727271,18.636363636363637
6166,7429,-31129,12,17,29,41.38,-0.02740689655172413,45.241379310344826
6168,4575,-28725,14,18,32,43.75,-0.023346875,21.5625
6172,1048,2472,9,6,15,60.0,0.040333333333333346,12.0
6176,9297,-14247,11,13,24,45.83,-0.0036083333333333293,27.208333333333332
6177,1825,12735,10,3,13,76.92,0.04695384615384615,34.84615384615385
6183,1564,1286,10,6,16,62.5,0.0094125,104.25
6184,4791,17559,13,7,20,65.0,0.026959999999999994,140.2
6189,4719,-16469,12,17,29,41.38,-0.02197241379310345,86.17241379310344
6191,3923,-21123,13,12,25,52.0,-0.008764000000000001,34.52
6192,6773,4427,14,10,24,58.33,0.009666666666666665,37.375
6196,6521,-631,15,14,29,51.72,0.004148275862068964,30.517241379310345
6197,7400,54400,22,5,27,81.48,0.06357777777777777,33.0
6201,3208,2742,10,7,17,58.82,0.012958823529411764,112.76470588235294
6202,6868,9032,14,10,24,58.33,0.008333333333333333,32.375
6205,5105,-44305,12,20,32,37.5,-0.040296875,44.375
6206,9811,-59411,10,14,24,41.67,-0.029829166666666667,81.16666666666667
6209,6632,-48522,15,17,32,46.88,-0.011746875,23.1875
6213,5468,8682,12,12,24,50.0,-0.0034749999999999968,39.958333333333336
6214,6580,-25730,12,14,26,46.15,-0.016588461538461535,48.96153846153846
6215,2521,-2371,10,9,19,52.63,0.01568947368421053,44.21052631578947
6216,4430,-16180,14,11,25,56.0,0.009548000000000006,75.56
6224,6528,-23128,12,11,23,52.17,-0.003047826086956524,66.30434782608695
6225,1605,-2775,10,9,19,52.63,-0.0030578947368421015,11.894736842105264
6226,2172,-3642,15,15,30,50.0,-0.0077433333333333295,29.566666666666666
6230,15298,-53848,16,16,32,50.0,-0.014453125,34.5625
6235,3916,4324,23,9,32,71.88,0.030621875,23.03125
6239,7748,50002,12,5,17,70.59,0.03802352941176471,44.588235294117645
6243,6275,25805,14,16,30,46.67,-0.013236666666666664,14.433333333333334
6251,1507,2313,11,6,17,64.71,0.02585294117647059,39.470588235294116
6257,2673,-12373,10,10,20,50.0,-0.022335,33.2
6269,7396,-5286,15,13,28,53.57,0.013792857142857143,34.82142857142857
6271,10051,-9951,8,9,17,47.06,-0.006111764705882354,16.294117647058822
6277,9407,48843,14,7,21,66.67,0.035,87.9047619047619
6278,6796,2354,12,9,21,57.14,0.011538095238095241,46.38095238095238
6281,4549,1101,8,7,15,53.33,0.005433333333333334,154.6
6282,4395,-2685,19,13,32,59.38,0.009200000000000002,27.65625
6283,4414,3146,22,15,37,59.46,0.029021621621621623,22.513513513513512
6285,11372,34428,19,12,31,61.29,0.02375161290322581,28.774193548387096
6288,0,0,0,0,0,0.0,,
6289,1918,-958,10,12,22,45.45,-0.018122727272727276,22.363636363636363
6405,2152,-41852,3,12,15,20.0,-0.08461999999999999,47.333333333333336
6409,9274,86226,2,1,3,66.67,0.0481,17.333333333333332
6412,3423,20277,8,3,11,72.73,0.039145454545454546,48.18181818181818
6414,17418,-199918,4,7,11,36.36,-0.04678181818181819,22.90909090909091
6415,12006,-58506,2,3,5,40.0,-0.0293,29.4
6416,7930,-17700,9,6,15,60.0,0.004033333333333338,25.933333333333334
6431,565,575,3,4,7,42.86,0.015057142857142856,13.142857142857142
6438,1939,-25289,1,5,6,16.67,-0.0682,21.833333333333332
6442,1789,-3789,4,4,8,50.0,0.0002999999999999947,87.25
6443,1015,-4095,4,6,10,40.0,-0.037910000000000006,30.2
6449,2079,-20879,3,6,9,33.33,-0.049044444444444446,34.55555555555556
6451,6118,-41318,4,7,11,36.36,-0.03378181818181818,20.0
6456,5168,42832,7,2,9,77.78,0.05366666666666667,29.666666666666668
6464,3113,-18413,2,3,5,40.0,-0.03468,311.8
6477,1751,9299,8,2,10,80.0,0.07279,39.4
6491,7107,69393,5,2,7,71.43,0.05678571428571429,49.57142857142857
6504,9839,49661,8,4,12,66.67,0.041558333333333336,42.333333333333336
6505,5858,-1658,7,5,12,58.33,-0.0010666666666666674,90.25
6515,0,0,0,0,0,0.0,,
6525,2863,-7963,4,4,8,50.0,-0.009812499999999995,20.625
6531,7531,-41581,2,4,6,33.33,-0.044833333333333336,18.166666666666668
6533,12121,-59921,6,3,9,66.67,0.008033333333333333,13.777777777777779
6541,5782,-11682,7,7,14,50.0,-0.005992857142857142,17.0
6552,2442,-10792,3,4,7,42.86,-0.003028571428571428,29.285714285714285
6558,2078,-8228,5,5,10,50.0,-0.013299999999999998,19.0
6573,830,-11280,1,4,5,20.0,-0.08792000000000001,16.8
6579,3277,-18427,3,4,7,42.86,-0.028214285714285716,116.71428571428571
6581,2971,-22071,2,4,6,33.33,-0.025966666666666666,68.16666666666667
6582,4675,-96675,0,8,8,0.0,-0.10773750000000001,36.25
6591,1530,-16880,2,3,5,40.0,-0.04122,33.2
6592,791,-7491,1,1,2,50.0,-0.038,12.0
6598,1017,-7917,1,2,3,33.33,-0.009133333333333335,21.666666666666668
6605,9219,-44019,8,12,20,40.0,-0.02583,69.9
6625,921,15929,2,2,4,50.0,0.102075,75.25
6641,1859,25341,4,1,5,80.0,0.08518,67.6
6655,1229,7171,3,1,4,75.0,0.0382,18.75
6666,2178,-4178,2,2,4,50.0,0.0059000000000000025,35.0
6668,1217,-467,2,2,4,50.0,0.01165,14.25
6669,19495,-185495,1,3,4,25.0,-0.050124999999999996,26.5
6670,2069,31931,2,0,2,100.0,0.09795000000000001,65.0
6671,727,-2977,1,2,3,33.33,-0.021833333333333333,139.0
6672,932,-5432,1,1,2,50.0,-0.01745,25.5
6674,799,5501,3,2,5,60.0,0.051019999999999996,47.8
6698,1118,-1768,2,2,4,50.0,0.0072000000000000015,15.75
6706,1309,-9809,1,1,2,50.0,-0.0001500000000000043,13.5
6715,2470,17030,3,1,4,75.0,0.05445,48.75
6743,3045,21655,4,2,6,66.67,0.04698333333333334,7.0
6754,257,2593,1,0,1,100.0,0.0621,167.0
6756,1742,-49742,0,1,1,0.0,-0.1489,5.0
8011,2829,-1829,11,11,22,50.0,-0.004890909090909089,24.40909090909091
8016,8516,-3116,11,10,21,52.38,0.0007142857142857149,32.95238095238095
8021,5406,-19756,17,13,30,56.67,0.010573333333333334,39.43333333333333
8028,0,0,0,0,0,0.0,,
8033,2865,3565,17,11,28,60.71,0.03378928571428571,25.25
8039,5781,-4931,13,12,25,52.0,-0.006212000000000004,31.04
8046,11307,-7707,10,11,21,47.62,0.004590476190476188,25.523809523809526
8070,14386,48314,15,10,25,60.0,0.004596000000000003,32.4
8072,9786,-40186,9,10,19,47.37,-0.009984210526315788,80.57894736842105
8081,15951,47149,12,11,23,52.17,0.01226521739130435,31.782608695652176
8101,3350,-8720,22,18,40,55.0,0.0065574999999999965,27.7
8103,5708,-20508,14,15,29,48.28,-0.0030344827586206912,42.310344827586206
8104,0,0,0,0,0,0.0,,
8105,2831,-12551,12,18,30,40.0,-0.020496666666666663,28.2
8110,1925,345,16,9,25,64.0,0.005972000000000001,30.68
8112,2608,7122,14,8,22,63.64,0.02065454545454545,36.90909090909091
8114,12575,45225,12,9,21,57.14,0.016009523809523814,24.714285714285715
8131,3880,-930,13,9,22,59.09,0.006359090909090908,51.77272727272727
8150,1856,-10306,5,6,11,45.45,-0.02664545454545455,36.0
8163,4518,-15468,11,14,25,44.0,-0.017915999999999998,30.64
8201,3255,795,15,12,27,55.56,-0.006737037037037038,31.0
8210,5328,942,13,13,26,50.0,-0.008838461538461542,35.42307692307692
8213,2692,-16942,5,8,13,38.46,-0.028161538461538464,47.53846153846154
8215,2479,-15729,10,12,22,45.45,-0.022704545454545453,24.681818181818183
8222,1298,402,7,5,12,58.33,0.014599999999999997,53.75
8249,4394,-19664,16,16,32,50.0,-0.015218749999999998,36.71875
8261,4053,-20763,11,16,27,40.74,-0.03956666666666666,18.814814814814813
8271,2318,-3918,8,6,14,57.14,0.0030428571428571458,66.42857142857143
8341,9051,15449,5,3,8,62.5,0.014125000000000002,87.875
8367,586,8564,3,0,3,100.0,0.10803333333333333,78.0
8374,3632,-18142,10,13,23,43.48,-0.021817391304347816,25.956521739130434
8404,1875,12325,7,2,9,77.78,0.05684444444444445,24.444444444444443
8411,2565,-13715,6,7,13,46.15,-0.009523076923076928,34.92307692307692
8422,9429,-11929,5,5,10,50.0,-0.0014600000000000017,82.0
8429,3340,4740,7,12,19,36.84,-0.041999999999999996,39.26315789473684
8442,1545,-9145,2,3,5,40.0,-0.017459999999999993,65.0
8443,1094,6576,6,3,9,66.67,0.05781111111111111,110.66666666666667
8454,12090,-250090,1,5,6,16.67,-0.07896666666666667,67.66666666666667
8462,8431,-27831,5,5,10,50.0,-0.001659999999999999,62.9
8463,952,-702,3,4,7,42.86,-0.012414285714285713,43.714285714285715
8464,10660,7340,3,4,7,42.86,-0.003742857142857143,41.714285714285715
8466,1852,-19552,2,3,5,40.0,-0.03828000000000001,66.4
8467,1992,-7192,4,4,8,50.0,-0.012662500000000004,44.625
8473,2482,968,5,4,9,55.56,0.008144444444444447,85.44444444444444
8478,3911,-63511,3,6,9,33.33,-0.06726666666666666,42.44444444444444
8480,2004,-1304,1,2,3,33.33,-0.014033333333333337,137.33333333333334
8481,2091,16109,5,1,6,83.33,0.05416666666666667,75.16666666666667
8482,1218,-24218,0,2,2,0.0,-0.10555,76.0
8488,434,-5334,1,2,3,33.33,-0.043966666666666675,72.66666666666667
8499,3094,-11694,3,3,6,50.0,-0.012016666666666667,42.666666666666664
8926,1773,9727,11,5,16,68.75,0.0281125,121.5625
8940,2323,-13993,8,12,20,40.0,-0.035735,71.8
8996,5295,3205,13,8,21,61.9,0.023666666666666666,29.857142857142858
9802,3595,-25145,4,5,9,44.44,-0.02645555555555555,47.111111111111114
9902,2030,1130,16,14,30,53.33,0.032446666666666665,45.0
9904,3428,-13478,9,11,20,45.0,-0.015955000000000004,66.15
9905,2450,13750,12,6,18,66.67,0.030238888888888885,99.22222222222223
9906,2445,3595,13,10,23,56.52,0.015730434782608705,16.652173913043477
9907,1995,-12575,10,14,24,41.67,-0.029583333333333336,61.375
9908,1037,9913,8,1,9,88.89,0.06037777777777779,133.66666666666666
9910,9466,29684,11,8,19,57.89,0.01494210526315789,49.89473684210526
9911,3018,9382,17,8,25,68.0,0.02806,36.6
9912,1487,-7017,9,13,22,40.91,0.017818181818181816,33.72727272727273
9914,15761,40789,15,8,23,65.22,0.02521739130434782,26.347826086956523
9917,5027,28723,10,5,15,66.67,0.029359999999999994,169.93333333333334
9918,662,8038,4,0,4,100.0,0.072175,71.5
9919,1908,-2458,10,9,19,52.63,0.0024684210526315768,57.31578947368421
9921,18192,-54392,12,10,22,54.55,0.004409090909090908,53.81818181818182
9924,3515,-8215,9,12,21,42.86,-0.015447619047619049,92.28571428571429
9925,2550,-6050,8,7,15,53.33,-0.010760000000000002,120.6
9926,362,5388,2,0,2,100.0,0.0955,98.5
9927,4529,-1629,15,10,25,60.0,0.00718,77.8
9928,1916,8974,16,9,25,64.0,0.028856000000000003,37.72
9929,1608,-8418,10,17,27,37.04,-0.04484444444444444,48.592592592592595
9930,4578,6472,11,6,17,64.71,0.021782352941176468,149.7058823529412
9931,530,3070,2,1,3,66.67,0.03950000000000001,66.0
9933,3449,-2199,10,7,17,58.82,0.007576470588235292,91.94117647058823
9934,4285,-1235,15,16,31,48.39,-0.008022580645161294,39.70967741935484
9935,2320,-20630,7,18,25,28.0,-0.05148,37.24
9937,2925,-3525,9,8,17,52.94,-0.01444705882352941,135.2941176470588
9938,6381,-27201,15,12,27,55.56,0.0005666666666666669,26.85185185185185
9939,7273,16527,14,12,26,53.85,0.00726153846153846,83.65384615384616
9940,5593,-15493,12,10,22,54.55,-0.004677272727272729,48.40909090909091
9941,7369,3381,12,10,22,54.55,-0.001740909090909089,62.04545454545455
9942,6076,-45976,7,12,19,36.84,-0.039442105263157896,58.94736842105263
9943,3811,6139,10,10,20,50.0,0.010914999999999998,73.75
9944,3466,1184,13,11,24,54.17,0.008329166666666667,51.5
9945,4906,-2096,14,13,27,51.85,-0.007344444444444446,45.629629629629626
9946,2096,-6666,11,12,23,47.83,-0.006230434782608695,37.26086956521739
9955,5035,6165,20,9,29,68.97,0.03218275862068966,45.06896551724138
9958,2750,9280,10,5,15,66.67,0.03368666666666667,37.2
1312A,1459,5891,8,5,13,61.54,0.003192307692307688,116.0
2002A,2184,3466,7,3,10,70.0,0.018749999999999996,198.6
2836A,140,1860,1,0,1,100.0,0.083,320.0
2838A,594,-5344,1,1,2,50.0,-0.048499999999999995,560.0
2881A,371,-1671,0,1,1,0.0,-0.0259,1031.0
2881B,363,-863,0,1,1,0.0,-0.0138,1114.0
2882A,363,537,1,0,1,100.0,0.0087,821.0
2882B,363,737,1,0,1,100.0,0.012,323.0
2887E,315,-1115,0,1,1,0.0,-0.0205,1074.0
2887F,301,-1101,0,1,1,0.0,-0.0212,662.0
2888A,246,-496,0,1,1,0.0,-0.0118,819.0
2888B,245,205,1,0,1,100.0,0.0049,506.0
2891B,369,-269,0,1,1,0.0,-0.0043,816.0
2891C,358,-58,0,1,1,0.0,-0.001,821.0
2897A,143,917,1,1,2,50.0,0.047799999999999995,383.0
3702A,289,2111,1,0,1,100.0,0.0444,821.0
5871A,582,-382,0,1,1,0.0,-0.0038,393.0
9941A,303,597,1,0,1,100.0,0.0117,821.0
1240,380,14720,1,0,1,100.0,0.2751,335.0
1258,1608,1192,5,5,10,50.0,0.0014099999999999987,61.1
1259,3680,320,4,3,7,57.14,0.003499999999999999,99.85714285714286
1264,7356,-14856,3,3,6,50.0,0.0016999999999999977,134.33333333333334
1268,8163,-65663,3,8,11,27.27,-0.037127272727272724,130.63636363636363
1336,1689,-12819,7,10,17,41.18,-0.04058235294117647,43.64705882352941
1565,49938,-14138,15,8,23,65.22,0.020091304347826085,37.56521739130435
1569,3747,-18587,12,11,23,52.17,-0.007543478260869567,33.47826086956522
1570,1341,-1131,6,6,12,50.0,-0.008841666666666666,40.25
1580,9970,-24770,8,7,15,53.33,-0.0017533333333333314,57.06666666666667
1584,1763,-2603,10,9,19,52.63,0.0017894736842105176,25.263157894736842
1586,2479,-179,6,8,14,42.86,-0.010964285714285715,50.0
1591,1123,-773,5,2,7,71.43,0.022242857142857144,42.857142857142854
1593,1609,3441,4,2,6,66.67,0.02581666666666667,140.0
1595,2890,6360,7,3,10,70.0,0.01816,54.4
1599,1949,-349,4,4,8,50.0,-0.000987499999999997,86.25
1742,3912,5588,17,11,28,60.71,0.041675000000000004,29.607142857142858
1752,2867,7183,10,5,15,66.67,0.019340000000000003,76.33333333333333
1777,5244,-994,8,7,15,53.33,0.0035533333333333307,81.06666666666666
1781,4515,-72545,11,19,30,36.67,-0.05203666666666667,29.566666666666666
1784,5476,11824,14,9,23,60.87,0.023234782608695652,20.08695652173913
1785,5480,22920,12,6,18,66.67,0.025433333333333336,35.77777777777778
1788,5368,25932,8,3,11,72.73,0.0426,85.72727272727273
1796,585,-8035,1,2,3,33.33,-0.036133333333333344,36.333333333333336
1799,1535,-2985,6,9,15,40.0,-0.01937333333333334,20.066666666666666
1813,2690,-9440,8,9,17,47.06,-0.01202941176470588,83.94117647058823
1815,2064,-10544,10,12,22,45.45,-0.022600000000000006,32.68181818181818
2035,2641,-19491,5,9,14,35.71,-0.040499999999999994,101.71428571428571
2061,1678,-18578,4,13,17,23.53,-0.05330588235294118,34.1764705882353
2063,2467,-5767,7,6,13,53.85,0.0018538461538461515,46.30769230769231
2064,854,-5404,3,6,9,33.33,-0.028966666666666665,85.66666666666667
2065,975,2625,2,2,4,50.0,0.0072,93.75
2066,1816,6084,2,2,4,50.0,0.034925,140.25
2067,807,-8287,1,8,9,11.11,-0.057300000000000004,28.333333333333332
2070,516,-6416,0,3,3,0.0,-0.07073333333333333,83.66666666666667
2221,1963,2137,9,7,16,56.25,0.02349375,46.9375
2230,552,-752,4,2,6,66.67,-0.0009166666666666675,27.0
2235,4586,3064,5,4,9,55.56,0.011099999999999999,83.44444444444444
2596,1189,-7039,4,6,10,40.0,-0.03132,73.9
2640,6361,31439,10,5,15,66.67,0.036059999999999995,61.2
2641,673,3037,5,4,9,55.56,0.017055555555555556,31.77777777777778
2643,2357,18793,6,2,8,75.0,0.051575,44.75
2718,794,-11544,2,4,6,33.33,-0.055366666666666654,62.5
2719,1315,3695,7,5,12,58.33,0.014899999999999998,37.916666666666664
2724,1637,-6297,4,6,10,40.0,-0.02186,49.5
2726,3143,-1293,5,5,10,50.0,0.014930000000000004,37.6
2729,15900,138600,9,2,11,81.82,0.05274545454545454,147.0
2732,8782,3618,8,6,14,57.14,0.011449999999999998,35.57142857142857
2734,1752,6348,5,4,9,55.56,0.025277777777777774,26.333333333333332
2736,943,-8543,3,5,8,37.5,-0.013587500000000002,30.25
2740,1553,-13903,4,4,8,50.0,-0.024812500000000005,28.875
2743,909,3091,6,2,8,75.0,0.05146250000000001,22.875
2745,1384,-1274,5,3,8,62.5,0.0018250000000000002,46.625
2752,3120,14380,3,1,4,75.0,0.036525,27.0
2754,1225,-4925,2,1,3,66.67,-0.022900000000000004,62.0
2755,306,-6806,0,1,1,0.0,-0.1188,5.0
2916,1527,-8677,5,9,14,35.71,-0.03807857142857143,80.5
2924,2085,-1535,4,3,7,57.14,0.0012857142857142828,66.42857142857143
2926,6334,-120734,1,9,10,10.0,-0.09501000000000001,127.9
2937,475,4875,2,1,3,66.67,0.042800000000000005,63.0
3064,7011,-36161,13,19,32,40.62,-0.01568125,23.71875
3066,1617,4063,10,10,20,50.0,0.046975,27.15
3067,993,-2643,2,5,7,28.57,-0.021400000000000006,24.0
3071,2392,-8372,11,18,29,37.93,-0.026182758620689653,28.896551724137932
3073,2243,-9923,10,12,22,45.45,-0.022340909090909092,18.90909090909091
3078,4510,-32930,13,22,35,37.14,-0.04298285714285714,32.94285714285714
3081,17871,158129,8,3,11,72.73,0.05413636363636364,14.090909090909092
3083,9463,-19663,14,12,26,53.85,0.006073076923076925,33.73076923076923
3085,3320,-20820,14,18,32,43.75,-0.010615624999999998,17.34375
3086,2458,-14618,12,14,26,46.15,-0.01633461538461539,21.884615384615383
3088,3760,-13910,9,9,18,50.0,-0.004388888888888888,83.5
3089,1855,-10045,11,11,22,50.0,-0.007672727272727273,13.272727272727273
3092,2717,-21467,8,11,19,42.11,-0.0374578947368421,32.68421052631579
3093,2396,21754,6,3,9,66.67,0.05867777777777778,123.0
3095,3510,16010,17,14,31,54.84,0.011970967741935483,12.709677419354838
3105,11026,50474,8,5,13,61.54,0.024076923076923072,20.23076923076923
3114,2420,-5840,10,14,24,41.67,-0.009133333333333334,36.666666666666664
3115,897,4113,6,5,11,54.55,0.02333636363636364,36.36363636363637
3118,1779,-11329,4,5,9,44.44,-0.026688888888888887,114.0
3122,469,81,3,2,5,60.0,0.002259999999999998,33.4
3128,2321,13359,14,9,23,60.87,0.03380434782608696,17.52173913043478
3131,17476,-90476,5,9,14,35.71,-0.03517142857142857,33.42857142857143
3141,2358,14192,7,3,10,70.0,0.04155,21.3
3147,1513,-8253,5,7,12,41.67,-0.020983333333333336,88.5
3152,26875,-179575,10,15,25,40.0,-0.021096,16.76
3162,2692,-7592,11,17,28,39.29,-0.024178571428571428,35.142857142857146
3163,3618,-22218,6,8,14,42.86,-0.021235714285714278,25.428571428571427
3169,4741,-36691,7,12,19,36.84,-0.03494736842105264,36.473684210526315
3171,1421,-1671,8,8,16,50.0,0.008162499999999996,56.1875
3176,5862,1938,9,9,18,50.0,0.009044444444444445,32.388888888888886
3178,2401,149,6,13,19,31.58,-0.049821052631578946,42.05263157894737
3188,4012,27658,21,10,31,67.74,0.03515806451612904,30.0
3191,3107,-14727,12,18,30,40.0,-0.019036666666666667,24.266666666666666
3202,0,0,0,0,0,0.0,,
3205,7001,-96141,10,13,23,43.48,0.0031043478260869527,23.565217391304348
3206,2627,10273,10,10,20,50.0,0.013699999999999995,48.3
3207,1093,-4163,5,10,15,33.33,-0.024953333333333334,24.8
3211,8128,14172,13,7,20,65.0,0.02267,58.65
3213,5504,13146,10,6,16,62.5,0.0088375,73.25
3217,4167,-16817,9,16,25,36.0,-0.039735999999999994,35.56
3218,7407,89193,17,7,24,70.83,0.045837499999999996,32.541666666666664
3219,3120,5610,7,8,15,46.67,-0.02666666666666667,13.666666666666666
3221,3035,-1285,11,9,20,55.0,0.002079999999999997,24.25
3224,3109,5711,11,8,19,57.89,0.003099999999999999,33.31578947368421
3226,3757,3503,8,10,18,44.44,-0.016505555555555555,54.333333333333336
3227,19819,-115819,10,15,25,40.0,-0.024367999999999997,20.64
3228,13783,-53233,12,12,24,50.0,-0.001995833333333331,17.25
3230,2630,-16310,12,16,28,42.86,-0.03192142857142858,27.5
3232,2254,15546,15,4,19,78.95,0.04758421052631578,12.105263157894736
3234,3789,-4189,11,9,20,55.0,0.002635000000000002,22.65
3236,2318,-1378,14,10,24,58.33,0.01365,27.875
3252,1545,-1595,7,7,14,50.0,0.0048928571428571415,38.92857142857143
3259,2780,-15330,6,13,19,31.58,-0.03668947368421053,29.31578947368421
3260,9163,-105563,9,22,31,29.03,-0.043500000000000004,23.516129032258064
3264,2098,17752,11,5,16,68.75,0.05485,42.75
3265,2319,-11489,9,8,17,52.94,-0.01672352941176471,33.76470588235294
3268,3685,-9055,12,13,25,48.0,-0.0030399999999999984,25.4
3272,5193,30957,11,7,18,61.11,0.029933333333333336,32.333333333333336
3276,1676,-336,12,10,22,54.55,0.009309090909090911,16.318181818181817
3284,1792,-2732,10,11,21,47.62,0.002652380952380954,43.333333333333336
3285,1515,7735,6,4,10,60.0,0.031740000000000004,21.5
3287,1402,808,9,7,16,56.25,-0.006068749999999998,28.3125
3288,3419,-16749,11,13,24,45.83,-0.018850000000000002,22.375
3289,7150,-51050,12,13,25,48.0,-0.024136,29.32
3290,1742,-7402,8,14,22,36.36,-0.02380909090909091,42.04545454545455
3293,20952,-49052,8,12,20,40.0,-0.032859999999999986,27.35
3294,2534,-6734,13,10,23,56.52,0.00374347826086956,29.782608695652176
3297,3708,-37788,10,14,24,41.67,-0.02559583333333333,27.75
3303,2756,4364,9,9,18,50.0,-0.00621666666666666,37.22222222222222
3306,4053,15897,13,9,22,59.09,0.026554545454545445,21.0
3310,1539,-7779,5,7,12,41.67,-0.011999999999999995,22.5
3313,3896,-2156,16,12,28,57.14,0.018785714285714284,30.25
3317,4919,10131,16,13,29,55.17,-0.004989655172413792,18.75862068965517
3322,1333,-73,9,10,19,47.37,0.007636842105263155,35.94736842105263
3323,3080,14270,12,4,16,75.0,0.036756250000000004,35.875
3324,11280,-41060,16,18,34,47.06,-0.01395,16.235294117647058
3325,3560,-22140,14,15,29,48.28,-0.015693103448275864,27.482758620689655
3332,1214,-18064,1,5,6,16.67,-0.07643333333333334,118.66666666666667
3339,3023,1647,11,14,25,44.0,-0.008944,19.4
3354,2425,-12065,12,10,22,54.55,-0.007563636363636366,16.454545454545453
3360,2707,-2127,15,15,30,50.0,-0.006646666666666664,24.3
3362,3583,2117,13,8,21,61.9,0.016257142857142855,13.285714285714286
3363,2763,10437,11,6,17,64.71,0.03840588235294118,40.529411764705884
3372,2349,-12239,17,18,35,48.57,-0.01744,25.857142857142858
3373,3149,-13999,8,10,18,44.44,-0.026338888888888894,60.55555555555556
3374,3521,23529,8,5,13,61.54,0.030384615384615385,14.153846153846153
3379,1849,2201,9,6,15,60.0,0.013600000000000001,44.86666666666667
3388,5557,-44357,4,8,12,33.33,-0.03605833333333334,133.66666666666666
3390,3532,26918,17,7,24,70.83,0.053625,38.416666666666664
3402,2367,-29067,5,12,17,29.41,-0.057417647058823525,30.764705882352942
3426,990,-20690,0,4,4,0.0,-0.11529999999999999,63.25
3434,863,207,5,6,11,45.45,-0.002345454545454547,14.181818181818182
3438,8171,-47071,10,13,23,43.48,-0.012691304347826084,49.17391304347826
3441,2650,-8400,8,8,16,50.0,-0.0108375,18.0625
3444,1348,2952,5,5,10,50.0,0.003500000000000002,37.7
3455,5119,-17469,12,13,25,48.0,-0.017580000000000002,17.64
3465,3157,-52707,2,8,10,20.0,-0.05978,17.5
3466,2536,-3286,8,9,17,47.06,-0.005388235294117646,53.1764705882353
3479,4113,-28463,6,9,15,40.0,-0.03156000000000001,72.6
3483,10472,-75972,13,23,36,36.11,-0.04329722222222223,27.305555555555557
3484,4108,-1858,9,10,19,47.37,-0.00903684210526316,54.421052631578945
3489,1703,-3133,9,7,16,56.25,-0.010375000000000002,40.5
3490,3536,-20236,10,9,19,52.63,-0.007431578947368421,19.05263157894737
3491,8449,-26049,12,9,21,57.14,-0.0037190476190476184,19.142857142857142
3492,1351,-6601,5,5,10,50.0,-0.01482,19.2
3498,6954,-37404,12,18,30,40.0,-0.02569333333333334,23.8
3499,2954,15286,13,7,20,65.0,0.028794999999999994,31.75
3508,6456,-31606,12,13,25,48.0,-0.007204000000000004,19.04
3511,3317,-16267,8,14,22,36.36,-0.020250000000000004,23.818181818181817
3512,1843,-8503,4,9,13,30.77,-0.036515384615384616,24.923076923076923
3516,1391,-491,11,7,18,61.11,0.0045222222222222235,44.05555555555556
3520,5259,12301,17,8,25,68.0,0.05724000000000001,16.92
3521,1815,-5665,7,8,15,46.67,-0.024419999999999994,28.933333333333334
3522,2733,-3703,12,10,22,54.55,0.008299999999999997,32.40909090909091
3523,5163,-46983,10,17,27,37.04,-0.0390037037037037,26.185185185185187
3526,5487,-7487,9,9,18,50.0,-0.016461111111111107,34.666666666666664
3527,11696,-4696,11,9,20,55.0,-0.0030199999999999975,25.45
3529,23448,140952,10,3,13,76.92,0.0515,14.692307692307692
3531,2298,-24598,6,11,17,35.29,-0.05705882352941177,67.41176470588235
3537,2255,-3855,7,8,15,46.67,-0.020846666666666666,36.93333333333333
3540,5417,-28767,15,17,32,46.88,-0.016512499999999996,28.59375
3541,10963,-62563,13,13,26,50.0,-0.012319230769230775,27.73076923076923
3546,14693,12457,15,14,29,51.72,0.006717241379310343,28.03448275862069
3548,4136,-16086,8,11,19,42.11,-0.027305263157894732,30.210526315789473
3551,3923,4177,10,7,17,58.82,0.01047058823529412,40.411764705882355
3552,14254,-86754,6,13,19,31.58,-0.04462631578947369,17.473684210526315
3555,1801,-31171,4,6,10,40.0,-0.05415,14.2
3556,6788,-39188,10,10,20,50.0,-0.020515,29.65
3558,8904,7196,7,6,13,53.85,0.012992307692307692,48.76923076923077
3564,3493,-11893,7,7,14,50.0,-0.008599999999999997,25.714285714285715
3567,1120,-300,5,5,10,50.0,-0.01117,58.1
3570,5121,10479,6,4,10,60.0,0.021849999999999998,47.1
3577,2674,4676,7,5,12,58.33,0.022000000000000002,39.916666666666664
3580,2173,-5673,7,10,17,41.18,-0.01244117647058824,23.941176470588236
3581,653,-7053,3,4,7,42.86,-0.04901428571428572,30.857142857142858
3587,6505,-47805,7,12,19,36.84,-0.03984736842105264,33.78947368421053
3594,1504,-5554,5,4,9,55.56,0.016222222222222218,51.333333333333336
3597,0,0,0,0,0,0.0,,
3609,1365,-4365,4,6,10,40.0,-0.009620000000000004,23.0
3611,17277,-47577,9,8,17,52.94,-0.0047470588235294115,45.35294117647059
3615,4751,-6651,12,11,23,52.17,-0.009965217391304347,24.73913043478261
3623,3314,-22704,6,12,18,33.33,-0.043922222222222224,39.77777777777778
3624,2325,-1875,7,9,16,43.75,-0.00786875,35.0
3625,1712,1988,8,9,17,47.06,-0.007335294117647058,25.88235294117647
3628,5332,-87032,5,8,13,38.46,-0.04263076923076924,68.3076923076923
3629,1966,15354,10,5,15,66.67,0.08201999999999998,18.533333333333335
3630,7662,-58712,12,12,24,50.0,-0.018175000000000004,22.25
3631,3237,-12687,8,8,16,50.0,-0.0034562500000000027,12.8125
3632,3100,-16190,9,12,21,42.86,-0.022128571428571428,22.904761904761905
3642,1997,6353,11,7,18,61.11,0.027472222222222224,37.166666666666664
3646,1295,1805,6,4,10,60.0,0.011609999999999999,27.4
3652,2180,-19680,6,11,17,35.29,-0.03894117647058823,50.88235294117647
3663,1610,13540,7,4,11,63.64,0.0631090909090909,36.63636363636363
3664,1222,-9452,6,7,13,46.15,-0.026615384615384614,32.0
3666,2752,-34802,7,11,18,38.89,-0.05237777777777777,24.055555555555557
3672,1664,2236,7,5,12,58.33,0.01884166666666667,33.666666666666664
3675,2655,8095,11,4,15,73.33,0.02555333333333333,33.333333333333336
3680,7193,-58043,6,8,14,42.86,-0.0073142857142857115,18.928571428571427
3684,2347,-1197,4,5,9,44.44,-0.00811111111111111,40.55555555555556
3685,4386,-1236,11,11,22,50.0,0.005436363636363636,25.272727272727273
3687,7526,16774,11,7,18,61.11,0.015099999999999995,22.38888888888889
3689,3278,2122,7,4,11,63.64,0.019881818181818188,50.81818181818182
3691,32165,-187365,10,10,20,50.0,0.0011400000000000028,17.75
3693,6760,-31260,10,8,18,55.56,-0.002127777777777776,22.944444444444443
3707,1508,-9708,5,5,10,50.0,0.01321,16.2
3709,514,-3914,2,2,4,50.0,-0.014374999999999995,114.0
3710,504,2536,6,2,8,75.0,0.0456375,20.0
3713,1091,959,3,2,5,60.0,0.0111,16.6
4102,2754,-14454,8,12,20,40.0,-0.027424999999999998,44.9
4105,10483,37567,15,10,25,60.0,0.015115999999999996,58.76
4107,7297,-55047,10,12,22,45.45,-0.019159090909090907,47.72727272727273
4109,3588,-4038,18,14,32,56.25,-0.0026999999999999993,59.375
4111,2462,-3062,11,10,21,52.38,-0.002171428571428573,56.04761904761905
4113,2339,10661,17,10,27,62.96,0.041548148148148153,50.18518518518518
4114,3633,15517,16,9,25,64.0,0.02588,48.84
4116,1790,4960,5,3,8,62.5,0.0247625,35.375
4120,7484,-39434,12,15,27,44.44,-0.03094074074074074,48.22222222222222
4121,3150,520,15,14,29,51.72,0.004748275862068965,28.0
4123,7078,-11928,14,12,26,53.85,-0.009200000000000002,44.69230769230769
4126,8824,-10724,12,13,25,48.0,-0.007332000000000003,45.4
4127,1698,-4148,10,8,18,55.56,0.004327777777777776,31.88888888888889
4128,4031,10719,15,7,22,68.18,0.0341590909090909,36.72727272727273
4129,4894,-25944,8,13,21,38.1,-0.023661904761904756,44.38095238095238
4130,3848,-11648,9,10,19,47.37,-0.00965263157894737,38.26315789473684
4131,2427,-21817,6,12,18,33.33,-0.03785,11.444444444444445
4138,5300,-10400,8,6,14,57.14,-5.714285714286076e-05,69.57142857142857
4139,4101,-47951,3,11,14,21.43,-0.056157142857142864,87.35714285714286
4147,10178,29922,8,4,12,66.67,0.03713333333333333,31.333333333333332
4153,3386,6764,7,6,13,53.85,0.009623076923076927,56.0
4154,2101,-6551,5,8,13,38.46,-0.01721538461538462,18.615384615384617
4157,1680,-1580,7,5,12,58.33,0.005574999999999999,26.333333333333332
4160,1115,985,4,3,7,57.14,0.015185714285714283,39.57142857142857
4161,2848,9202,5,3,8,62.5,0.026099999999999998,39.25
4162,11164,-22364,9,6,15,60.0,0.0024533333333333343,28.4
4163,13078,-25378,11,9,20,55.0,-0.003930000000000001,48.65
4167,1080,-13680,1,8,9,11.11,-0.07024444444444444,35.55555555555556
4168,5783,-26283,12,10,22,54.55,0.0005000000000000017,33.22727272727273
4171,3455,15195,3,5,8,37.5,0.004375000000000004,26.625
4173,2312,10838,11,4,15,73.33,0.03618,43.0
4174,15051,-99251,5,8,13,38.46,-0.01990769230769231,20.23076923076923
4175,1548,-2448,2,2,4,50.0,-0.006724999999999998,172.0
4183,324,3426,2,1,3,66.67,0.07346666666666667,102.0
4188,1004,-6104,3,4,7,42.86,-0.035957142857142854,69.71428571428571
4192,2306,1694,4,7,11,36.36,-0.007390909090909095,37.72727272727273
4198,1081,6449,6,4,10,60.0,0.05405,20.3
4205,3680,-1280,7,3,10,70.0,0.02905,96.3
4207,1402,-492,9,10,19,47.37,-0.004242105263157894,63.36842105263158
4303,1307,4933,10,7,17,58.82,0.02575882352941176,24.176470588235293
4304,1556,-2566,11,13,24,45.83,-0.010845833333333332,23.791666666666668
4305,1141,-1841,4,5,9,44.44,0.005811111111111112,140.66666666666666
4401,5253,-503,15,10,25,60.0,0.022056,34.72
4402,1151,2519,13,7,20,65.0,0.012829999999999998,10.6
4406,241,-171,2,2,4,50.0,0.002400000000000003,66.75
4413,1157,2283,10,8,18,55.56,0.050499999999999996,10.38888888888889
4416,2943,2007,4,3,7,57.14,0.018685714285714285,39.142857142857146
4417,3110,1390,12,10,22,54.55,0.007886363636363636,89.27272727272727
4419,829,7801,5,3,8,62.5,0.05727499999999999,17.25
4420,2511,11339,11,7,18,61.11,0.032188888888888885,97.94444444444444
4430,2303,19647,10,2,12,83.33,0.060916666666666675,69.58333333333333
4432,4312,-17962,7,9,16,43.75,-0.0199125,34.6875
4433,1836,18064,7,3,10,70.0,0.06824,35.3
4502,3341,3789,13,6,19,68.42,0.03867368421052632,22.94736842105263
4503,2052,-6952,10,9,19,52.63,0.008247368421052633,21.36842105263158
4506,2195,13345,10,7,17,58.82,0.009829411764705883,90.0
4510,1778,-6548,10,11,21,47.62,-0.010238095238095239,55.57142857142857
4513,1401,1739,10,8,18,55.56,0.013049999999999997,50.94444444444444
4523,5337,17123,19,12,31,61.29,0.019664516129032257,35.193548387096776
4527,1984,-10284,7,9,16,43.75,-0.01553125,148.375
4528,5327,6563,16,13,29,55.17,0.02287241379310345,47.48275862068966
4529,2626,4694,14,11,25,56.0,0.004499999999999997,31.6
4530,1441,-9541,7,13,20,35.0,-0.033870000000000004,16.6
4533,2058,-4628,13,10,23,56.52,0.0035086956521739126,59.17391304347826
4534,2341,-1301,12,14,26,46.15,-0.024576923076923076,25.76923076923077
4535,5906,-27156,10,14,24,41.67,-0.018691666666666665,92.875
4538,541,3789,3,3,6,50.0,0.03261666666666666,170.66666666666666
4541,1956,13844,8,3,11,72.73,0.049045454545454545,52.54545454545455
4542,596,6054,2,1,3,66.67,0.04136666666666667,28.666666666666668
4543,297,4503,3,0,3,100.0,0.10273333333333334,46.666666666666664
4549,6137,-18037,7,5,12,58.33,-0.0003749999999999969,30.5
4550,742,-1792,2,4,6,33.33,-0.017900000000000003,124.0
4554,1928,-4628,4,7,11,36.36,-0.019690909090909082,26.90909090909091
4556,1127,-2677,3,3,6,50.0,-0.01193333333333333,137.83333333333334
4561,667,8733,3,1,4,75.0,0.116375,60.0
4563,2670,11070,6,4,10,60.0,0.02778,55.7
4568,1021,4379,2,1,3,66.67,0.02936666666666667,86.66666666666667
4580,503,7697,1,0,1,100.0,0.0965,25.0
4609,1399,3021,9,11,20,45.0,0.008830000000000001,26.45
4702,1962,-5052,12,15,27,44.44,-0.015411111111111117,22.88888888888889
4706,903,-4173,4,6,10,40.0,-0.015139999999999997,176.8
4707,2097,1583,10,11,21,47.62,-0.013728571428571427,30.095238095238095
4711,1580,1120,9,8,17,52.94,0.009194117647058821,107.3529411764706
4712,3265,-1405,13,16,29,44.83,-0.005655172413793105,21.586206896551722
4714,2087,-6117,13,14,27,48.15,-0.013662962962962962,36.03703703703704
4716,3443,21027,24,9,33,72.73,0.041460606060606066,25.545454545454547
4721,5489,8011,14,11,25,56.0,0.001320000000000004,34.88
4726,2210,-9910,6,6,12,50.0,-0.011050000000000004,35.25
4728,4296,8154,8,6,14,57.14,0.01792857142857143,30.357142857142858
4729,1893,4807,12,9,21,57.14,0.016195238095238092,32.333333333333336
4735,2501,-14701,5,4,9,55.56,-0.005011111111111111,25.444444444444443
4736,8680,3020,9,8,17,52.94,-0.00243529411764706,34.294117647058826
4741,5656,-16596,7,8,15,46.67,-0.005446666666666665,69.8
4743,9634,-48134,11,12,23,47.83,-0.027839130434782602,25.73913043478261
4744,4619,-10269,7,13,20,35.0,-0.03311000000000001,40.15
4745,5562,-43362,4,11,15,26.67,-0.04889333333333333,79.4
4747,2082,-22632,3,5,8,37.5,-0.04945,147.0
4754,1516,9984,5,1,6,83.33,0.04538333333333333,70.0
4760,2065,-6365,4,3,7,57.14,-0.0047571428571428565,43.142857142857146
4767,268,4832,2,0,2,100.0,0.11529999999999999,96.5
4804,3492,-28122,6,10,16,37.5,-0.026325,29.25
4806,1288,-11978,3,4,7,42.86,-0.007314285714285713,23.285714285714285
4903,2349,-4849,16,15,31,51.61,0.008551612903225808,18.806451612903224
4905,3664,-104,12,8,20,60.0,0.031584999999999995,56.6
4907,1561,2969,14,6,20,70.0,0.01997,33.75
4908,3719,11881,17,9,26,65.38,0.027865384615384608,28.26923076923077
4909,7120,-41220,18,21,39,46.15,-0.024587179487179485,40.02564102564103
4911,4668,-15318,7,8,15,46.67,0.00242,44.93333333333333
4924,1253,-8163,5,6,11,45.45,-0.031327272727272724,66.0909090909091
4931,1032,-4192,4,5,9,44.44,0.22800000000000006,162.88888888888889
4933,5700,-46200,10,12,22,45.45,-0.016440909090909093,40.5
4939,1566,-5596,6,10,16,37.5,-0.01194375,36.875
4944,1803,2517,9,9,18,50.0,0.014161111111111112,18.77777777777778
4945,0,0,0,0,0,0.0,,
4946,5043,-31893,9,8,17,52.94,0.0013705882352941178,33.94117647058823
4950,1358,-1598,6,8,14,42.86,0.017285714285714283,26.357142857142858
4953,2160,-3110,6,2,8,75.0,0.024737500000000006,42.625
4966,30959,-374959,4,6,10,40.0,-0.031199999999999995,18.2
4971,5302,-14052,7,7,14,50.0,-0.011464285714285713,23.857142857142858
4972,1572,4278,5,3,8,62.5,0.0261875,112.75
4973,2432,968,9,8,17,52.94,-0.003970588235294115,32.88235294117647
4974,2584,21366,8,3,11,72.73,0.04741818181818181,34.90909090909091
4979,3689,-5389,11,8,19,57.89,-0.012105263157894735,16.42105263157895
4987,4365,-14065,5,6,11,45.45,-0.00982727272727273,143.8181818181818
4991,4906,1044,9,7,16,56.25,0.003493750000000004,29.1875
4995,1677,14673,6,2,8,75.0,0.05982499999999999,74.125
5009,3647,-8717,14,12,26,53.85,0.00284615384615385,28.26923076923077
5011,1235,-85,5,4,9,55.56,0.0159,23.0
5013,1639,-10239,6,10,16,37.5,-0.04,62.3125
5014,2268,3342,16,12,28,57.14,0.01718571428571428,35.857142857142854
5015,2662,13338,13,5,18,72.22,0.037466666666666676,67.16666666666667
5016,2693,-12743,8,9,17,47.06,-0.016852941176470588,92.94117647058823
5102,891,59,7,3,10,70.0,0.018379999999999997,72.0
5201,2483,2617,12,11,23,52.17,0.02069565217391304,19.782608695652176
5202,1746,3734,14,8,22,63.64,0.02368636363636363,30.40909090909091
5205,1838,-10828,6,10,16,37.5,-0.028862499999999996,18.6875
5206,1408,-3488,9,11,20,45.0,-0.017125,68.0
5209,3732,6268,7,9,16,43.75,-0.015131250000000002,83.375
5210,1646,-3666,14,10,24,58.33,0.0022625000000000006,27.25
5211,3566,-19616,10,13,23,43.48,-0.0265304347826087,32.26086956521739
5212,2174,-3774,6,10,16,37.5,-0.0029312500000000016,39.5
5213,2137,-4027,10,11,21,47.62,-0.012133333333333324,57.19047619047619
5220,1451,59,6,3,9,66.67,0.011922222222222218,54.55555555555556
5223,1659,-26559,2,5,7,28.57,-0.06535714285714286,19.714285714285715
5227,2122,-4222,6,6,12,50.0,0.0019416666666666668,11.75
5230,4393,-11043,8,10,18,44.44,-0.01005,59.44444444444444
5245,3835,-19385,5,5,10,50.0,-0.0031800000000000023,33.4
5251,1601,-15401,4,5,9,44.44,-0.020044444444444445,47.111111111111114
5263,14428,95072,8,3,11,72.73,0.051918181818181815,20.90909090909091
5272,3424,-14524,8,9,17,47.06,-0.008141176470588237,21.294117647058822
5274,16497,260003,6,1,7,85.71,0.08347142857142857,15.142857142857142
5276,724,-334,4,3,7,57.14,-0.020800000000000006,58.714285714285715
5278,6570,36580,8,5,13,61.54,0.014730769230769226,19.923076923076923
5281,701,-5901,2,1,3,66.67,-0.001666666666666667,18.666666666666668
5287,16674,2826,6,5,11,54.55,0.008400000000000001,59.81818181818182
5289,5748,48952,6,2,8,75.0,0.0424375,55.5
5291,948,1102,3,4,7,42.86,0.030928571428571427,19.285714285714285
5299,1579,10881,6,3,9,66.67,0.02802222222222222,34.333333333333336
5301,2480,6580,11,12,23,47.83,-0.0026478260869565234,16.0
5302,2301,159,16,13,29,55.17,0.014286206896551724,20.517241379310345
5306,10076,-18046,14,15,29,48.28,-0.01763793103448276,40.86206896551724
5309,2227,4983,16,13,29,55.17,0.011531034482758622,20.310344827586206
5310,4929,23891,17,15,32,53.12,0.044846875,22.75
5312,5648,-9748,10,7,17,58.82,0.006135294117647057,91.88235294117646
5314,1685,-2995,14,13,27,51.85,-0.01271851851851852,19.925925925925927
5315,2017,-6447,14,14,28,50.0,-0.0014035714285714272,25.535714285714285
5321,1505,1735,9,12,21,42.86,-0.024219047619047623,13.095238095238095
5324,1772,-4982,12,12,24,50.0,-0.004958333333333331,29.791666666666668
5328,2291,-6121,17,20,37,45.95,-0.01770810810810811,27.43243243243243
5340,3039,-5879,18,16,34,52.94,0.009841176470588237,29.176470588235293
5344,1164,-2174,8,9,17,47.06,-0.01161764705882353,16.58823529411765
5345,1356,1044,12,11,23,52.17,0.016108695652173908,16.652173913043477
5347,4464,9446,11,10,21,52.38,0.011714285714285714,19.476190476190474
5348,1433,-653,9,6,15,60.0,0.01876,13.733333333333333
5351,2606,-10926,14,13,27,51.85,-0.004933333333333342,26.0
5353,1657,793,13,9,22,59.09,0.012209090909090909,25.136363636363637
5355,2348,-7438,14,19,33,42.42,-0.023048484848484842,30.575757575757574
5356,4857,-29657,17,18,35,48.57,-0.019905714285714287,45.0
5364,914,-6194,7,4,11,63.64,0.020745454545454543,14.272727272727273
5371,4286,-3086,11,10,21,52.38,-0.0005238095238095236,35.95238095238095
5381,2109,-6919,17,22,39,43.59,-0.02951538461538461,15.897435897435898
5383,2684,10396,21,11,32,65.62,0.024268750000000006,28.5625
5386,2567,14353,12,8,20,60.0,0.021679999999999998,15.0
5392,12278,53682,20,10,30,66.67,0.03515000000000001,31.766666666666666
5398,3221,12449,16,10,26,61.54,0.04181153846153847,15.923076923076923
5403,3559,23841,15,11,26,57.69,0.021730769230769227,56.03846153846154
5410,1892,8728,15,6,21,71.43,0.044819047619047626,52.95238095238095
5425,4226,-20096,15,14,29,51.72,-0.014934482758620691,18.79310344827586
5426,1959,-13519,11,13,24,45.83,-0.031225000000000003,48.916666666666664
5432,1189,-2549,8,9,17,47.06,-0.023664705882352945,23.11764705882353
5438,5001,-33951,11,21,32,34.38,-0.038425,38.0
5439,3778,-11578,13,14,27,48.15,-0.005981481481481483,37.48148148148148
5443,2451,-8751,12,13,25,48.0,-0.008104,20.76
5450,3130,-11180,15,15,30,50.0,-0.016499999999999997,35.0
5452,2725,-95,19,11,30,63.33,0.027816666666666667,32.6
5455,1863,-543,14,13,27,51.85,-0.0014148148148148145,8.962962962962964
5457,3574,-8184,14,16,30,46.67,-0.021833333333333326,21.6
5460,2212,7268,15,10,25,60.0,0.018244000000000003,59.88
5464,3290,9010,15,10,25,60.0,0.007459999999999999,44.76
5465,1691,7849,14,8,22,63.64,0.054409090909090914,31.954545454545453
5468,1276,6614,10,8,18,55.56,0.020727777777777776,12.722222222222221
5474,8999,-5129,19,13,32,59.38,0.02425625,20.84375
5475,2269,-10159,13,18,31,41.94,-0.03191612903225807,24.838709677419356
5478,13582,-29982,15,18,33,45.45,-0.012212121212121209,19.87878787878788
5481,3075,2635,17,15,32,53.12,-0.0016000000000000007,28.5
5483,13186,75464,22,8,30,73.33,0.04767666666666665,20.1
5487,2315,8625,9,9,18,50.0,0.00760555555555555,31.61111111111111
5488,2508,-13848,12,16,28,42.86,-0.03300357142857143,24.857142857142858
5489,4557,-19607,9,12,21,42.86,-0.012880952380952382,74.76190476190476
5490,7958,-22258,17,19,36,47.22,-0.009330555555555555,22.666666666666668
5493,2446,16354,13,5,18,72.22,0.04345555555555555,56.666666666666664
5498,2015,4465,17,11,28,60.71,0.014678571428571435,26.5
5508,5149,-28099,10,12,22,45.45,-0.015990909090909097,70.9090909090909
5511,2205,9995,15,3,18,83.33,0.033544444444444446,71.11111111111111
5512,2116,-4206,15,13,28,53.57,-0.004517857142857145,46.142857142857146
5514,1401,-191,8,8,16,50.0,-0.0028312500000000004,30.875
5516,621,-2461,4,4,8,50.0,-0.013437500000000003,60.625
5520,769,-2529,3,4,7,42.86,-0.00757142857142857,72.57142857142857
5523,2058,13782,16,8,24,66.67,0.053554166666666674,27.0
5529,1876,-3396,10,11,21,47.62,0.02766666666666666,26.0
5530,5863,14187,10,9,19,52.63,0.008557894736842103,106.47368421052632
5536,10367,75933,9,4,13,69.23,0.043423076923076925,57.46153846153846
5543,693,4607,1,1,2,50.0,0.044050000000000006,73.5
5601,372,1528,3,1,4,75.0,0.059725,141.25
5603,1633,-10513,8,14,22,36.36,-0.025422727272727277,79.04545454545455
5604,2575,-11075,4,8,12,33.33,-0.027975,122.08333333333333
5609,3049,25101,15,6,21,71.43,0.04877619047619047,76.38095238095238
5701,1852,-212,14,16,30,46.67,-0.006906666666666669,37.7
5703,1386,3914,8,3,11,72.73,0.025745454545454547,44.0
5704,0,0,0,0,0,0.0,,
5820,1480,3120,14,9,23,60.87,0.02666086956521739,78.47826086956522
5864,468,-4088,2,5,7,28.57,-0.0708142857142857,97.14285714285714
5878,815,12235,3,0,3,100.0,0.09493333333333333,195.33333333333334
5902,1431,-1331,9,10,19,47.37,-0.014678947368421055,33.05263157894737
5903,11554,54696,9,4,13,69.23,0.03456923076923077,99.6923076923077
5904,30615,-65665,14,15,29,48.28,-0.008924137931034484,55.03448275862069
5905,2236,-4996,11,15,26,42.31,-0.017103846153846154,47.26923076923077
6015,1955,1825,19,12,31,61.29,0.020300000000000002,35.16129032258065
6016,1701,7169,17,9,26,65.38,0.033546153846153844,54.69230769230769
6020,1605,1595,9,8,17,52.94,0.014423529411764707,94.6470588235294
6021,0,0,0,0,0,0.0,,
6023,3087,12513,8,5,13,61.54,0.028615384615384612,180.23076923076923
6026,283,1437,3,1,4,75.0,0.0335,58.5
6101,3195,-25995,13,20,33,39.39,-0.032587878787878784,16.333333333333332
6103,2784,-20094,7,11,18,38.89,-0.030322222222222226,16.666666666666668
6104,7566,-1416,18,16,34,52.94,-0.005908823529411765,21.205882352941178
6109,1619,6521,14,8,22,63.64,0.026336363636363633,32.31818181818182
6111,5494,39046,15,5,20,75.0,0.054310000000000004,21.55
6113,2029,-13209,12,17,29,41.38,-0.031400000000000004,33.6551724137931
6114,3271,-21761,10,11,21,47.62,-0.008023809523809523,39.95238095238095
6118,2090,9400,15,10,25,60.0,0.033228,16.68
6121,16893,-78093,10,10,20,50.0,-0.007605000000000003,30.85
6122,2128,-1568,14,14,28,50.0,0.0007857142857142844,42.57142857142857
6123,3413,57,13,7,20,65.0,0.027365,31.05
6124,3017,-23917,9,11,20,45.0,-0.035905,24.65
6125,3431,-13981,14,15,29,48.28,-0.010299999999999995,37.689655172413794
6126,4167,-16017,12,18,30,40.0,-0.023206666666666667,28.566666666666666
6127,2551,-9611,13,18,31,41.94,-0.013525806451612903,19.516129032258064
6129,4352,-32122,16,20,36,44.44,-0.03068888888888889,20.22222222222222
6130,5087,-24617,11,12,23,47.83,-0.004239130434782604,14.521739130434783
6134,5861,-35081,20,22,42,47.62,-0.01838095238095238,30.857142857142858
6138,5349,7151,14,11,25,56.0,0.009156,23.92
6140,1153,1787,11,5,16,68.75,0.011725,30.875
6143,8739,-11239,22,17,39,56.41,0.0070025641025641015,25.82051282051282
6144,641,699,5,4,9,55.56,0.03147777777777778,15.0
6146,12172,32828,11,8,19,57.89,0.012726315789473685,86.63157894736842
6147,5814,22676,17,10,27,62.96,0.008777777777777777,22.962962962962962
6148,1739,-939,13,13,26,50.0,-0.014557692307692306,23.615384615384617
6150,7079,14831,14,18,32,43.75,-0.006915625000000002,16.875
6151,3225,-5215,12,14,26,46.15,-0.013576923076923073,67.26923076923077
6154,4380,-33630,9,15,24,37.5,-0.027579166666666665,109.25
6156,2124,6066,13,9,22,59.09,0.016700000000000003,20.863636363636363
6158,5948,-16598,15,17,32,46.88,-0.023734374999999995,32.125
6160,5629,2921,17,15,32,53.12,0.0020125000000000004,45.625
6161,2366,-4246,14,13,27,51.85,-0.006214814814814817,25.74074074074074
6163,2414,-1184,14,13,27,51.85,-0.0036222222222222207,43.48148148148148
6167,1890,-4270,15,12,27,55.56,-0.010207407407407408,21.074074074074073
6169,3718,-24618,9,14,23,39.13,-0.020452173913043478,18.347826086956523
6170,3799,-35619,14,15,29,48.28,-0.014558620689655168,34.793103448275865
6171,1371,3869,10,7,17,58.82,0.0188,38.588235294117645
6173,3495,-18315,12,17,29,41.38,-0.017934482758620685,23.20689655172414
6174,1705,-11595,6,13,19,31.58,-0.03088421052631579,37.8421052631579
6175,3077,-19137,10,19,29,34.48,-0.03553103448275863,38.03448275862069
6179,3711,17169,18,8,26,69.23,0.03713076923076923,47.42307692307692
6180,7119,14481,17,12,29,58.62,0.0011965517241379342,41.793103448275865
6182,7075,-19955,17,16,33,51.52,-0.017545454545454545,12.06060606060606
6185,3826,-33376,11,17,28,39.29,-0.03168214285714286,51.57142857142857
6186,3679,-6419,17,16,33,51.52,-0.0032727272727272726,27.606060606060606
6187,6262,-54762,12,20,32,37.5,-0.036375,21.90625
6188,8077,-36327,19,16,35,54.29,0.007562857142857139,33.65714285714286
6190,2386,-17256,11,21,32,34.38,-0.03799375,37.6875
6194,4365,-27765,9,16,25,36.0,-0.026892,69.28
6195,6422,-69082,6,21,27,22.22,-0.057874074074074085,46.851851851851855
6198,1780,-750,9,6,15,60.0,0.014453333333333334,33.4
6199,1961,-8361,10,11,21,47.62,-0.019490476190476187,24.333333333333332
6203,6284,-23434,9,12,21,42.86,-0.025490476190476192,34.666666666666664
6204,4737,12713,14,10,24,58.33,0.0121625,55.791666666666664
6207,4606,-1206,13,13,26,50.0,-0.004792307692307692,44.0
6208,2196,7264,11,6,17,64.71,0.02825882352941177,38.11764705882353
6210,4632,-24882,11,13,24,45.83,-0.003087499999999997,39.583333333333336
6212,944,6236,7,4,11,63.64,0.02161818181818182,12.727272727272727
6217,4232,-15232,11,17,28,39.29,-0.032946428571428564,24.464285714285715
6218,2530,7320,12,8,20,60.0,0.021554999999999998,40.7
6219,1370,860,10,8,18,55.56,0.005861111111111115,20.944444444444443
6220,4784,-6814,19,20,39,48.72,-0.005641025641025639,33.07692307692308
6221,2738,-14688,10,11,21,47.62,-0.024590476190476194,32.714285714285715
6222,1942,-4722,13,12,25,52.0,-0.006300000000000003,15.64
6223,11424,-42124,14,14,28,50.0,-0.008482142857142856,33.714285714285715
6227,3742,11658,20,9,29,68.97,0.023362068965517246,44.86206896551724
6228,1656,-5916,9,15,24,37.5,-0.024574999999999996,17.625
6229,2926,13594,17,9,26,65.38,0.03377307692307692,25.26923076923077
6231,7753,-9153,11,13,24,45.83,-0.01498333333333333,14.416666666666666
6233,3884,-50334,16,12,28,57.14,0.005778571428571432,20.571428571428573
6234,5895,-19045,14,16,30,46.67,-0.015336666666666662,41.9
6236,1941,-10971,8,13,21,38.1,-0.020257142857142856,13.428571428571429
6237,8397,-447,18,12,30,60.0,0.012633333333333338,25.433333333333334
6240,1776,20204,12,4,16,75.0,0.07044375,11.25
6241,2133,8527,15,7,22,68.18,0.13140909090909092,39.90909090909091
6242,1956,-20076,5,10,15,33.33,-0.04364,25.066666666666666
6244,19212,-24522,22,16,38,57.89,-8.684210526315454e-05,27.36842105263158
6245,5772,29178,20,11,31,64.52,0.02284516129032258,24.032258064516128
6246,3042,-5822,15,19,34,44.12,-0.013376470588235297,26.323529411764707
6247,1719,-16999,6,13,19,31.58,-0.039747368421052635,92.0
6248,2535,5555,14,13,27,51.85,0.010966666666666668,21.40740740740741
6259,1950,-4680,10,11,21,47.62,-0.004790476190476186,15.571428571428571
6261,7787,25113,14,9,23,60.87,0.028669565217391307,57.47826086956522
6263,5949,19001,13,11,24,54.17,0.004225,64.70833333333333
6264,2780,-31650,9,14,23,39.13,-0.03780869565217391,25.347826086956523
6265,1565,625,11,9,20,55.0,0.0015050000000000016,32.4
6266,1548,-5238,9,10,19,47.37,-0.017410526315789474,29.05263157894737
6270,2998,-7348,11,14,25,44.0,-0.015108000000000002,40.44
6274,6323,25697,18,11,29,62.07,0.01089655172413793,27.24137931034483
6275,1403,-4453,7,8,15,46.67,-0.015053333333333333,27.466666666666665
6276,1440,-6870,6,11,17,35.29,-0.026935294117647057,20.0
6279,10775,-18825,12,14,26,46.15,-0.008984615384615386,49.96153846153846
6284,5738,-7488,17,12,29,58.62,0.005217241379310346,22.20689655172414
6287,1478,2892,12,13,25,48.0,0.030648000000000005,15.96
6290,4034,-38784,8,16,24,33.33,-0.052866666666666666,28.708333333333332
6291,2063,2357,11,10,21,52.38,0.01203809523809524,15.619047619047619
6292,2460,-2710,9,7,16,56.25,0.0020937499999999967,81.8125
6294,5249,-34919,9,13,22,40.91,-0.035540909090909095,35.95454545454545
6404,2786,-50656,4,10,14,28.57,-0.049300000000000004,17.714285714285715
6411,2429,-34779,2,2,4,50.0,-0.009925,11.0
6417,976,15724,4,0,4,100.0,0.10685,86.0
6418,1130,3700,7,4,11,63.64,0.026000000000000002,62.27272727272727
6419,804,-11414,2,5,7,28.57,-0.06227142857142857,41.714285714285715
6425,1799,8611,6,2,8,75.0,0.034749999999999996,16.5
6426,6559,-19609,8,8,16,50.0,0.0064437500000000016,14.8125
6432,1225,-7725,3,5,8,37.5,-0.0333,26.5
6435,2423,33077,4,0,4,100.0,0.085425,10.75
6441,2883,-33963,3,5,8,37.5,-0.055262500000000006,13.125
6446,3244,53356,5,0,5,100.0,0.10788,24.6
6457,1566,8934,4,2,6,66.67,0.0197,135.5
6461,2137,-6857,6,5,11,54.55,0.00918181818181818,31.90909090909091
6462,8686,35714,7,3,10,70.0,0.02416,25.6
6465,1441,5759,4,3,7,57.14,0.05482857142857143,25.285714285714285
6469,2185,2415,3,2,5,60.0,0.015020000000000002,77.6
6470,2472,-22022,4,6,10,40.0,-0.04574,53.9
6472,3059,12841,3,1,4,75.0,0.043750000000000004,56.5
6482,954,19246,3,0,3,100.0,0.13956666666666667,23.0
6485,3022,-35872,4,7,11,36.36,-0.04246363636363638,41.09090909090909
6486,1680,7470,3,2,5,60.0,0.02362,37.2
6488,9885,-44885,4,1,5,80.0,0.025139999999999996,22.2
6492,3893,21607,4,3,7,57.14,0.029385714285714286,51.42857142857143
6494,1777,-10177,3,3,6,50.0,0.014049999999999998,44.666666666666664
6496,2212,12088,6,2,8,75.0,0.0457125,49.625
6499,2560,-3960,3,3,6,50.0,0.011733333333333333,24.5
6506,976,-576,5,5,10,50.0,-0.005389999999999997,132.9
6508,3330,-130,12,9,21,57.14,0.003561904761904766,88.71428571428571
6509,2684,-2284,13,8,21,61.9,0.013485714285714287,35.285714285714285
6510,38477,94523,4,5,9,44.44,0.013477777777777776,22.444444444444443
6512,965,-11265,1,5,6,16.67,-0.07688333333333335,38.666666666666664
6514,2551,-301,5,5,10,50.0,0.005259999999999998,37.6
6516,3058,28242,3,1,4,75.0,0.049825,64.5
6523,2559,-17759,2,2,4,50.0,0.015449999999999995,62.25
6527,1401,-9651,2,3,5,40.0,-0.032100000000000004,91.4
6530,291,4869,3,0,3,100.0,0.111,93.33333333333333
6532,1425,19475,5,1,6,83.33,0.10701666666666665,34.666666666666664
6535,1109,3041,4,2,6,66.67,0.027783333333333337,68.66666666666667
6538,4311,4689,3,4,7,42.86,-0.014614285714285717,37.57142857142857
6542,2833,32917,6,2,8,75.0,0.0780625,23.125
6547,2952,-10002,1,3,4,25.0,0.023825,73.25
6548,6015,-124215,2,3,5,40.0,-0.039259999999999996,19.8
6556,520,-1360,1,1,2,50.0,-0.01525,115.0
6560,2251,-37001,0,8,8,0.0,-0.0912125,27.625
6561,6191,-60191,1,3,4,25.0,-0.052375,83.5
6568,8627,-130627,3,7,10,30.0,-0.06191,14.3
6569,4130,-12130,2,3,5,40.0,-0.011659999999999993,52.2
6570,1343,-7853,3,4,7,42.86,-0.029557142857142855,43.285714285714285
6574,811,11189,1,0,1,100.0,0.0864,11.0
6576,3982,10298,6,4,10,60.0,0.01865,36.8
6577,2143,-4843,3,3,6,50.0,-0.01120000000000001,64.0
6578,763,5887,3,3,6,50.0,0.04583333333333334,84.16666666666667
6588,665,-4215,1,1,2,50.0,-0.01815,48.0
6589,2081,-351,3,4,7,42.86,-0.020614285714285713,146.0
6590,173,3827,1,0,1,100.0,0.1444,62.0
6593,526,3074,2,1,3,66.67,0.04303333333333333,97.66666666666667
6594,610,2190,3,1,4,75.0,0.028825000000000003,15.5
6596,1499,9401,3,2,5,60.0,0.041620000000000004,76.6
6603,1604,-4014,9,11,20,45.0,-0.014100000000000001,47.75
6609,3026,-13826,9,10,19,47.37,-0.014715789473684212,58.473684210526315
6612,711,12689,2,0,2,100.0,0.11474999999999999,13.5
6613,4352,-17852,2,3,5,40.0,-0.01912,98.6
6615,1849,-36449,0,4,4,0.0,-0.105625,64.75
6616,701,-571,3,3,6,50.0,-0.0045,41.666666666666664
6624,401,4349,2,0,2,100.0,0.0669,15.5
6629,966,1834,2,1,3,66.67,0.019566666666666666,60.666666666666664
6640,460,-2910,1,1,2,50.0,-0.039549999999999995,33.0
6642,347,-7247,0,1,1,0.0,-0.1124,46.0
6643,3100,42400,2,0,2,100.0,0.08524999999999999,15.5
6649,656,1844,3,1,4,75.0,0.0322,19.5
6651,491,-7291,0,1,1,0.0,-0.0817,50.0
6654,1424,-17024,1,3,4,25.0,-0.072075,42.0
6661,0,0,0,0,0,0.0,,
6662,198,2052,1,0,1,100.0,0.0642,61.0
6664,1057,14243,3,0,3,100.0,0.08483333333333333,71.33333333333333
6667,880,-180,1,2,3,33.33,0.03253333333333334,21.666666666666668
6679,4246,7254,2,1,3,66.67,0.03149999999999999,14.333333333333334
6680,294,1506,1,0,1,100.0,0.0307,221.0
6683,4160,36340,2,1,3,66.67,0.08929999999999999,14.666666666666666
6690,1959,-13459,1,2,3,33.33,-0.034633333333333335,58.333333333333336
6697,874,376,2,2,4,50.0,0.008499999999999999,90.5
6703,550,-9150,0,1,1,0.0,-0.091,83.0
6712,2986,-35486,0,2,2,0.0,-0.05165,13.5
6716,0,0,0,0,0,0.0,,
6727,392,-1692,0,1,1,0.0,-0.025,2.0
6728,849,-3349,0,1,1,0.0,-0.0228,2.0
6732,11518,105982,3,1,4,75.0,0.0418,16.5
6733,276,-4026,0,2,2,0.0,-0.077,43.5
6747,4447,-76947,0,3,3,0.0,-0.09006666666666667,48.0
6751,339,1261,1,0,1,100.0,0.0222,27.0
6752,326,1074,1,0,1,100.0,0.0197,155.0
6762,0,0,0,0,0,0.0,,
6767,372,6078,2,0,2,100.0,0.1036,113.0
6803,7117,83383,6,1,7,85.71,0.0746,235.85714285714286
7402,2443,-11843,4,5,9,44.44,-0.025344444444444447,37.22222222222222
7556,1349,-24349,0,2,2,0.0,-0.0957,24.5
8024,2632,6388,12,9,21,57.14,0.007466666666666664,35.80952380952381
8027,2272,-7572,7,5,12,58.33,-0.004308333333333335,32.416666666666664
8032,1844,-794,7,7,14,50.0,-0.002907142857142859,86.21428571428571
8034,2085,215,14,15,29,48.28,-0.006368965517241378,23.344827586206897
8038,4088,14662,10,6,16,62.5,0.029775,28.6875
8040,3814,-35644,9,16,25,36.0,-0.037967999999999995,16.04
8042,4663,-10963,11,13,24,45.83,-0.009883333333333329,50.0
8043,3726,-6396,13,14,27,48.15,-0.010562962962962961,51.03703703703704
8044,18213,31537,14,8,22,63.64,0.02863181818181818,17.90909090909091
8047,793,-14643,3,4,7,42.86,-0.056528571428571435,29.142857142857142
8048,1759,-3809,5,6,11,45.45,-0.004672727272727274,36.54545454545455
8049,2338,3912,17,10,27,62.96,0.02248148148148148,25.444444444444443
8050,7272,2478,13,12,25,52.0,0.011280000000000002,47.36
8054,6060,-30860,10,14,24,41.67,-0.023337500000000008,44.416666666666664
8059,1739,-2269,12,10,22,54.55,0.005936363636363636,29.363636363636363
8064,1890,-8700,8,9,17,47.06,-0.008929411764705882,22.823529411764707
8066,7106,-15026,14,10,24,58.33,0.008516666666666667,26.0
8067,960,-2870,6,7,13,46.15,-0.01939230769230769,27.53846153846154
8068,4911,19919,12,13,25,48.0,0.012787999999999997,10.68
8069,4731,-17681,13,15,28,46.43,-0.018921428571428568,18.285714285714285
8071,2805,8565,19,9,28,67.86,0.03363571428571429,23.5
8074,2882,-8662,12,14,26,46.15,-0.015542307692307692,48.46153846153846
8076,15185,-45335,16,18,34,47.06,-0.02152941176470588,22.147058823529413
8077,801,-8271,5,7,12,41.67,-0.024491666666666672,11.75
8080,2891,-13861,13,17,30,43.33,-0.014333333333333332,19.4
8083,8517,-8217,5,7,12,41.67,-0.013899999999999997,119.66666666666667
8084,4719,-10209,10,16,26,38.46,-0.013003846153846152,23.807692307692307
8085,2255,2235,17,12,29,58.62,0.0007655172413793093,29.517241379310345
8086,5919,-9569,9,10,19,47.37,-0.007226315789473685,16.42105263157895
8087,987,-6967,5,7,12,41.67,-0.01340833333333333,29.0
8088,3326,11014,18,12,30,60.0,0.02079666666666667,21.133333333333333
8089,0,0,0,0,0,0.0,,
8091,7881,14119,17,10,27,62.96,0.017844444444444444,43.55555555555556
8092,2484,-1564,15,14,29,51.72,0.009679310344827585,34.172413793103445
8093,1840,-7160,12,12,24,50.0,-0.005612500000000002,31.25
8096,3365,-8405,16,13,29,55.17,0.006417241379310341,27.75862068965517
8097,1644,8656,11,10,21,52.38,0.03066666666666667,15.761904761904763
8099,3520,1380,16,12,28,57.14,0.008467857142857147,37.75
8107,2678,-9238,12,12,24,50.0,-0.006679166666666667,20.625
8109,6037,11163,12,8,20,60.0,0.011205000000000008,92.45
8111,2770,-5500,14,15,29,48.28,-0.005358620689655168,18.24137931034483
8121,5188,-48498,15,17,32,46.88,-0.008115624999999998,14.96875
8147,1803,1247,6,4,10,60.0,0.014350000000000002,41.2
8155,3917,-16567,8,6,14,57.14,0.008864285714285717,18.642857142857142
8171,1172,-11872,5,10,15,33.33,-0.06165333333333334,18.933333333333334
8176,1113,-2663,9,7,16,56.25,-0.0026249999999999954,32.9375
8182,2454,-8604,10,10,20,50.0,-0.012630000000000002,36.35
8183,1275,-3105,9,10,19,47.37,-0.01156315789473684,28.57894736842105
8234,2746,-28696,7,9,16,43.75,-0.03855,44.75
8240,6944,59706,17,8,25,68.0,0.046292,40.8
8255,17286,45214,16,11,27,59.26,0.015474074074074076,43.03703703703704
8277,2847,-22687,15,17,32,46.88,-0.020353125,19.4375
8279,4554,-22654,3,4,7,42.86,-0.0194,43.57142857142857
8284,2227,54783,5,3,8,62.5,0.2140625,298.625
8289,1028,-7508,5,8,13,38.46,-0.03534615384615385,25.076923076923077
8291,294,756,3,2,5,60.0,0.018779999999999998,26.4
8299,35045,88955,17,11,28,60.71,0.022803571428571427,25.928571428571427
8342,890,10210,2,1,3,66.67,0.07619999999999999,150.0
8349,7156,-19656,12,10,22,54.55,-0.002204545454545455,61.59090909090909
8354,1789,-4299,9,10,19,47.37,-0.016342105263157894,75.21052631578948
8358,2850,-28860,3,12,15,20.0,-0.07511333333333332,52.13333333333333
8383,4343,1157,14,10,24,58.33,0.0072791666666666656,54.25
8390,3305,-17905,10,10,20,50.0,-0.012729999999999997,34.45
8401,1521,-9171,7,8,15,46.67,-0.011360000000000004,74.66666666666667
8403,2579,4521,8,5,13,61.54,0.018815384615384616,66.6923076923077
8409,1996,5804,4,7,11,36.36,0.005490909090909089,35.81818181818182
8410,3382,-18032,6,11,17,35.29,-0.03356470588235294,39.705882352941174
8415,105,1595,1,0,1,100.0,0.0955,29.0
8416,5372,57628,6,2,8,75.0,0.0753,99.75
8418,1623,-10033,5,9,14,35.71,-0.029071428571428574,42.5
8420,753,347,4,2,6,66.67,0.01283333333333333,69.16666666666667
8421,603,-2703,3,4,7,42.86,-0.027371428571428567,41.714285714285715
8423,456,-5406,1,3,4,25.0,-0.07295,47.25
8424,1333,3717,3,2,5,60.0,0.02346,211.4
8426,2881,-30131,6,10,16,37.5,-0.04045,46.6875
8431,3556,17994,7,4,11,63.64,0.03470909090909092,26.636363636363637
8432,3196,-26096,3,6,9,33.33,-0.0547,66.66666666666667
8433,7716,-45116,9,9,18,50.0,-0.017061111111111114,48.111111111111114
8435,1459,8691,3,2,5,60.0,0.037919999999999995,171.6
8436,13502,-64302,5,6,11,45.45,-0.020054545454545457,17.727272727272727
8437,8760,-93260,2,7,9,22.22,-0.06423333333333334,103.33333333333333
8440,1107,-2097,6,4,10,60.0,0.01191,72.1
8444,5300,-43000,3,5,8,37.5,-0.0238125,72.875
8446,6745,-26945,5,7,12,41.67,-0.011783333333333335,45.333333333333336
8450,3210,-23860,5,6,11,45.45,-0.03518181818181818,62.72727272727273
8455,915,-4765,4,2,6,66.67,-0.01995,60.666666666666664
8472,2167,-15217,4,5,9,44.44,-0.02592222222222222,39.111111111111114
8476,879,-1379,3,2,5,60.0,0.014360000000000003,53.2
8477,2801,-12951,5,7,12,41.67,-0.02174166666666667,52.5
8489,9145,17555,9,5,14,64.29,0.036471428571428564,20.357142857142858
8905,1953,-53,10,8,18,55.56,0.003066666666666666,53.0
8906,661,-2251,6,5,11,54.55,-0.009327272727272724,21.272727272727273
8908,89,-2189,0,1,1,0.0,-0.1315,34.0
8916,2973,12927,12,6,18,66.67,0.03117222222222223,64.83333333333333
8917,804,4896,2,1,3,66.67,0.04416666666666667,376.3333333333333
8921,527,3833,4,2,6,66.67,0.059066666666666656,75.66666666666667
8923,652,3498,5,2,7,71.43,0.028514285714285718,222.14285714285714
8924,6145,-7245,13,12,25,52.0,-0.012232,69.0
8927,744,-144,4,5,9,44.44,-0.0006888888888888901,57.333333333333336
8928,3086,-9346,11,16,27,40.74,-0.02337407407407407,29.814814814814813
8929,3113,-3223,11,8,19,57.89,0.005584210526315791,29.0
8930,1420,-6080,9,10,19,47.37,-0.013542105263157894,43.526315789473685
8931,1881,8759,10,7,17,58.82,0.015288235294117648,58.411764705882355
8932,959,3241,8,5,13,61.54,0.03702307692307692,41.69230769230769
8933,2612,-8592,16,17,33,48.48,-0.01454848484848485,54.27272727272727
8935,1742,2548,14,13,27,51.85,0.01050740740740741,38.74074074074074
8936,3863,-7343,16,13,29,55.17,-0.0006931034482758618,25.655172413793103
8937,3174,6896,18,11,29,62.07,0.02717586206896552,57.827586206896555
8938,6692,-47992,8,18,26,30.77,-0.032569230769230774,57.61538461538461
8941,6819,-49239,9,15,24,37.5,-0.029200000000000004,25.708333333333332
8942,5883,-47033,6,13,19,31.58,-0.04167368421052632,52.31578947368421
9949,2866,13234,11,10,21,52.38,0.013238095238095245,67.61904761904762
9950,1135,-5095,6,6,12,50.0,-0.012033333333333333,76.66666666666667
9951,11719,-52419,12,19,31,38.71,-0.022477419354838712,54.67741935483871
9960,2904,-11774,11,11,22,50.0,-0.006004545454545457,31.318181818181817
9962,1723,-22153,5,15,20,25.0,-0.07338499999999999,45.1
8916A,583,-4133,0,2,2,0.0,-0.03955,555.5
4148,2990,-43590,3,7,10,30.0,-0.059129999999999995,28.4
6781,6344,180656,1,0,1,100.0,0.1916,12.0
6776,245,1305,1,0,1,100.0,0.0321,136.0
2211,0,0,0,0,0,0.0,,
6768,416,7084,1,0,1,100.0,0.1082,56.0
3357,1901,-29701,1,7,8,12.5,-0.0786375,42.625
6741,2742,-57242,0,3,3,0.0,-0.10880000000000001,17.666666666666668
2250,672,16328,1,0,1,100.0,0.1601,13.0
5236,652,-11152,0,1,1,0.0,-0.0933,53.0
1522A,260,340,1,0,1,100.0,0.0077,204.0
6684,1325,-5325,1,1,2,50.0,-0.011199999999999995,6.0
2753,0,0,0,0,0,0.0,,
2348A,0,0,0,0,0,0.0,,
6790,248,-1648,0,1,1,0.0,-0.0381,36.0
6788,0,0,0,0,0,0.0,,
2947,0,0,0,0,0,0.0,,
4440,0,0,0,0,0,0.0,,
5222,3285,-35845,3,5,8,37.5,-0.013862500000000003,16.0
2881C,348,-648,0,1,1,0.0,-0.0109,37.0
6761,631,-10631,0,1,1,0.0,-0.092,32.0
6806,0,0,0,0,0,0.0,,
2945,0,0,0,0,0,0.0,,
6770,301,-4501,0,1,1,0.0,-0.0826,110.0
6792,561,-3461,0,1,1,0.0,-0.0353,1.0
4770,0,0,0,0,0,0.0,,
2883B,65,-375,0,1,1,0.0,-0.0433,24.0
6691,0,0,0,0,0,0.0,,
3592,11300,-55570,9,9,18,50.0,-0.011699999999999997,30.11111111111111
6719,0,0,0,0,0,0.0,,
2756,0,0,0,0,0,0.0,,
5244,848,142,6,4,10,60.0,0.02153,56.6
6693,0,0,0,0,0,0.0,,
8112A,0,0,0,0,0,0.0,,
8438,1197,-6897,3,4,7,42.86,-0.022128571428571435,136.28571428571428
6829,0,0,0,0,0,0.0,,
4923,613,-3263,1,4,5,20.0,-0.06599999999999999,122.8
6763,0,0,0,0,0,0.0,,
4558,575,25675,3,2,5,60.0,0.31592,452.8
3349,0,0,0,0,0,0.0,,
6804,0,0,0,0,0,0.0,,
4768,0,0,0,0,0,0.0,,
6807,0,0,0,0,0,0.0,,
6721,0,0,0,0,0,0.0,,
6735,0,0,0,0,0,0.0,,
4583,0,0,0,0,0,0.0,,
6799,0,0,0,0,0,0.0,,
6585,689,-6329,1,1,2,50.0,-0.0426,988.5
5228,361,-8011,0,3,3,0.0,-0.1178,70.33333333333333
6546,595,-3695,2,4,6,33.33,-0.03395,48.0
6796,0,0,0,0,0,0.0,,
6550,380,-12580,0,2,2,0.0,-0.1758,33.5
