代號,總成本,總損益(淨),獲利次數,損失次數,總交易次數,勝率%,平均報酬,平均持倉時間(日)
1101,3262,-10582,6,10,16,37.5,-0.02445,69.75
1102,1590,4720,5,4,9,55.56,0.005222222222222225,82.55555555555556
1103,1213,787,7,7,14,50.0,0.0003499999999999996,47.357142857142854
1104,1283,1437,6,7,13,46.15,-0.010430769230769226,69.92307692307692
1108,855,1995,7,6,13,53.85,-0.0006230769230769217,96.38461538461539
1109,1318,-5768,6,12,18,33.33,-0.04031666666666667,68.55555555555556
1110,1086,-5966,5,9,14,35.71,-0.03554999999999999,69.28571428571429
1201,1757,-13877,4,9,13,30.77,-0.044684615384615385,70.0
1203,1420,-4850,5,7,12,41.67,-0.022949999999999998,77.58333333333333
1210,2060,-200,6,7,13,46.15,-0.008500000000000004,98.15384615384616
1213,1908,9902,15,8,23,65.22,0.023543478260869558,52.73913043478261
1215,2946,2374,10,8,18,55.56,0.004005555555555557,61.611111111111114
1216,1987,-14527,3,5,8,37.5,-0.0309875,79.875
1217,1076,-2536,7,10,17,41.18,-0.0262235294117647,74.11764705882354
1218,1558,-13368,6,13,19,31.58,-0.044399999999999995,41.31578947368421
1219,1211,-4731,6,8,14,42.86,-0.02125,77.92857142857143
1220,868,-2818,6,7,13,46.15,-0.02170769230769231,85.07692307692308
1225,2017,-207,5,8,13,38.46,-0.030223076923076922,59.30769230769231
1227,4131,16489,7,4,11,63.64,0.021263636363636363,110.18181818181819
1229,1424,-12844,4,9,13,30.77,-0.044976923076923074,47.23076923076923
1231,3390,-3710,9,12,21,42.86,-0.016138095238095236,51.857142857142854
1232,2585,-21355,2,8,10,20.0,-0.05664,137.9
1233,2345,-22495,2,9,11,18.18,-0.06244545454545454,169.54545454545453
1234,1617,5613,9,4,13,69.23,0.02572307692307692,78.92307692307692
1235,2554,3036,9,8,17,52.94,-3.529411764705902e-05,82.23529411764706
1236,1464,-7404,5,9,14,35.71,-0.03469285714285714,103.14285714285714
1256,12973,77927,7,4,11,63.64,0.021463636363636362,32.45454545454545
1301,3376,-14236,3,5,8,37.5,-0.030887500000000002,88.75
1303,5424,-9274,7,8,15,46.67,-0.012533333333333336,76.4
1304,2057,2033,11,8,19,57.89,0.009526315789473683,60.526315789473685
1305,1571,6479,8,7,15,53.33,0.00020666666666666888,32.2
1307,1653,3407,6,6,12,50.0,-0.005866666666666667,77.08333333333333
1308,1814,1166,9,6,15,60.0,0.014026666666666661,62.2
1309,1675,305,11,9,20,55.0,0.002659999999999999,27.3
1310,1773,-3873,8,11,19,42.11,-0.02219473684210526,45.05263157894737
1312,1607,5263,11,8,19,57.89,0.012352631578947367,33.26315789473684
1313,1216,10484,12,3,15,80.0,0.05362,42.666666666666664
1314,1681,4759,12,10,22,54.55,0.0014999999999999987,30.227272727272727
1315,1251,4609,5,5,10,50.0,-0.0066,89.2
1316,1713,3667,15,9,24,62.5,0.01441666666666667,32.208333333333336
1319,4401,28579,15,6,21,71.43,0.03696666666666666,37.76190476190476
1321,1893,-2723,8,8,16,50.0,-0.00626875,52.5625
1323,1806,-8436,6,9,15,40.0,-0.02673333333333333,48.666666666666664
1324,1366,-2136,9,9,18,50.0,-0.006833333333333334,66.66666666666667
1325,2238,-11488,7,11,18,38.89,-0.028677777777777778,91.27777777777777
1326,5563,32367,9,4,13,69.23,0.032661538461538464,134.3846153846154
1337,1685,24345,11,1,12,91.67,0.076825,49.333333333333336
1338,2495,11845,4,2,6,66.67,0.02753333333333333,34.666666666666664
1339,972,-9002,1,3,4,25.0,-0.0559,66.25
1340,2668,36712,8,3,11,72.73,0.048881818181818165,67.81818181818181
1341,1097,-19417,0,3,3,0.0,-0.106,169.0
1342,0,0,0,0,0,0.0,,
1402,1503,-4823,4,6,10,40.0,-0.02606,91.9
1409,841,-261,6,6,12,50.0,-0.007916666666666664,43.5
1410,1611,-3151,10,9,19,52.63,-0.00250526315789474,53.94736842105263
1413,1522,1158,15,12,27,55.56,-0.0025222222222222247,38.370370370370374
1414,1651,-2651,13,16,29,44.83,-0.022565517241379306,27.689655172413794
1416,1126,3494,9,6,15,60.0,0.011466666666666665,37.13333333333333
1417,923,2447,9,6,15,60.0,0.016840000000000004,49.46666666666667
1418,1453,-6963,9,17,26,34.62,-0.04395769230769231,30.153846153846153
1419,2314,-3534,6,7,13,46.15,-0.013599999999999998,64.53846153846153
1423,911,-1701,7,8,15,46.67,-0.017206666666666665,81.6
1432,118,-6488,1,1,2,50.0,-0.5873,2563.5
1434,2192,-2472,8,7,15,53.33,-0.00482,95.46666666666667
1435,1202,-1422,11,9,20,55.0,-0.001114999999999998,30.3
1436,1741,-11331,2,9,11,18.18,-0.07077272727272726,162.9090909090909
1437,1593,4377,10,8,18,55.56,0.010322222222222222,26.5
1438,286,-30846,4,2,6,66.67,-6.0157,836.8333333333334
1439,2634,-21394,7,19,26,26.92,-0.05263846153846154,39.03846153846154
1440,1643,-5873,8,12,20,40.0,-0.026894999999999992,34.45
1441,1344,-864,12,10,22,54.55,-0.0053636363636363656,40.27272727272727
1442,2094,-12644,6,14,20,30.0,-0.046595,68.15
1443,685,1025,8,5,13,61.54,0.007530769230769234,40.84615384615385
1444,1160,-2510,9,10,19,47.37,-0.015215789473684209,29.473684210526315
1445,627,-527,5,5,10,50.0,-0.00955,118.3
1446,2055,-9245,12,10,22,54.55,0.0005090909090909091,31.5
1447,1047,433,8,8,16,50.0,-0.008093750000000004,28.9375
1449,1309,701,15,11,26,57.69,-0.005746153846153845,24.615384615384617
1451,2726,18134,15,7,22,68.18,0.030318181818181814,57.31818181818182
1452,1801,6599,13,7,20,65.0,0.022475000000000002,59.75
1453,1168,1392,13,7,20,65.0,0.016470000000000002,66.7
1454,866,1024,8,6,14,57.14,0.005592857142857141,97.35714285714286
1455,1438,-3998,9,12,21,42.86,-0.02260952380952381,53.80952380952381
1456,579,-8319,6,6,12,50.0,-0.09618333333333333,256.3333333333333
1457,544,-2954,4,5,9,44.44,-0.02248888888888889,53.77777777777778
1459,1212,-3212,8,11,19,42.11,-0.024152631578947373,39.21052631578947
1460,1301,3819,12,8,20,60.0,0.014434999999999998,58.15
1463,1200,3480,9,9,18,50.0,-0.01011111111111111,24.72222222222222
1464,1790,6260,12,7,19,63.16,0.01919473684210526,59.68421052631579
1465,1386,-1196,9,9,18,50.0,-0.006699999999999998,97.11111111111111
1466,1849,-6409,12,12,24,50.0,-0.010691666666666669,54.25
1467,1473,-8603,7,13,20,35.0,-0.037419999999999995,35.05
1468,591,-7001,1,7,8,12.5,-0.0816625,172.125
1470,705,-1805,4,7,11,36.36,-0.03737272727272727,55.27272727272727
1471,1704,10086,13,5,18,72.22,0.03627777777777778,17.11111111111111
1472,1929,12641,15,8,23,65.22,0.022604347826086967,28.608695652173914
1473,2653,4877,9,7,16,56.25,0.006662499999999998,117.5625
1474,955,4375,9,5,14,64.29,0.020678571428571428,80.07142857142857
1475,2509,12421,18,10,28,64.29,0.021107142857142856,19.785714285714285
1476,4081,-1631,4,3,7,57.14,0.00832857142857143,54.714285714285715
1477,10095,64585,11,5,16,68.75,0.0316875,52.6875
1503,2142,-32272,1,11,12,8.33,-0.08932499999999999,186.5
1504,1217,-317,5,6,11,45.45,-0.015190909090909093,58.54545454545455
1506,2227,-547,11,12,23,47.83,-0.010704347826086954,52.52173913043478
1512,1308,7192,17,5,22,77.27,0.04451363636363636,22.545454545454547
1513,1546,-6936,6,8,14,42.86,-0.020407142857142856,56.714285714285715
1514,1241,-1601,10,7,17,58.82,0.009476470588235293,45.529411764705884
1515,3163,1167,13,9,22,59.09,0.01043181818181818,43.36363636363637
1516,1191,-1991,11,8,19,57.89,0.0055052631578947405,33.10526315789474
1517,1481,389,10,10,20,50.0,-0.007119999999999999,54.9
1519,2239,-10819,7,11,18,38.89,-0.028405555555555555,59.388888888888886
1521,3714,13486,9,4,13,69.23,0.03257692307692308,101.6923076923077
1522,2190,4710,9,9,18,50.0,-0.006000000000000002,43.05555555555556
1524,1259,-2419,8,10,18,44.44,-0.01892222222222222,68.11111111111111
1525,5194,12826,10,6,16,62.5,0.0250375,64.0
1526,1963,12727,12,10,22,54.55,0.0005090909090909098,29.545454545454547
1527,3585,25995,10,4,14,71.43,0.03701428571428572,58.42857142857143
1528,1915,4915,16,10,26,61.54,0.016107692307692302,36.73076923076923
1529,1733,1677,17,11,28,60.71,0.009760714285714287,15.857142857142858
1530,3010,-11910,6,10,16,37.5,-0.027374999999999997,60.4375
1531,2732,-6182,10,10,20,50.0,-0.005974999999999998,59.75
1532,3094,-204,8,9,17,47.06,-0.006376470588235296,49.76470588235294
1533,4801,-2861,13,13,26,50.0,-0.005980769230769232,32.11538461538461
1535,3334,26526,9,6,15,60.0,0.013806666666666665,69.2
1536,3596,52894,13,1,14,92.86,0.07978571428571431,28.428571428571427
1537,3586,23444,7,3,10,70.0,0.034210000000000004,68.8
1538,2176,7624,12,10,22,54.55,0.0013909090909090898,18.545454545454547
1539,2149,5791,13,11,24,54.17,0.0006583333333333342,41.25
1540,2305,3395,11,8,19,57.89,0.009931578947368423,41.63157894736842
1541,3571,-9941,14,16,30,46.67,-0.013449999999999997,36.56666666666667
1558,5860,7580,5,5,10,50.0,-0.005830000000000002,83.1
1560,7163,-29643,9,10,19,47.37,-0.011136842105263159,22.263157894736842
1568,1278,3752,6,4,10,60.0,0.014149999999999996,20.7
1582,6427,-12667,7,9,16,43.75,-0.0183625,34.9375
1583,3080,-2690,6,6,12,50.0,-0.005866666666666666,58.25
1587,1180,-7630,3,6,9,33.33,-0.03926666666666667,43.666666666666664
1589,5761,-48401,4,7,11,36.36,-0.03317272727272727,21.272727272727273
1590,11972,-57122,3,4,7,42.86,-0.03174285714285714,9.571428571428571
1597,3844,16866,6,3,9,66.67,0.027533333333333337,31.77777777777778
1598,1587,-10537,2,4,6,33.33,-0.03921666666666667,15.5
1603,1746,-606,10,11,21,47.62,-0.009895238095238096,51.523809523809526
1604,798,6642,8,3,11,72.73,0.036427272727272725,63.09090909090909
1605,1272,-6682,6,10,16,37.5,-0.03189375,33.125
1608,1468,8752,15,6,21,71.43,0.03481428571428571,31.666666666666668
1609,1457,-4277,9,11,20,45.0,-0.018615,36.1
1611,1337,-4227,7,10,17,41.18,-0.028258823529411763,44.35294117647059
1612,1142,10218,11,3,14,78.57,0.045107142857142846,30.857142857142858
1614,2709,-2779,9,8,17,52.94,-0.005470588235294119,91.11764705882354
1615,1350,2980,9,8,17,52.94,-0.0013294117647058836,100.0
1616,1299,-1479,10,11,21,47.62,-0.014100000000000001,30.142857142857142
1617,1359,661,10,9,19,52.63,-0.007063157894736846,85.84210526315789
1618,1338,-1758,8,9,17,47.06,-0.012952941176470585,56.11764705882353
1626,2045,6675,7,4,11,63.64,0.02141818181818182,21.181818181818183
1701,1579,-11069,4,11,15,26.67,-0.049780000000000005,73.53333333333333
1702,2450,21420,11,4,15,73.33,0.03538,74.6
1707,9314,-33674,6,12,18,33.33,-0.03961666666666666,64.11111111111111
1708,1938,-5758,6,7,13,46.15,-0.014123076923076926,78.76923076923077
1709,1598,-918,8,10,18,44.44,-0.017366666666666662,92.11111111111111
1710,2548,10092,11,6,17,64.71,0.023523529411764707,63.94117647058823
1711,2172,558,11,9,20,55.0,0.003770000000000005,42.35
1712,804,-604,6,5,11,54.55,0.0014636363636363614,64.27272727272727
1713,1176,-7706,5,10,15,33.33,-0.040526666666666676,80.8
1714,1570,-7000,8,14,22,36.36,-0.03469545454545454,49.13636363636363
1717,1856,10934,8,4,12,66.67,0.03494166666666667,88.33333333333333
1718,1557,673,13,10,23,56.52,0.005395652173913042,34.04347826086956
1720,1606,-3966,5,6,11,45.45,-0.015000000000000003,66.18181818181819
1721,1605,-4125,9,14,23,39.13,-0.029852173913043477,49.91304347826087
1722,4694,7816,8,7,15,53.33,-0.003246666666666667,76.06666666666666
1723,7039,-9999,6,6,12,50.0,-0.005858333333333333,51.5
1725,1646,-5826,7,8,15,46.67,-0.01264,37.93333333333333
1726,2883,-20343,3,6,9,33.33,-0.049433333333333336,137.33333333333334
1727,1452,-7792,5,10,15,33.33,-0.03968666666666667,79.0
1730,2412,-13382,6,8,14,42.86,-0.02079285714285714,91.85714285714286
1731,1002,3008,7,5,12,58.33,0.010458333333333333,81.5
1732,1897,14843,15,6,21,71.43,0.03646666666666667,37.333333333333336
1733,5049,13831,13,8,21,61.9,0.017990476190476192,58.523809523809526
1734,2573,-1813,8,9,17,47.06,-0.011782352941176471,56.76470588235294
1735,1711,3809,10,9,19,52.63,0.0026947368421052624,62.26315789473684
1736,4489,27801,6,5,11,54.55,0.003236363636363637,55.63636363636363
1737,2336,-2686,7,9,16,43.75,-0.012968750000000001,112.4375
1760,8070,-45470,6,9,15,40.0,-0.026033333333333335,37.333333333333336
1762,1113,-9063,2,3,5,40.0,-0.02592,50.4
1773,3799,18581,5,3,8,62.5,0.013549999999999996,60.25
1776,401,-7081,0,4,4,0.0,-0.10615,99.0
1783,1810,-5290,5,5,10,50.0,-0.00584,27.6
1786,2435,-8635,3,5,8,37.5,-0.0309,49.625
1789,2418,13732,6,4,10,60.0,0.014149999999999996,70.6
1795,4178,-1228,6,6,12,50.0,-0.0058583333333333334,24.833333333333332
1802,2422,-2132,10,10,20,50.0,-0.006084999999999998,58.55
1805,1706,-2146,14,12,26,53.85,-0.0046923076923076935,28.423076923076923
1806,1572,-3182,10,11,21,47.62,-0.01571904761904763,45.285714285714285
1808,2283,13907,8,7,15,53.33,-0.0004266666666666678,57.6
1809,1440,4220,11,7,18,61.11,0.020811111111111107,35.611111111111114
1810,1354,-6114,7,13,20,35.0,-0.03751,46.65
1817,1057,9593,4,1,5,80.0,0.05417999999999999,179.0
1903,4929,-2209,12,11,23,52.17,-0.00152608695652174,52.69565217391305
1904,1435,865,8,7,15,53.33,0.006866666666666668,71.66666666666667
1905,986,2074,7,6,13,53.85,0.0008615384615384606,74.76923076923077
1906,1504,-4294,10,11,21,47.62,-0.014533333333333332,29.285714285714285
1907,1766,-15396,5,15,20,25.0,-0.05686000000000001,36.5
1909,1632,10128,13,6,19,68.42,0.02999473684210527,34.89473684210526
2002,1562,18178,8,2,10,80.0,0.054200000000000005,159.3
2006,2398,-238,8,8,16,50.0,-0.006006250000000001,61.5625
2007,1200,6970,15,5,20,75.0,0.03948,31.4
2008,1079,-4129,6,11,17,35.29,-0.038252941176470594,19.88235294117647
2009,1668,-1228,11,8,19,57.89,0.008368421052631575,54.578947368421055
2010,1624,426,10,9,19,52.63,-0.0011789473684210535,89.89473684210526
2012,1407,-4417,7,11,18,38.89,-0.02366111111111111,59.55555555555556
2013,2774,-2224,10,11,21,47.62,-0.01071904761904762,80.23809523809524
2014,1793,6127,12,8,20,60.0,0.012570000000000003,26.85
2015,3798,-12228,5,9,14,35.71,-0.03449285714285714,108.85714285714286
2017,1151,3119,10,7,17,58.82,0.009229411764705885,51.529411764705884
2020,2199,5751,11,9,20,55.0,0.004030000000000004,66.35
2022,1132,3698,12,7,19,63.16,0.016173684210526316,30.526315789473685
2023,1376,744,8,8,16,50.0,-0.006693750000000002,70.875
2024,938,1772,8,7,15,53.33,-0.002959999999999998,29.066666666666666
2025,1354,2126,14,11,25,56.0,-0.0020199999999999975,22.68
2027,2661,-4491,8,10,18,44.44,-0.017038888888888888,31.944444444444443
2028,1383,9617,14,5,19,73.68,0.034589473684210524,32.63157894736842
2029,2304,12366,11,5,16,68.75,0.03169375000000001,91.9375
2030,1767,5343,9,8,17,52.94,-0.0004764705882352906,34.94117647058823
2031,2874,16656,12,6,18,66.67,0.027488888888888886,41.27777777777778
2032,1991,9549,13,8,21,61.9,0.017223809523809523,22.904761904761905
2033,1187,-2487,6,9,15,40.0,-0.026813333333333342,58.8
2034,1455,11205,8,3,11,72.73,0.03950909090909091,83.45454545454545
2038,1276,4364,8,7,15,53.33,-0.0008533333333333338,44.86666666666667
2049,13762,176338,9,1,10,90.0,0.07427000000000002,20.7
2059,15347,-78167,5,7,12,41.67,-0.022541666666666668,34.916666666666664
2062,3423,2777,9,9,18,50.0,-0.005900000000000004,57.888888888888886
2069,772,6198,5,2,7,71.43,0.037014285714285715,58.0
2101,2649,-6559,6,8,14,42.86,-0.014935714285714285,50.785714285714285
2102,2011,1969,11,9,20,55.0,0.004000000000000002,35.5
2103,4637,-17387,10,13,23,43.48,-0.01903478260869565,41.65217391304348
2104,1782,-3912,5,8,13,38.46,-0.02366153846153846,42.0
2105,4005,-4475,7,8,15,46.67,-0.007466666666666665,66.8
2106,4092,12618,13,8,21,61.9,0.01796666666666667,54.76190476190476
2107,1950,-1720,9,11,20,45.0,-0.016099999999999996,49.8
2108,3530,26210,11,8,19,57.89,0.005857894736842107,51.0
2109,1400,4170,11,8,19,57.89,0.00846842105263158,50.0
2114,2716,-25836,2,5,7,28.57,-0.048799999999999996,66.0
2115,1955,25195,7,1,8,87.5,0.06923750000000001,72.625
2201,2066,8094,7,4,11,63.64,0.02141818181818182,79.0909090909091
2204,3108,4082,10,9,19,52.63,-0.0006999999999999989,49.73684210526316
2206,1879,-21179,3,13,16,18.75,-0.06911875,85.6875
2207,13560,-70780,2,5,7,28.57,-0.04877142857142857,49.285714285714285
2208,1598,7662,9,5,14,64.29,0.022549999999999997,62.857142857142854
2227,15323,-141013,7,9,16,43.75,-0.0235625,93.3125
2228,5456,-31976,3,6,9,33.33,-0.039233333333333335,56.0
2231,14900,-5920,8,6,14,57.14,0.008450000000000001,17.214285714285715
2233,4648,8132,5,4,9,55.56,0.005277777777777776,24.0
2236,1185,3495,4,2,6,66.67,0.027499999999999997,57.833333333333336
2239,3465,33705,5,2,7,71.43,0.037071428571428575,23.428571428571427
2241,2522,1958,4,3,7,57.14,0.008428571428571428,38.0
2243,779,6841,4,2,6,66.67,0.027366666666666668,17.833333333333332
2247,1438,23762,1,0,1,100.0,0.0943,17.0
2301,1647,-3047,3,4,7,42.86,-0.020185714285714286,74.0
2302,918,2222,9,7,16,56.25,0.00040625000000000296,23.0625
2303,1353,-43,8,8,16,50.0,-0.006475,46.5
2305,1260,2000,14,9,23,60.87,0.00952173913043478,29.695652173913043
2308,8664,54406,8,3,11,72.73,0.039672727272727276,40.18181818181818
2312,1034,7186,10,4,14,71.43,0.035685714285714286,71.14285714285714
2313,1236,11234,10,3,13,76.92,0.04678461538461538,33.0
2314,2575,13265,16,9,25,64.0,0.021456,20.28
2316,1941,-6131,9,11,20,45.0,-0.021655,36.95
2317,10195,-68225,5,11,16,31.25,-0.04340625,55.1875
2321,1642,-512,16,11,27,59.26,0.0039740740740740734,19.74074074074074
2323,975,595,7,8,15,46.67,-0.016226666666666667,30.333333333333332
2324,2139,-1229,6,8,14,42.86,-0.014950000000000003,58.5
2327,18606,-9966,9,10,19,47.37,-0.009705263157894734,23.57894736842105
2328,2589,20381,10,5,15,66.67,0.027433333333333334,29.533333333333335
2329,1591,4269,14,12,26,53.85,-0.004307692307692306,19.807692307692307
2330,4491,-47611,3,5,8,37.5,-0.030887500000000002,28.25
2331,2320,11810,15,9,24,62.5,0.018354166666666668,28.291666666666668
2332,2159,-3939,7,11,18,38.89,-0.02852222222222222,35.333333333333336
2337,2674,15196,18,12,30,60.0,0.014819999999999998,24.3
2338,1181,-7061,5,9,14,35.71,-0.03523571428571428,77.35714285714286
2340,1797,-1417,10,10,20,50.0,-0.007285000000000002,24.0
2342,1879,1701,15,11,26,57.69,0.0037192307692307724,13.038461538461538
2344,1470,7980,12,7,19,63.16,0.0182,15.947368421052632
2345,5452,36048,11,4,15,73.33,0.040633333333333334,34.46666666666667
2347,3610,-4490,6,7,13,46.15,-0.013538461538461537,62.53846153846154
2348,973,-66813,7,5,12,58.33,-2.081325,428.4166666666667
2349,1604,-454,13,13,26,50.0,-0.00978076923076923,34.53846153846154
2351,2411,16009,11,4,15,73.33,0.04072,24.866666666666667
2352,1791,-3721,9,6,15,60.0,0.01368666666666667,27.466666666666665
2353,4335,13985,13,8,21,61.9,0.0222047619047619,25.047619047619047
2354,10002,-1332,9,7,16,56.25,0.006668749999999999,44.25
2355,3794,8696,13,10,23,56.52,0.007086956521739132,25.26086956521739
2356,1447,-12067,4,9,13,30.77,-0.04446923076923077,71.0
2357,15436,38154,9,8,17,52.94,3.5294117647058204e-05,57.1764705882353
2358,2106,7314,17,11,28,60.71,0.015135714285714284,16.464285714285715
2359,1467,-9137,7,12,19,36.84,-0.03391578947368421,28.05263157894737
2360,7899,53031,11,8,19,57.89,0.00996315789473684,19.263157894736842
2362,3115,7985,10,8,18,55.56,0.0049888888888888865,27.38888888888889
2363,1727,-107,12,10,22,54.55,0.001631818181818183,15.863636363636363
2364,1537,833,18,13,31,58.06,-0.0010580645161290317,25.806451612903224
2365,2848,14002,16,7,23,69.57,0.03295217391304348,35.65217391304348
2367,1622,4528,11,7,18,61.11,0.0157,25.166666666666668
2368,864,1506,6,5,11,54.55,0.002154545454545456,17.454545454545453
2369,1552,1598,11,8,19,57.89,0.00473684210526316,17.263157894736842
2371,1613,-2103,11,11,22,50.0,-0.007827272727272728,29.454545454545453
2373,3154,-374,5,8,13,38.46,-0.0334,101.0
2374,2636,15444,12,6,18,66.67,0.02742222222222222,37.388888888888886
2375,1894,17576,11,5,16,68.75,0.028312499999999997,22.875
2376,5236,25884,12,9,21,57.14,0.009666666666666665,28.857142857142858
2377,3813,37137,10,4,14,71.43,0.03702142857142857,21.071428571428573
2379,11233,-25493,6,10,16,37.5,-0.030887500000000002,36.375
2380,2108,-3848,13,15,28,46.43,-0.015014285714285714,24.857142857142858
2382,4232,2128,6,6,12,50.0,-0.00585,39.416666666666664
2383,1892,-2332,7,5,12,58.33,0.010133333333333336,49.5
2385,5060,31280,10,7,17,58.82,0.01181176470588235,47.529411764705884
2387,3103,-7353,12,11,23,52.17,-0.0016695652173913033,33.130434782608695
2388,2814,4296,10,11,21,47.62,-0.011204761904761905,18.857142857142858
2390,2020,11200,15,7,22,68.18,0.02959090909090909,28.318181818181817
2392,3765,-2745,8,5,13,61.54,0.017253846153846154,40.07692307692308
2393,5120,24460,11,6,17,64.71,0.028782352941176474,33.0
2395,4968,-27758,2,4,6,33.33,-0.03925,34.0
2397,4521,-33571,5,13,18,27.78,-0.05037222222222223,44.77777777777778
2399,1518,8032,11,6,17,64.71,0.022970588235294118,29.235294117647058
2401,3552,13838,15,10,25,60.0,0.012428,23.04
2402,2233,-6813,7,10,17,41.18,-0.02363529411764706,16.058823529411764
2404,5795,-1465,7,10,17,41.18,-0.02363529411764706,59.0
2405,2242,-8852,10,14,24,41.67,-0.02356666666666667,18.958333333333332
2406,2378,20402,17,7,24,70.83,0.03412916666666666,13.083333333333334
2408,3513,11407,15,7,22,68.18,0.027109090909090916,16.59090909090909
2409,2669,-21229,6,12,18,33.33,-0.039466666666666664,22.166666666666668
2412,3680,-43030,1,6,7,14.29,-0.07738571428571428,363.42857142857144
2413,1882,-5762,10,12,22,45.45,-0.01573181818181818,16.5
2414,1093,-3313,5,7,12,41.67,-0.023066666666666666,58.333333333333336
2415,2814,13266,19,10,29,65.52,0.02469655172413794,21.655172413793103
2417,1710,-3450,7,6,13,53.85,0.0013307692307692315,39.38461538461539
2419,1551,199,10,8,18,55.56,0.00363888888888889,22.055555555555557
2420,2316,3094,8,8,16,50.0,-0.006181249999999999,71.0
2421,2729,-15499,6,14,20,30.0,-0.046005000000000004,31.7
2423,2017,2563,10,8,18,55.56,0.005205555555555555,69.94444444444444
2424,2148,-15228,9,12,21,42.86,-0.02195238095238095,25.0
2425,2631,-3431,13,14,27,48.15,-0.011859259259259262,23.185185185185187
2426,2287,343,13,10,23,56.52,0.0066086956521739185,15.391304347826088
2427,1142,-2052,7,9,16,43.75,-0.020125,21.25
2428,3438,-3378,6,9,15,40.0,-0.026006666666666664,46.6
2429,438,-8608,4,5,9,44.44,-0.26915555555555554,577.0
2430,4381,20009,14,8,22,63.64,0.02137272727272727,66.31818181818181
2431,1242,6328,12,5,17,70.59,0.03429411764705883,31.41176470588235
2433,2119,-13829,2,9,11,18.18,-0.060227272727272727,115.27272727272727
2434,2169,-3989,12,13,25,48.0,-0.008848,27.96
2436,2351,-15431,6,11,17,35.29,-0.03547058823529412,23.823529411764707
2438,1537,3003,17,8,25,68.0,0.020672000000000003,28.44
2439,9433,15897,9,9,18,50.0,-0.005855555555555558,20.72222222222222
2440,1800,-1770,12,16,28,42.86,-0.023600000000000003,29.964285714285715
2441,2421,7459,6,6,12,50.0,-0.0059083333333333305,51.75
2442,1409,1311,12,10,22,54.55,0.0005181818181818186,27.681818181818183
2443,1537,5343,21,7,28,75.0,0.03665357142857142,26.428571428571427
2444,1553,-5243,9,13,22,40.91,-0.025859090909090908,25.045454545454547
2449,1915,-8375,8,9,17,47.06,-0.016705882352941178,31.0
2450,3349,10561,7,7,14,50.0,-0.005907142857142861,88.78571428571429
2451,7293,-56033,5,11,16,31.25,-0.04340624999999999,83.6875
2453,1522,-3662,9,11,20,45.0,-0.016989999999999998,38.3
2454,31528,79672,9,7,16,56.25,0.004537499999999998,19.9375
2455,3880,14620,12,6,18,66.67,0.027238888888888885,9.61111111111111
2457,1906,2464,12,8,20,60.0,0.013425000000000003,17.4
2458,4023,-2833,9,7,16,56.25,0.0008374999999999997,25.875
2459,3602,-6132,9,12,21,42.86,-0.017414285714285715,56.61904761904762
2460,2553,1277,11,13,24,45.83,-0.014629166666666667,35.75
2461,2460,12190,15,8,23,65.22,0.02438260869565218,26.47826086956522
2462,2431,2219,9,8,17,52.94,-8.823529411764959e-05,30.41176470588235
2464,3278,452,10,9,19,52.63,-0.0006052631578947374,50.05263157894737
2465,2498,17542,19,8,27,70.37,0.032429629629629635,24.962962962962962
2466,2766,-606,10,9,19,52.63,-0.0011894736842105276,110.89473684210526
2467,2534,-9114,9,13,22,40.91,-0.02429090909090909,35.54545454545455
2468,1663,-5413,10,13,23,43.48,-0.020169565217391303,54.608695652173914
2471,1387,-9567,6,11,17,35.29,-0.036835294117647056,52.529411764705884
2472,2937,-10037,10,13,23,43.48,-0.01956521739130435,18.391304347826086
2474,15320,-7590,8,8,16,50.0,-0.005850000000000001,22.9375
2476,2687,-10797,7,13,20,35.0,-0.035934999999999995,34.3
2477,2396,14584,12,5,17,70.59,0.03507647058823529,35.1764705882353
2478,4997,11223,12,12,24,50.0,-0.0059208333333333335,29.791666666666668
2480,2171,-13491,6,9,15,40.0,-0.026046666666666662,40.86666666666667
2481,2129,10511,10,5,15,66.67,0.027386666666666663,20.8
2482,1574,-964,7,9,16,43.75,-0.018737499999999997,48.9375
2483,2033,5877,13,7,20,65.0,0.02386,41.45
2484,1700,-5650,7,9,16,43.75,-0.018531250000000003,31.125
2485,3662,19968,12,5,17,70.59,0.03534117647058824,38.94117647058823
2486,3766,27284,20,10,30,66.67,0.02713333333333334,18.966666666666665
2488,2923,8587,13,8,21,61.9,0.01780952380952381,50.904761904761905
2489,2573,18887,17,5,22,77.27,0.04851363636363636,39.81818181818182
2491,1162,508,12,7,19,63.16,0.01162631578947368,20.36842105263158
2492,3846,51704,9,5,14,64.29,0.021571428571428568,30.214285714285715
2493,1461,-2201,7,7,14,50.0,-0.006835714285714287,29.642857142857142
2495,5384,-704,13,13,26,50.0,-0.006030769230769233,45.11538461538461
2496,5260,12400,14,9,23,60.87,0.006830434782608696,39.73913043478261
2497,2658,13442,11,7,18,61.11,0.01635,19.38888888888889
2498,41947,35193,12,14,26,46.15,-0.01356153846153846,21.53846153846154
2501,996,-646,5,6,11,45.45,-0.015499999999999998,86.63636363636364
2504,1357,10703,12,5,17,70.59,0.0338764705882353,27.823529411764707
2505,1821,-6931,10,10,20,50.0,-0.00658,26.3
2506,1039,1861,11,6,17,64.71,0.017905882352941178,78.52941176470588
2509,1968,-938,10,8,18,55.56,-1.3492293702041833e-18,30.38888888888889
2511,2085,-5865,10,15,25,40.0,-0.023116000000000005,55.16
2514,1380,-4850,6,9,15,40.0,-0.026266666666666664,68.26666666666667
2515,1026,-166,9,8,17,52.94,-0.0032117647058823536,51.35294117647059
2516,1257,3373,15,7,22,68.18,0.02557272727272727,57.04545454545455
2520,2243,-743,9,10,19,47.37,-0.01645263157894737,32.526315789473685
2524,3281,-3641,10,11,21,47.62,-0.010747619047619048,42.57142857142857
2527,1464,4126,11,6,17,64.71,0.02151764705882353,46.11764705882353
2528,1138,7822,12,5,17,70.59,0.009952941176470586,37.88235294117647
2530,1552,-3732,12,11,23,52.17,-0.006643478260869565,38.78260869565217
2534,1568,-11528,4,11,15,26.67,-0.053126666666666676,29.066666666666666
2535,1383,-1303,7,7,14,50.0,-0.0018928571428571401,49.92857142857143
2536,2438,-5738,7,9,16,43.75,-0.014962499999999997,107.3125
2537,1376,2324,11,8,19,57.89,0.008105263157894735,57.26315789473684
2538,1539,8591,12,6,18,66.67,0.026488888888888888,68.83333333333333
2539,480,-19490,3,3,6,50.0,-0.17726666666666666,849.0
2540,2798,-28128,8,11,19,42.11,-0.031605263157894734,29.789473684210527
2542,4014,-1354,9,8,17,52.94,-1.1764705882353279e-05,33.705882352941174
2543,1340,-1030,10,11,21,47.62,-0.01318571428571429,61.61904761904762
2545,4461,-12471,10,11,21,47.62,-0.010814285714285714,36.57142857142857
2546,1798,-15638,6,11,17,35.29,-0.03614705882352941,58.1764705882353
2547,2281,15129,13,6,19,68.42,0.030800000000000004,19.473684210526315
2548,3763,-6313,4,6,10,40.0,-0.025879999999999997,37.1
2597,2646,12144,6,4,10,60.0,0.014149999999999996,62.1
2601,2077,9573,12,9,21,57.14,0.006904761904761903,27.0
2603,1957,5233,6,7,13,46.15,-0.013676923076923078,62.07692307692308
2605,2052,12788,10,4,14,71.43,0.03704285714285715,52.92857142857143
2606,3149,15601,8,4,12,66.67,0.027516666666666665,27.416666666666668
2607,1626,2614,10,7,17,58.82,0.011535294117647055,47.411764705882355
2608,1418,-9068,5,6,11,45.45,-0.016027272727272727,64.27272727272727
2609,2471,24309,13,6,19,68.42,0.03024736842105263,36.526315789473685
2610,1250,-4670,6,9,15,40.0,-0.02084,92.06666666666666
2611,1490,4200,12,7,19,63.16,0.019442105263157896,61.421052631578945
2612,3335,-7125,7,10,17,41.18,-0.023764705882352938,46.588235294117645
2613,1745,-3665,9,10,19,47.37,-0.011884210526315787,57.73684210526316
2614,1081,4909,9,6,15,60.0,0.010706666666666668,29.133333333333333
2615,3142,-5502,9,9,18,50.0,-0.005950000000000001,35.5
2616,1232,-12,5,5,10,50.0,0.0010199999999999994,141.7
2617,2264,8906,10,4,14,71.43,0.03705714285714286,60.642857142857146
2618,1414,-6294,6,10,16,37.5,-0.0313875,47.6875
2630,338,1902,2,1,3,66.67,0.02763333333333333,59.0
2633,521,1369,2,1,3,66.67,0.027433333333333334,140.66666666666666
2634,799,471,2,2,4,50.0,-0.0058,148.0
2636,4145,8095,7,4,11,63.64,0.021418181818181822,43.63636363636363
2637,2119,13431,7,3,10,70.0,0.03417,129.0
2642,2742,10868,7,4,11,63.64,0.021436363636363632,34.09090909090909
2701,1075,-4365,5,9,14,35.71,-0.03207857142857142,131.57142857142858
2702,2360,2840,13,9,22,59.09,0.012045454545454547,64.81818181818181
2704,3301,-12321,8,12,20,40.0,-0.02315,93.3
2705,1522,-5522,9,10,19,47.37,-0.012184210526315789,35.578947368421055
2706,1747,783,8,7,15,53.33,0.0008066666666666657,127.0
2707,26696,45754,10,8,18,55.56,0.005277777777777777,96.55555555555556
2712,331,1169,1,1,2,50.0,-0.006000000000000005,25.0
2722,1530,4920,5,3,8,62.5,0.0191875,108.5
2723,14101,57319,8,5,13,61.54,0.01726153846153846,25.0
2727,6375,74215,7,2,9,77.78,0.04978888888888889,61.666666666666664
2731,4491,6569,5,4,9,55.56,0.005277777777777778,85.77777777777777
2739,969,11,3,3,6,50.0,-0.005883333333333338,44.333333333333336
2748,1452,3388,3,2,5,60.0,0.014120000000000004,70.8
2801,1674,-12464,5,12,17,29.41,-0.04721764705882353,72.47058823529412
2809,1252,228,7,5,12,58.33,0.014924999999999996,40.0
2812,1028,-3638,5,10,15,33.33,-0.03418000000000001,90.93333333333334
2816,2006,-3286,11,11,22,50.0,-0.008627272727272726,35.27272727272727
2820,1108,-7928,4,11,15,26.67,-0.04823333333333334,118.8
2832,1332,-2252,5,7,12,41.67,-0.016175,146.5
2834,873,-3423,5,8,13,38.46,-0.03071538461538462,132.0
2836,1299,-4629,6,9,15,40.0,-0.02662666666666667,142.93333333333334
2838,523,-1013,4,4,8,50.0,-0.008212499999999998,146.0
2845,929,891,7,5,12,58.33,0.009725,79.33333333333333
2849,923,-23,7,6,13,53.85,0.00027692307692307847,40.69230769230769
2850,1845,-6265,6,8,14,42.86,-0.02060714285714286,80.07142857142857
2851,1080,3460,8,5,13,61.54,0.016376923076923074,86.3076923076923
2852,1638,4592,11,8,19,57.89,0.013989473684210526,83.0
2855,1451,5569,10,6,16,62.5,0.018924999999999997,95.125
2867,859,-1809,5,5,10,50.0,-0.006380000000000004,91.9
2880,1552,-4762,5,8,13,38.46,-0.028999999999999995,156.07692307692307
2881,3313,-20983,5,10,15,33.33,-0.04388,53.0
2882,4259,-20409,6,10,16,37.5,-0.030906249999999996,87.0
2883,1654,3226,13,10,23,56.52,0.006060869565217392,50.78260869565217
2884,1264,-7594,4,9,13,30.77,-0.04479230769230769,87.07692307692308
2885,1177,-11297,3,10,13,23.08,-0.060169230769230767,49.23076923076923
2886,1117,1253,5,3,8,62.5,0.010799999999999999,85.375
2887,1321,759,8,7,15,53.33,0.00017333333333333366,81.0
2888,1218,-6458,4,10,14,28.57,-0.05016428571428571,67.85714285714286
2889,479,-859,3,4,7,42.86,-0.02172857142857143,108.42857142857143
2890,988,2392,8,5,13,61.54,0.016330769230769225,80.84615384615384
2891,1414,11346,8,3,11,72.73,0.039609090909090906,77.54545454545455
2892,983,-6963,2,6,8,25.0,-0.04665,110.5
2897,194,1376,2,1,3,66.67,0.055299999999999995,222.0
2901,2722,-5852,9,11,20,45.0,-0.019334999999999998,126.4
2903,2294,26876,13,3,16,81.25,0.0566875,81.9375
2904,1196,1444,6,5,11,54.55,0.0011454545454545454,107.0909090909091
2905,1757,-3797,8,10,18,44.44,-0.01777777777777778,53.666666666666664
2906,719,-2749,4,6,10,40.0,-0.026959999999999994,164.6
2908,1686,-9846,5,10,15,33.33,-0.03927333333333334,112.2
2910,1668,-2698,5,7,12,41.67,-0.016008333333333336,28.666666666666668
2911,1982,-10252,8,11,19,42.11,-0.019031578947368424,61.10526315789474
2912,11631,-58561,5,8,13,38.46,-0.028961538461538462,136.69230769230768
2913,1682,1738,12,8,20,60.0,0.012775,36.2
2915,3746,-11786,8,7,15,53.33,0.000633333333333334,47.666666666666664
2923,748,-2418,2,4,6,33.33,-0.025183333333333332,54.833333333333336
2929,5110,-1030,7,6,13,53.85,0.0017230769230769222,32.53846153846154
2939,285,-5055,0,2,2,0.0,-0.1062,16.5
3002,2192,-2802,12,12,24,50.0,-0.006295833333333331,54.166666666666664
3003,3148,24022,11,4,15,73.33,0.04088,34.2
3004,3100,-5440,6,8,14,42.86,-0.02230714285714286,24.428571428571427
3005,2707,-9397,10,9,19,52.63,-0.0006157894736842077,31.894736842105264
3006,7415,30425,13,9,22,59.09,0.01235909090909091,15.909090909090908
3008,158169,-172619,8,7,15,53.33,0.0008266666666666672,17.866666666666667
3010,4044,-7964,7,8,15,46.67,-0.012546666666666666,67.8
3011,1529,-8469,6,17,23,26.09,-0.05689565217391304,24.347826086956523
3013,1953,-17133,5,14,19,26.32,-0.05366315789473686,34.31578947368421
3014,2714,346,8,5,13,61.54,0.010415384615384615,29.53846153846154
3015,2357,1633,8,7,15,53.33,0.000739999999999998,57.4
3016,3286,4804,11,8,19,57.89,0.009747368421052628,22.68421052631579
3017,2624,-9664,7,12,19,36.84,-0.03223684210526316,22.42105263157895
3018,2589,13301,18,8,26,69.23,0.026792307692307688,26.153846153846153
3019,6353,19777,9,8,17,52.94,2.9411764705880748e-05,17.88235294117647
3021,1625,-3405,10,14,24,41.67,-0.03540833333333333,29.875
3022,3754,-8464,7,10,17,41.18,-0.023552941176470586,56.76470588235294
3023,2632,-23162,5,10,15,33.33,-0.03941333333333333,36.13333333333333
3024,1965,7355,13,11,24,54.17,0.0002416666666666655,49.958333333333336
3025,1420,-4850,8,9,17,47.06,-0.012852941176470593,18.11764705882353
3026,7021,-32891,7,14,21,33.33,-0.03923809523809524,46.76190476190476
3027,1879,6321,12,7,19,63.16,0.019731578947368423,44.473684210526315
3028,1374,-2354,7,6,13,53.85,-0.0057769230769230805,87.3076923076923
3029,1641,-8561,5,11,16,31.25,-0.04001875,29.375
3030,4035,13105,11,6,17,64.71,0.02358235294117647,56.88235294117647
3031,2546,18284,15,5,20,75.0,0.043895,20.75
3032,2706,9974,14,9,23,60.87,0.01527391304347826,30.956521739130434
3033,1850,8080,11,7,18,61.11,0.015927777777777777,123.66666666666667
3034,19480,-45390,9,13,22,40.91,-0.020850000000000004,22.636363636363637
3035,6416,8624,9,9,18,50.0,-0.00585,36.833333333333336
3036,2396,21124,10,2,12,83.33,0.05385,60.666666666666664
3037,1486,-3376,5,6,11,45.45,-0.015127272727272722,35.90909090909091
3038,2531,-6951,12,15,27,44.44,-0.018607407407407406,26.296296296296298
3040,3249,11841,15,10,25,60.0,0.013727999999999997,44.28
3041,3921,8619,14,8,22,63.64,0.021359090909090907,20.454545454545453
3042,4524,-4914,9,11,20,45.0,-0.0159,44.05
3043,3338,-558,15,12,27,55.56,0.0005222222222222212,12.074074074074074
3044,6283,68097,12,2,14,85.71,0.059178571428571435,13.428571428571429
3045,5693,-64163,3,9,12,25.0,-0.0636,181.75
3046,2515,5425,21,12,33,63.64,0.019406060606060607,21.242424242424242
3047,2008,3482,13,9,22,59.09,0.011277272727272726,34.31818181818182
3048,2650,30520,14,4,18,77.78,0.049327777777777776,40.5
3049,1036,3384,10,5,15,66.67,0.02515333333333333,20.733333333333334
3050,1669,4181,13,8,21,61.9,0.019628571428571422,28.714285714285715
3051,3078,33252,21,8,29,72.41,0.03250344827586207,14.793103448275861
3052,1426,7984,15,7,22,68.18,0.02727727272727273,47.45454545454545
3054,2340,10670,12,7,19,63.16,0.019915789473684213,32.10526315789474
3055,1970,-9200,6,11,17,35.29,-0.04057058823529411,46.588235294117645
3056,1841,4079,9,9,18,50.0,-0.008149999999999998,38.0
3057,1808,-108,10,9,19,52.63,-0.0012947368421052615,18.68421052631579
3058,1820,12770,17,6,23,73.91,0.04069565217391304,34.65217391304348
3059,5347,10773,13,14,27,48.15,-0.009607407407407408,23.62962962962963
3060,6359,12071,14,7,21,66.67,0.027538095238095233,30.857142857142858
3062,2404,-904,9,8,17,52.94,-5.8823529411766395e-06,25.176470588235293
3090,2980,-5690,8,7,15,53.33,0.0008066666666666676,28.533333333333335
3094,2204,2286,7,8,15,46.67,-0.012593333333333335,27.8
3130,6656,7694,4,4,8,50.0,-0.005850000000000001,88.375
3138,3558,-8748,11,5,16,68.75,0.029775000000000003,45.4375
3149,2332,4128,11,5,16,68.75,0.0313125,23.125
3164,2920,-5000,7,9,16,43.75,-0.018437500000000002,38.9375
3167,1239,-6589,2,5,7,28.57,-0.04877142857142857,35.57142857142857
3189,7850,-32600,5,11,16,31.25,-0.043393749999999995,20.25
3209,2108,1732,8,9,17,47.06,-0.01182941176470588,52.588235294117645
3229,2272,11128,16,10,26,61.54,0.01633076923076923,26.73076923076923
3231,2159,2061,8,5,13,61.54,0.01721538461538461,42.46153846153846
3257,3451,11569,6,4,10,60.0,0.014159999999999997,26.2
3266,2391,4319,12,10,22,54.55,0.0028363636363636364,46.90909090909091
3296,3205,26335,14,8,22,63.64,0.021400000000000006,26.681818181818183
3305,5690,-12030,11,9,20,55.0,0.004170000000000001,42.9
3308,1101,-2331,7,8,15,46.67,-0.014526666666666665,23.133333333333333
3311,5469,6231,9,9,18,50.0,-0.005877777777777778,31.38888888888889
3312,993,2897,8,5,13,61.54,0.01621538461538461,34.61538461538461
3321,674,7656,7,1,8,87.5,0.06885,21.375
3338,2414,426,7,5,12,58.33,0.010833333333333334,19.0
3346,2331,-20601,3,5,8,37.5,-0.030937499999999996,26.0
3356,9148,-40948,8,9,17,47.06,-0.011758823529411766,32.529411764705884
3376,11863,65937,11,6,17,64.71,0.023605882352941174,32.411764705882355
3380,1772,-11522,5,8,13,38.46,-0.029,21.615384615384617
3406,23602,80288,14,5,19,73.68,0.04158947368421053,15.631578947368421
3413,3672,-37912,1,3,4,25.0,-0.055925,32.25
3416,4219,7361,7,6,13,53.85,0.0018538461538461577,58.61538461538461
3419,1819,171,9,6,15,60.0,0.013873333333333338,21.133333333333333
3432,1014,3516,6,5,11,54.55,0.0027636363636363644,25.0
3437,1588,12112,6,2,8,75.0,0.044137499999999996,10.5
3443,9498,-6748,6,5,11,54.55,0.003254545454545453,40.18181818181818
3450,5697,1903,9,9,18,50.0,-0.005894444444444446,21.22222222222222
3454,7151,-26541,6,11,17,35.29,-0.03531764705882353,30.470588235294116
3481,2418,10772,7,9,16,43.75,-0.0187,16.875
3494,1765,6505,11,8,19,57.89,0.008505263157894734,32.94736842105263
3501,3452,20418,9,5,14,64.29,0.025771428571428567,71.71428571428571
3504,8275,27355,11,12,23,47.83,-0.010204347826086955,16.434782608695652
3515,7788,47262,9,6,15,60.0,0.009339999999999998,71.4
3518,4731,14009,11,10,21,52.38,-0.0011190476190476187,28.952380952380953
3528,1755,-12835,3,6,9,33.33,-0.03922222222222222,130.77777777777777
3530,3905,27745,9,5,14,64.29,0.021992857142857144,30.0
3532,5410,17930,9,7,16,56.25,0.006643749999999999,36.1875
3533,10831,-97791,6,9,15,40.0,-0.0259,32.46666666666667
3535,1950,-3930,10,8,18,55.56,0.004688888888888888,15.61111111111111
3536,1506,1124,12,11,23,52.17,-0.004830434782608697,31.91304347826087
3543,3949,40691,14,7,21,66.67,0.027257142857142858,26.952380952380953
3545,3537,-38897,3,10,13,23.08,-0.053861538461538454,13.076923076923077
3550,970,2800,6,5,11,54.55,0.00280909090909091,41.36363636363637
3557,1384,2246,11,3,14,78.57,0.04889285714285714,18.428571428571427
3563,4403,72707,7,0,7,100.0,0.09429999999999998,30.571428571428573
3576,1763,-5043,5,6,11,45.45,-0.015354545454545454,36.27272727272727
3583,2105,23005,5,1,6,83.33,0.06091666666666667,77.33333333333333
3588,4625,-7415,7,5,12,58.33,0.004333333333333331,23.083333333333332
3591,1948,11532,8,5,13,61.54,0.017099999999999997,22.76923076923077
3593,1491,3009,11,8,19,57.89,0.008221052631578945,20.789473684210527
3596,3473,8267,7,6,13,53.85,0.0018538461538461547,32.0
3605,1448,-4438,4,4,8,50.0,-0.005862500000000003,27.625
3607,2414,7786,9,4,13,69.23,0.032600000000000004,52.23076923076923
3617,2915,17865,5,2,7,71.43,0.03707142857142857,109.71428571428571
3622,5863,-46853,10,6,16,62.5,0.01915,14.8125
3645,1377,5343,4,3,7,57.14,0.00837142857142857,18.428571428571427
3653,4963,2917,6,3,9,66.67,0.027544444444444444,38.111111111111114
3661,1064,3696,2,2,4,50.0,-0.005850000000000001,6.25
3665,6644,-43394,3,6,9,33.33,-0.039233333333333335,13.333333333333334
3669,2454,-5824,6,8,14,42.86,-0.020107142857142858,28.071428571428573
3673,14117,120823,8,4,12,66.67,0.027541666666666662,23.666666666666668
3679,2924,-10044,4,5,9,44.44,-0.01698888888888889,29.77777777777778
3682,1031,2609,9,6,15,60.0,0.01945333333333333,55.6
3686,1564,-3774,9,8,17,52.94,-0.0012117647058823525,16.0
3694,1487,-9097,4,9,13,30.77,-0.04443846153846154,32.76923076923077
3701,1321,-551,12,7,19,63.16,0.015599999999999998,44.473684210526315
3702,2352,2848,7,4,11,63.64,0.02141818181818182,45.18181818181818
3703,629,-1049,4,4,8,50.0,-0.006725000000000002,124.125
3704,1566,2674,9,7,16,56.25,0.006443750000000002,38.0625
3705,1299,4961,3,2,5,60.0,0.01416,421.6
3706,780,-2830,2,3,5,40.0,-0.02596,75.8
3708,2283,-7093,2,3,5,40.0,-0.025880000000000004,36.2
3711,1250,-22080,0,3,3,0.0,-0.106,30.666666666666668
3712,89,1481,1,0,1,100.0,0.094,10.0
3714,835,13815,2,0,2,100.0,0.0943,11.0
4104,5485,-17815,9,11,20,45.0,-0.01588,109.45
4106,3027,-10997,8,10,18,44.44,-0.017005555555555555,33.166666666666664
4108,4127,-8157,12,12,24,50.0,-0.005841666666666666,33.541666666666664
4119,3605,-41095,3,9,12,25.0,-0.05594999999999999,66.08333333333333
4133,3395,-10155,5,8,13,38.46,-0.02898461538461538,78.53846153846153
4137,10626,97374,8,2,10,80.0,0.04485,21.8
4142,1448,-8498,2,5,7,28.57,-0.048857142857142856,16.0
4155,2213,11477,8,3,11,72.73,0.039636363636363636,33.45454545454545
4164,2679,27841,6,2,8,75.0,0.0441875,33.625
4190,4472,5028,5,4,9,55.56,0.005277777777777776,51.333333333333336
4306,1731,11769,12,6,18,66.67,0.024800000000000003,63.44444444444444
4414,1876,3584,14,11,25,56.0,0.0034000000000000007,44.2
4426,7349,35411,18,10,28,64.29,0.022471428571428566,21.785714285714285
4438,5615,49935,6,2,8,75.0,0.044225,48.0
4439,785,12965,1,0,1,100.0,0.0943,152.0
4526,3242,15318,12,7,19,63.16,0.020484210526315785,56.0
4532,2126,6494,11,6,17,64.71,0.02317058823529412,51.23529411764706
4536,5181,-14221,3,4,7,42.86,-0.020157142857142856,90.71428571428571
4540,2031,1969,5,4,9,55.56,0.0052444444444444465,64.11111111111111
4545,1748,-8858,3,6,9,33.33,-0.039266666666666665,55.0
4551,4824,-25284,2,4,6,33.33,-0.039233333333333335,13.166666666666666
4552,3452,10638,6,3,9,66.67,0.02751111111111111,53.333333333333336
4555,1315,115,2,2,4,50.0,-0.005875000000000002,92.5
4557,773,-403,1,1,2,50.0,-0.005850000000000001,55.5
4560,1311,249,3,2,5,60.0,0.00032000000000000084,77.8
4562,1273,7537,5,3,8,62.5,0.0320375,123.625
4564,1359,22461,6,0,6,100.0,0.09431666666666666,47.833333333333336
4566,2137,1663,4,4,8,50.0,-0.005875000000000002,52.75
4571,1420,5010,2,1,3,66.67,0.02753333333333333,26.0
4572,2377,2583,2,2,4,50.0,-0.005850000000000001,19.5
4576,2270,-19830,1,3,4,25.0,-0.055925,24.0
4581,417,-567,1,1,2,50.0,-0.005950000000000004,119.5
4720,1332,15518,13,2,15,86.67,0.06728666666666666,87.13333333333334
4722,1974,-314,9,9,18,50.0,-0.0063722222222222236,70.27777777777777
4737,3987,10383,6,4,10,60.0,0.014180000000000003,45.2
4739,1753,-6903,2,3,5,40.0,-0.025880000000000004,63.0
4746,3821,469,5,7,12,41.67,-0.02256666666666667,33.916666666666664
4755,1165,1955,3,3,6,50.0,-0.005850000000000004,43.166666666666664
4763,2978,3172,2,2,4,50.0,-0.005850000000000001,88.75
4764,1863,13807,4,1,5,80.0,0.03866,90.0
4766,1616,26684,2,0,2,100.0,0.0943,125.0
4807,1469,3181,4,2,6,66.67,0.02753333333333333,82.0
4904,3124,-2914,4,5,9,44.44,-0.007677777777777779,278.22222222222223
4906,2847,-10137,6,7,13,46.15,-0.013600000000000004,15.76923076923077
4912,3196,12534,4,2,6,66.67,0.027516666666666672,33.0
4915,1258,-7908,2,3,5,40.0,-0.025939999999999998,30.6
4916,1507,-1567,4,5,9,44.44,-0.017011111111111112,28.555555555555557
4919,2011,9289,6,4,10,60.0,0.014169999999999999,19.8
4927,1396,11554,3,1,4,75.0,0.044225,30.25
4930,1573,-7863,7,9,16,43.75,-0.0186875,40.0625
4934,448,252,4,2,6,66.67,0.025783333333333335,41.166666666666664
4935,2960,32810,8,2,10,80.0,0.054220000000000004,28.3
4938,2869,-13759,4,5,9,44.44,-0.016966666666666668,69.44444444444444
4942,1856,-626,5,5,10,50.0,-0.0059,81.5
4943,1324,21116,6,0,6,100.0,0.08644999999999999,22.333333333333332
4952,1926,16504,7,2,9,77.78,0.04574444444444445,32.22222222222222
4956,1015,7815,7,2,9,77.78,0.0496,32.55555555555556
4958,4952,-65022,1,9,10,10.0,-0.08596999999999999,45.2
4960,966,-2926,6,5,11,54.55,0.0024545454545454592,23.363636363636363
4961,4154,12926,8,5,13,61.54,0.017284615384615384,30.615384615384617
4967,1701,3199,7,6,13,53.85,0.0012076923076923091,20.76923076923077
4968,3297,38383,4,1,5,80.0,0.05424,16.8
4976,1865,30825,8,0,8,100.0,0.09432499999999999,24.375
4977,3733,-20513,3,5,8,37.5,-0.030887500000000002,19.0
4989,941,4459,8,3,11,72.73,0.03675454545454546,45.27272727272727
4994,9661,89449,12,6,18,66.67,0.02752777777777778,26.0
4999,1855,14005,5,2,7,71.43,0.037085714285714284,124.0
5007,2855,9545,7,5,12,58.33,0.010799999999999999,104.5
5203,8266,-26186,6,9,15,40.0,-0.025879999999999997,50.666666666666664
5215,3171,4279,6,6,12,50.0,-0.005883333333333334,45.083333333333336
5225,3387,5033,7,7,14,50.0,-0.005885714285714287,26.214285714285715
5234,4966,-22236,5,8,13,38.46,-0.029,29.076923076923077
5243,1621,-5961,3,4,7,42.86,-0.02017142857142857,33.57142857142857
5258,1104,5666,5,3,8,62.5,0.019125000000000003,21.75
5269,20083,86827,4,2,6,66.67,0.021150000000000002,11.166666666666666
5283,1532,-4942,1,3,4,25.0,-0.05595,70.25
5284,2181,15419,5,2,7,71.43,0.03705714285714286,79.28571428571429
5285,2194,17796,6,1,7,85.71,0.06564285714285714,57.857142857142854
5288,2774,-13234,2,3,5,40.0,-0.025880000000000004,38.8
5388,3344,-5164,8,7,15,53.33,0.0007466666666666667,34.266666666666666
5434,5181,-11241,7,9,16,43.75,-0.018375000000000002,38.0
5469,1952,-812,8,8,16,50.0,-0.006231250000000001,26.75
5471,5039,-50989,4,12,16,25.0,-0.0511375,27.5
5484,2890,9640,16,10,26,61.54,0.015661538461538463,33.0
5515,1563,-9243,7,12,19,36.84,-0.032794736842105265,79.84210526315789
5519,2228,12142,11,7,18,61.11,0.021944444444444444,63.44444444444444
5521,1871,-731,12,14,26,46.15,-0.014896153846153845,39.88461538461539
5522,3702,-2452,7,9,16,43.75,-0.0184625,44.0625
5525,1318,4402,6,5,11,54.55,0.00930909090909091,105.72727272727273
5531,3474,6866,14,10,24,58.33,0.007329166666666664,48.083333333333336
5533,1141,-6221,4,8,12,33.33,-0.039483333333333336,186.58333333333334
5534,6872,308,10,11,21,47.62,-0.010652380952380948,53.714285714285715
5538,1208,672,3,3,6,50.0,-0.0058666666666666685,62.166666666666664
5546,1427,-5327,2,2,4,50.0,-0.02635,46.5
5607,2149,3631,9,7,16,56.25,0.006674999999999997,50.125
5608,2196,28624,15,1,16,93.75,0.07880000000000001,68.3125
5706,2711,-9461,4,7,11,36.36,-0.03336363636363636,131.54545454545453
5871,387,6393,1,0,1,100.0,0.0943,19.0
5876,774,-324,2,2,4,50.0,-0.005875000000000005,70.0
5880,381,-3631,1,3,4,25.0,-0.056,131.5
5906,981,-6231,5,6,11,45.45,-0.018463636363636363,26.818181818181817
5907,3052,16528,8,6,14,57.14,0.014849999999999999,33.785714285714285
6005,1523,1107,10,10,20,50.0,-0.006839999999999999,57.05
6024,1377,10793,5,2,7,71.43,0.037028571428571425,164.57142857142858
6108,2476,-186,11,9,20,55.0,0.003975,36.25
6112,2979,-3629,11,11,22,50.0,-0.006204545454545452,83.22727272727273
6115,3473,18657,10,6,16,62.5,0.024293750000000003,83.625
6116,1432,5808,16,7,23,69.57,0.027765217391304352,19.956521739130434
6117,2565,10755,14,10,24,58.33,0.010583333333333332,42.666666666666664
6120,3047,26563,18,6,24,75.0,0.04372916666666666,23.333333333333332
6128,3149,-2869,9,9,18,50.0,-0.005916666666666667,57.27777777777778
6133,1370,5330,10,7,17,58.82,0.010664705882352944,51.11764705882353
6136,3588,23462,13,9,22,59.09,0.012281818181818182,72.5
6139,5108,-14368,11,12,23,47.83,-0.010199999999999997,42.43478260869565
6141,2959,7101,13,13,26,50.0,-0.002238461538461538,35.73076923076923
6142,1736,-1516,11,10,21,52.38,-0.003280952380952381,21.571428571428573
6152,2430,7750,13,7,20,65.0,0.023285,44.7
6153,3268,-17168,8,11,19,42.11,-0.021873684210526313,26.894736842105264
6155,2713,3177,9,10,19,47.37,-0.011178947368421054,62.73684210526316
6164,2445,4645,17,12,29,58.62,0.01057241379310345,26.20689655172414
6165,1360,3840,10,7,17,58.82,0.009823529411764708,29.11764705882353
6166,4401,5709,11,9,20,55.0,0.004160000000000001,34.65
6168,2074,13616,12,6,18,66.67,0.02725555555555555,11.944444444444445
6176,5035,33265,10,4,14,71.43,0.037078571428571426,20.857142857142858
6177,2026,744,7,9,16,43.75,-0.018687499999999996,45.6875
6183,1853,-5413,9,6,15,60.0,0.013793333333333336,105.86666666666666
6184,2799,-10099,5,8,13,38.46,-0.029,119.53846153846153
6189,2387,-7387,7,7,14,50.0,-0.005900000000000002,53.92857142857143
6191,3004,-3914,9,12,21,42.86,-0.02085714285714286,27.80952380952381
6192,4457,-9097,6,9,15,40.0,-0.025873333333333335,56.6
6196,2714,14036,8,7,15,53.33,0.0006199999999999984,27.933333333333334
6197,3722,14728,9,7,16,56.25,0.0066500000000000005,30.6875
6201,2689,9221,9,6,15,60.0,0.014160000000000006,84.8
6202,4067,-11987,7,8,15,46.67,-0.01677333333333333,36.733333333333334
6205,3298,-10218,9,10,19,47.37,-0.011131578947368425,39.578947368421055
6206,7482,11018,10,8,18,55.56,0.005277777777777779,80.33333333333333
6209,3803,7607,11,10,21,52.38,-0.001176190476190477,21.904761904761905
6213,3336,-17556,8,9,17,47.06,-0.011758823529411763,20.11764705882353
6214,3546,5724,8,6,14,57.14,0.005064285714285713,37.5
6215,2471,12869,11,7,18,61.11,0.016172222222222223,24.833333333333332
6216,3789,26391,12,6,18,66.67,0.027438888888888895,91.0
6224,5659,9141,12,7,19,63.16,0.02051578947368421,65.84210526315789
6225,2228,13402,18,10,28,64.29,0.018550000000000004,17.392857142857142
6226,1522,5758,14,8,22,63.64,0.01977727272727273,29.59090909090909
6230,7417,18703,7,7,14,50.0,-0.0058571428571428585,30.928571428571427
6235,1575,-6025,5,8,13,38.46,-0.03041538461538462,14.846153846153847
6239,3720,-47020,1,8,9,11.11,-0.08374444444444445,42.333333333333336
6243,3228,23532,14,6,20,70.0,0.033985,19.0
6257,2127,-6427,7,7,14,50.0,-0.01075,28.714285714285715
6269,6279,-26179,9,8,17,52.94,-2.941176470588401e-05,19.764705882352942
6271,5836,-22846,5,4,9,55.56,0.0052555555555555585,14.333333333333334
6277,6845,33275,11,5,16,68.75,0.027843749999999997,107.25
6278,4560,-18340,6,9,15,40.0,-0.02588,37.6
6281,2848,8272,5,4,9,55.56,0.016277777777777776,229.55555555555554
6282,1411,6149,8,4,12,66.67,0.027425,51.916666666666664
6283,3423,24187,21,7,28,75.0,0.04321785714285714,17.392857142857142
6285,3440,10970,5,5,10,50.0,-0.005879999999999999,29.7
6288,1436,2754,11,6,17,64.71,0.02128823529411764,27.352941176470587
6405,1213,5557,5,4,9,55.56,0.005222222222222221,18.0
6409,2756,45544,1,0,1,100.0,0.0943,20.0
6412,1935,-7345,3,3,6,50.0,-0.005849999999999998,66.33333333333333
6414,8678,-84928,1,4,5,20.0,-0.06594,9.8
6415,41136,-583786,2,4,6,33.33,-0.039233333333333335,13.5
6416,5598,30082,6,4,10,60.0,0.014179999999999998,25.2
6431,798,10952,6,1,7,85.71,0.06547142857142857,38.857142857142854
6438,1613,-17343,1,3,4,25.0,-0.05595,26.5
6442,1427,-977,3,3,6,50.0,-0.005849999999999998,34.0
6443,771,-581,4,2,6,66.67,0.0267,23.833333333333332
6449,1507,8393,4,2,6,66.67,0.027499999999999997,34.166666666666664
6451,3007,-6337,2,3,5,40.0,-0.025880000000000004,25.4
6456,5728,-60108,2,5,7,28.57,-0.04877142857142857,19.571428571428573
6464,3188,30652,4,1,5,80.0,0.05424,191.6
6477,422,-4042,1,2,3,33.33,-0.039233333333333335,67.66666666666667
6491,2954,34136,4,1,5,80.0,0.05424,36.0
6504,9262,40658,7,4,11,63.64,0.021463636363636362,52.18181818181818
6505,5716,3794,6,6,12,50.0,-0.005850000000000001,93.0
6515,1561,-27611,0,1,1,0.0,-0.106,5.0
6525,1711,-5071,2,3,5,40.0,-0.025880000000000004,60.4
6531,14789,8171,6,4,10,60.0,0.00753,18.4
6533,5246,7954,3,1,4,75.0,0.044225,26.25
6541,3058,24782,5,3,8,62.5,0.019174999999999998,25.5
6552,1029,16961,3,0,3,100.0,0.0943,43.0
6558,839,6941,3,1,4,75.0,0.044149999999999995,16.75
6573,1166,3234,4,3,7,57.14,0.00844285714285714,20.0
6579,2643,-713,3,3,6,50.0,-0.005850000000000001,80.0
6581,1664,10066,2,1,3,66.67,0.02753333333333333,82.66666666666667
6582,4928,8162,4,3,7,57.14,0.008457142857142854,35.714285714285715
6591,1319,1381,2,2,4,50.0,-0.005850000000000001,19.5
6592,584,-10324,0,1,1,0.0,-0.106,39.0
6598,1922,1258,4,4,8,50.0,-0.005887500000000002,11.75
6605,5769,-8419,6,7,13,46.15,-0.01355384615384615,72.15384615384616
6625,1807,2863,4,4,8,50.0,-0.0059000000000000025,52.25
6641,1423,9587,3,1,4,75.0,0.035124999999999997,68.0
6655,538,752,1,1,2,50.0,-0.0059000000000000025,58.0
6666,2464,40696,4,0,4,100.0,0.0943,31.5
6668,1246,-12816,1,3,4,25.0,-0.055925,31.0
6669,9132,150868,2,0,2,100.0,0.0943,4.5
6670,2344,-41444,0,2,2,0.0,-0.106,25.5
6671,420,6930,2,0,2,100.0,0.0943,39.5
6672,2284,11586,3,1,4,75.0,0.044225,32.5
6674,652,2938,3,1,4,75.0,0.024975,38.5
6698,1187,-14477,1,4,5,20.0,-0.06594,26.8
6706,1883,31117,2,0,2,100.0,0.0943,23.0
6715,593,-10493,0,1,1,0.0,-0.106,24.0
6743,1554,4066,2,1,3,66.67,0.02753333333333333,7.0
6754,241,-4271,0,1,1,0.0,-0.1061,60.0
6756,1366,-24166,0,1,1,0.0,-0.106,11.0
8011,2130,-580,8,10,18,44.44,-0.018200000000000004,20.0
8016,7592,-34872,6,8,14,42.86,-0.020178571428571428,35.5
8021,2120,12420,6,5,11,54.55,0.0031272727272727233,41.54545454545455
8028,1405,-3555,6,6,12,50.0,-0.00909166666666667,9.583333333333334
8033,2242,3468,12,12,24,50.0,-0.006775000000000001,19.208333333333332
8039,5497,-3427,11,12,23,47.83,-0.01177391304347826,33.95652173913044
8046,6808,-15518,5,5,10,50.0,-0.005890000000000001,31.7
8070,6885,-6095,7,6,13,53.85,0.0018384615384615377,26.76923076923077
8072,7538,9192,10,11,21,47.62,-0.01061904761904762,76.52380952380952
8081,8117,71323,9,4,13,69.23,0.03266923076923077,29.384615384615383
8101,1843,4177,15,8,23,65.22,0.020839130434782614,24.73913043478261
8103,2417,8793,8,5,13,61.54,0.01719230769230769,35.92307692307692
8104,2934,-13964,6,9,15,40.0,-0.027566666666666663,19.866666666666667
8105,965,4735,8,4,12,66.67,0.026116666666666667,16.583333333333332
8110,1109,-3019,7,8,15,46.67,-0.013699999999999997,20.866666666666667
8112,2001,-431,9,9,18,50.0,-0.010633333333333333,29.22222222222222
8114,7612,-2382,7,6,13,53.85,0.0018538461538461536,55.23076923076923
8131,1661,3839,6,4,10,60.0,0.014130000000000004,36.9
8150,1569,-5179,4,4,8,50.0,-0.017487499999999996,34.125
8163,2488,13122,9,7,16,56.25,0.006643749999999999,16.5625
8201,1771,4529,9,9,18,50.0,-0.006833333333333334,41.666666666666664
8210,4053,-10333,9,9,18,50.0,-0.0059833333333333336,58.05555555555556
8213,2891,12349,8,5,13,61.54,0.024223076923076924,48.61538461538461
8215,1677,7293,8,5,13,61.54,0.017023076923076922,22.76923076923077
8222,961,1979,5,4,9,55.56,0.0050444444444444425,48.888888888888886
8249,2328,25042,13,3,16,81.25,0.056525,33.1875
8261,2443,4737,8,8,16,50.0,-0.006006250000000001,23.5625
8271,1350,5930,5,3,8,62.5,0.019125,49.125
8341,6235,615,3,2,5,60.0,-0.0007800000000000009,119.8
8367,923,8157,3,1,4,75.0,0.044175000000000006,28.5
8374,2574,9816,11,6,17,64.71,0.02358235294117647,37.0
8404,1736,-16426,3,8,11,27.27,-0.05143636363636364,94.9090909090909
8411,2574,12256,10,3,13,76.92,0.048053846153846155,28.692307692307693
8422,4981,46819,4,1,5,80.0,0.05424,268.0
8429,1632,3668,6,3,9,66.67,0.02722222222222222,35.55555555555556
8442,1673,-8343,2,4,6,33.33,-0.03925,103.66666666666667
8443,770,5560,6,2,8,75.0,0.0438125,104.125
8454,12332,126568,3,2,5,60.0,0.014179999999999998,53.2
8462,4824,5046,3,3,6,50.0,-0.005850000000000004,51.833333333333336
8463,1633,-10393,3,7,10,30.0,-0.037720000000000004,88.4
8464,10294,69206,4,2,6,66.67,0.02753333333333333,27.666666666666668
8466,3016,25854,6,1,7,85.71,0.06568571428571428,79.28571428571429
8467,1657,7353,5,3,8,62.5,0.019224999999999996,71.75
8473,2438,-15528,3,6,9,33.33,-0.039233333333333335,97.55555555555556
8478,3667,33783,6,1,7,85.71,0.06565714285714286,20.142857142857142
8480,2325,675,2,2,4,50.0,-0.005850000000000001,93.75
8481,1039,-3569,1,2,3,33.33,-0.039233333333333335,71.0
8482,1198,-6538,1,1,2,50.0,-0.005850000000000001,37.0
8488,984,8056,5,3,8,62.5,0.0293125,41.5
8499,2525,-7065,2,2,4,50.0,-0.005850000000000001,48.25
8926,1223,-8673,5,8,13,38.46,-0.02929230769230769,83.3076923076923
8940,2003,2407,10,8,18,55.56,0.005161111111111112,97.27777777777777
8996,4514,-2344,9,8,17,52.94,5.294117647058649e-05,30.176470588235293
9802,2534,3076,4,2,6,66.67,0.027516666666666672,28.5
9902,1810,-4570,12,16,28,42.86,-0.02311071428571429,35.0
9904,2287,-1077,7,7,14,50.0,-0.0058214285714285685,80.5
9905,1568,-2958,5,8,13,38.46,-0.02912307692307692,77.15384615384616
9906,1590,2140,11,5,16,68.75,0.019143749999999998,13.25
9907,1481,-2631,8,11,19,42.11,-0.0226,55.89473684210526
9908,1278,-7858,4,8,12,33.33,-0.04626666666666667,154.83333333333334
9910,9546,-17806,9,7,16,56.25,0.00665,50.9375
9911,1088,522,5,6,11,45.45,-0.015790909090909088,61.54545454545455
9912,1761,-2611,12,14,26,46.15,-0.015703846153846155,28.807692307692307
9914,12766,-9456,9,7,16,56.25,0.004043749999999998,22.625
9917,2654,-19304,2,6,8,25.0,-0.055925,240.875
9918,1776,-9926,3,8,11,27.27,-0.04192727272727272,109.63636363636364
9919,2045,1195,10,10,20,50.0,-0.006184999999999999,69.75
9921,11460,1290,8,6,14,57.14,0.008457142857142856,40.142857142857146
9924,2636,-7686,7,8,15,46.67,-0.012586666666666666,71.4
9925,1386,-8326,3,6,9,33.33,-0.03928888888888889,131.77777777777777
9926,1248,-14218,1,6,7,14.29,-0.07740000000000001,191.0
9927,2839,-2549,8,9,17,47.06,-0.011794117647058825,58.294117647058826
9928,1912,-162,13,11,24,54.17,0.0007833333333333361,35.333333333333336
9929,1396,1874,12,11,23,52.17,-0.0071869565217391315,39.08695652173913
9930,2512,13698,6,3,9,66.67,0.027533333333333333,98.44444444444444
9931,1333,-8433,2,6,8,25.0,-0.04305,159.625
9933,3654,-9354,8,10,18,44.44,-0.017005555555555555,43.77777777777778
9934,2481,6499,13,9,22,59.09,0.01225,49.18181818181818
9935,2068,-6168,10,14,24,41.67,-0.02423333333333334,30.291666666666668
9937,2165,-6785,5,7,12,41.67,-0.014900000000000002,159.5
9938,3835,-2595,8,6,14,57.14,0.008228571428571429,34.5
9939,3768,-10278,5,7,12,41.67,-0.022574999999999998,33.083333333333336
9940,6643,-6253,11,12,23,47.83,-0.007317391304347826,37.21739130434783
9941,5256,2074,7,6,13,53.85,-0.0016846153846153842,65.53846153846153
9942,4336,-11006,6,7,13,46.15,-0.013553846153846156,87.46153846153847
9943,3188,-11268,6,11,17,35.29,-0.029658823529411765,127.29411764705883
9944,2483,-10643,8,12,20,40.0,-0.02597,47.5
9945,2313,8697,9,5,14,64.29,0.02811428571428572,38.857142857142854
9946,1264,2446,10,7,17,58.82,0.010623529411764704,37.76470588235294
9955,2996,-3586,8,11,19,42.11,-0.021794736842105266,53.0
9958,2801,2079,8,5,13,61.54,0.012946153846153845,56.0
1312A,1371,-4251,5,7,12,41.67,-0.014674999999999999,130.66666666666666
2002A,1404,-8414,2,4,6,33.33,-0.04231666666666667,588.3333333333334
2836A,132,18,1,0,1,100.0,0.0008,447.0
2838A,307,593,1,0,1,100.0,0.0113,729.0
2881A,375,3725,1,0,1,100.0,0.0572,1177.0
2881B,359,1241,1,0,1,100.0,0.0201,511.0
2882A,362,2138,1,0,1,100.0,0.0342,1464.0
2882B,361,1939,1,0,1,100.0,0.0311,560.0
2887E,309,1691,1,0,1,100.0,0.0317,738.0
2887F,303,2547,1,0,1,100.0,0.0486,751.0
2888A,248,3802,1,0,1,100.0,0.0874,640.0
2888B,236,1114,1,0,1,100.0,0.0274,415.0
2891B,375,3525,1,0,1,100.0,0.0541,717.0
2891C,359,941,1,0,1,100.0,0.0153,640.0
2897A,71,969,1,0,1,100.0,0.0936,307.0
3702A,0,0,0,0,0,0.0,,
5871A,0,0,0,0,0,0.0,,
9941A,301,599,1,0,1,100.0,0.0116,664.0
1240,1183,-5013,2,2,4,50.0,-0.023275,85.0
1258,1451,6099,6,3,9,66.67,0.027488888888888882,70.44444444444444
1259,5193,1547,5,5,10,50.0,-0.005850000000000001,197.0
1264,10208,-15108,3,5,8,37.5,-0.018600000000000002,106.75
1268,3987,23413,4,1,5,80.0,0.036059999999999995,185.8
1336,785,5715,7,2,9,77.78,0.04921111111111111,43.77777777777778
1565,29087,9953,7,8,15,46.67,-0.012526666666666667,33.0
1569,2770,-14050,9,11,20,45.0,-0.016120000000000002,19.35
1570,1528,4642,11,7,18,61.11,0.015322222222222225,32.55555555555556
1580,9430,-77650,5,10,15,33.33,-0.039246666666666666,52.86666666666667
1584,861,8609,8,2,10,80.0,0.05362,42.0
1586,1216,954,4,3,7,57.14,0.00032857142857142807,111.0
1591,2001,16249,9,4,13,69.23,0.03257692307692308,32.76923076923077
1593,905,7045,2,1,3,66.67,0.02753333333333333,18.333333333333332
1595,2136,10154,5,3,8,62.5,0.019187500000000003,54.0
1599,1810,450,4,4,8,50.0,-0.005875000000000005,59.875
1742,3415,28705,18,6,24,75.0,0.044104166666666667,32.083333333333336
1752,2322,-15612,3,8,11,27.27,-0.046109090909090905,72.0909090909091
1777,3332,-28042,3,8,11,27.27,-0.05137272727272728,78.0
1781,3892,6408,15,11,26,57.69,0.009119230769230767,23.115384615384617
1784,3916,-42236,4,13,17,23.53,-0.05888823529411765,35.411764705882355
1785,5365,-8675,8,7,15,53.33,-0.00494,10.466666666666667
1788,3045,-23095,2,4,6,33.33,-0.039233333333333335,156.16666666666666
1796,1704,-2534,4,3,7,57.14,0.008428571428571426,34.857142857142854
1799,1312,-2562,6,8,14,42.86,-0.020664285714285715,21.714285714285715
1813,1477,10203,6,2,8,75.0,0.044225,75.875
1815,1324,-194,8,7,15,53.33,0.0003333333333333355,28.0
2035,2857,-19847,4,11,15,26.67,-0.05261999999999999,116.66666666666667
2061,1085,2155,7,6,13,53.85,0.0010000000000000009,25.615384615384617
2063,2208,-3608,4,6,10,40.0,-0.0259,75.6
2064,653,4807,5,2,7,71.43,0.0369,92.85714285714286
2065,156,-2756,0,1,1,0.0,-0.106,12.0
2066,3246,7244,4,3,7,57.14,0.008457142857142856,71.28571428571429
2067,404,216,3,2,5,60.0,0.0031600000000000005,78.6
2070,1245,1935,3,2,5,60.0,0.01416,47.4
2221,1453,-8613,4,9,13,30.77,-0.044676923076923065,38.38461538461539
2230,614,-2164,3,4,7,42.86,-0.020628571428571434,80.57142857142857
2235,3404,-23554,3,6,9,33.33,-0.03922222222222222,50.888888888888886
2596,1099,4191,6,4,10,60.0,0.01371,120.6
2640,5220,-19020,5,7,12,41.67,-0.022541666666666668,33.416666666666664
2641,628,2882,7,3,10,70.0,0.03161,42.5
2643,665,10975,2,0,2,100.0,0.0943,62.5
2718,2328,6942,9,5,14,64.29,0.022714285714285715,59.0
2719,1479,6421,9,7,16,56.25,0.0051750000000000025,33.625
2724,1311,10069,6,4,10,60.0,0.011719999999999998,50.9
2726,2341,7969,4,3,7,57.14,0.00845714285714286,50.857142857142854
2729,7217,29233,3,2,5,60.0,0.014180000000000002,197.2
2732,1548,5702,2,1,3,66.67,0.02753333333333333,59.0
2734,1746,8874,8,7,15,53.33,0.0003466666666666627,15.6
2736,966,-3236,3,6,9,33.33,-0.039400000000000004,48.44444444444444
2740,1682,18308,9,2,11,81.82,0.05767272727272727,34.36363636363637
2743,706,-4336,2,3,5,40.0,-0.02592,23.0
2745,1413,1107,4,3,7,57.14,0.008442857142857139,37.857142857142854
2752,3224,-6674,2,2,4,50.0,-0.005850000000000001,36.5
2754,0,0,0,0,0,0.0,,
2755,332,-5852,0,1,1,0.0,-0.106,153.0
2916,1142,-6352,4,7,11,36.36,-0.03337272727272727,106.18181818181819
2924,2076,4134,4,4,8,50.0,-0.005862500000000003,141.625
2926,7516,76734,8,2,10,80.0,0.05424,103.8
2937,442,-3402,1,2,3,33.33,-0.0392,79.0
3064,7249,67971,18,8,26,69.23,0.0326,13.615384615384615
3066,1407,913,11,8,19,57.89,0.0076263157894736824,28.36842105263158
3067,2677,-21077,6,16,22,27.27,-0.05397272727272728,39.45454545454545
3071,1416,2464,11,8,19,57.89,0.007921052631578948,24.42105263157895
3073,2065,5005,11,12,23,47.83,-0.012569565217391302,17.73913043478261
3078,1720,7910,9,6,15,60.0,0.013899999999999997,21.266666666666666
3081,10577,46823,5,2,7,71.43,0.03707142857142857,7.285714285714286
3083,5659,21281,9,7,16,56.25,0.0066624999999999965,21.625
3085,2781,-7831,16,11,27,59.26,0.010807407407407406,16.74074074074074
3086,3997,7003,16,9,25,64.0,0.021624000000000004,13.72
3088,3994,-14944,8,9,17,47.06,-0.011758823529411763,57.05882352941177
3089,2162,12518,19,7,26,73.08,0.038773076923076924,23.96153846153846
3092,2434,11456,9,6,15,60.0,0.013913333333333331,29.266666666666666
3093,3506,-6506,7,7,14,50.0,-0.005850000000000002,77.92857142857143
3095,2018,-3508,10,6,16,62.5,0.013775,11.1875
3105,3796,33154,4,1,5,80.0,0.054200000000000005,9.2
3114,1829,2791,9,9,18,50.0,-0.006272222222222221,33.94444444444444
3115,1862,4218,13,10,23,56.52,0.00639130434782609,44.869565217391305
3118,1771,16759,7,2,9,77.78,0.04977777777777778,85.22222222222223
3122,787,-187,4,5,9,44.44,-0.017166666666666667,9.222222222222221
3128,1691,12629,11,6,17,64.71,0.023064705882352945,30.235294117647058
3131,8245,-60045,3,6,9,33.33,-0.039233333333333335,34.666666666666664
3141,2148,-7948,5,3,8,62.5,0.019187499999999996,32.75
3147,1101,7819,5,3,8,62.5,0.0191375,98.125
3152,18431,72679,11,8,19,57.89,0.009963157894736844,14.421052631578947
3162,1991,9909,14,9,23,60.87,0.014504347826086957,36.17391304347826
3163,2508,23452,7,2,9,77.78,0.0498,14.444444444444445
3169,2958,-16068,6,5,11,54.55,0.003245454545454545,29.818181818181817
3171,1888,-9048,9,13,22,40.91,-0.024918181818181808,45.95454545454545
3176,5168,19952,9,4,13,69.23,0.032676923076923076,24.46153846153846
3178,2682,-14152,9,13,22,40.91,-0.025309090909090906,29.272727272727273
3188,2034,-1794,12,10,22,54.55,0.0025500000000000006,29.59090909090909
3191,1756,-2796,7,10,17,41.18,-0.024964705882352948,18.529411764705884
3202,2301,-15361,7,15,22,31.82,-0.042786363636363636,24.136363636363637
3205,6239,35571,16,10,26,61.54,0.01593846153846154,24.53846153846154
3206,1719,6091,9,6,15,60.0,0.013946666666666666,37.4
3207,1542,4488,14,7,21,66.67,0.02594285714285714,26.571428571428573
3211,6669,-6539,7,9,16,43.75,-0.01836875,34.375
3213,5498,20822,11,7,18,61.11,0.016405555555555555,41.111111111111114
3217,2621,5469,10,7,17,58.82,0.011611764705882354,23.0
3218,5108,-40758,7,11,18,38.89,-0.028105555555555557,41.166666666666664
3219,4055,30195,16,5,21,76.19,0.04607619047619048,14.857142857142858
3221,2771,8309,12,7,19,63.16,0.02036842105263158,38.0
3224,2294,-9734,9,10,19,47.37,-0.01393157894736842,30.68421052631579
3226,1893,19757,9,2,11,81.82,0.05757272727272727,41.63636363636363
3227,8398,-76338,3,8,11,27.27,-0.04580909090909091,24.09090909090909
3228,8633,42257,13,11,24,54.17,0.0024624999999999994,17.541666666666668
3230,1074,-5014,5,9,14,35.71,-0.03681428571428572,33.357142857142854
3232,2197,2843,10,9,19,52.63,-0.0010473684210526317,29.31578947368421
3234,1839,-7129,4,5,9,44.44,-0.016999999999999998,23.0
3236,1833,-8343,9,12,21,42.86,-0.021076190476190478,22.19047619047619
3252,1873,-7313,6,10,16,37.5,-0.03125625,62.875
3259,1944,20616,12,3,15,80.0,0.054180000000000006,34.733333333333334
3260,5230,1280,10,6,16,62.5,0.01908125,13.0
3264,1524,6996,7,4,11,63.64,0.02137272727272727,37.18181818181818
3265,1706,-12536,5,10,15,33.33,-0.03998666666666666,15.6
3268,3846,16794,14,11,25,56.0,0.005723999999999998,21.64
3272,2238,2192,5,3,8,62.5,0.019125,13.0
3276,1469,61,10,8,18,55.56,0.007983333333333334,31.666666666666668
3284,1524,3696,12,7,19,63.16,0.019252631578947365,40.31578947368421
3285,1359,-11049,4,7,11,36.36,-0.03327272727272727,29.818181818181817
3287,1563,2567,11,7,18,61.11,0.01537777777777778,20.833333333333332
3288,1694,14086,15,4,19,78.95,0.050199999999999995,19.05263157894737
3289,5194,27036,13,6,19,68.42,0.03101052631578947,17.0
3290,1762,7028,11,8,19,57.89,0.009057894736842103,24.63157894736842
3293,21992,-43292,10,6,16,62.5,0.0191875,39.125
3294,2001,18779,10,5,15,66.67,0.027279999999999995,32.266666666666666
3297,2856,11314,12,7,19,63.16,0.020478947368421055,41.21052631578947
3303,2106,5594,9,8,17,52.94,-8.823529411764632e-05,40.588235294117645
3306,3602,-1372,9,12,21,42.86,-0.02015714285714286,36.38095238095238
3310,2609,1661,11,9,20,55.0,0.0035150000000000008,35.4
3313,3057,23173,15,8,23,65.22,0.02376086956521739,22.73913043478261
3317,3083,21137,10,6,16,62.5,0.01903125,18.0
3322,1338,-8348,6,12,18,33.33,-0.04072777777777777,35.5
3323,2493,2027,7,6,13,53.85,0.0017923076923076903,26.46153846153846
3324,5689,19201,14,11,25,56.0,0.006079999999999997,15.96
3325,2611,-3461,9,13,22,40.91,-0.02433181818181818,28.59090909090909
3332,1874,2646,5,4,9,55.56,0.005277777777777778,167.44444444444446
3339,2873,3827,17,14,31,54.84,0.001470967741935483,16.35483870967742
3354,1593,47,6,10,16,37.5,-0.03150625,20.25
3360,1469,-5669,7,10,17,41.18,-0.02417058823529412,35.588235294117645
3362,2138,15412,11,4,15,73.33,0.04073333333333333,34.8
3363,2174,6106,7,6,13,53.85,0.0018615384615384627,37.69230769230769
3372,1209,2611,10,8,18,55.56,0.0020777777777777773,35.888888888888886
3373,3697,29873,14,4,18,77.78,0.049766666666666674,48.111111111111114
3374,2230,32510,6,1,7,85.71,0.06561428571428571,7.714285714285714
3379,1814,-1714,6,9,15,40.0,-0.02608,21.533333333333335
3388,6017,-15537,6,9,15,40.0,-0.025886666666666665,80.0
3390,941,-1771,5,4,9,55.56,0.00507777777777778,18.11111111111111
3402,2290,3400,10,7,17,58.82,0.011494117647058821,26.823529411764707
3426,1322,7618,3,2,5,60.0,0.02178,131.0
3434,877,383,6,6,12,50.0,-0.006833333333333336,38.416666666666664
3438,10843,8707,14,9,23,60.87,0.01589130434782609,31.82608695652174
3441,2649,10651,12,7,19,63.16,0.02027368421052631,11.68421052631579
3444,2062,-5912,7,8,15,46.67,-0.01252,44.93333333333333
3455,1220,1050,4,3,7,57.14,0.008342857142857136,29.142857142857142
3465,3207,-12527,9,7,16,56.25,0.0044375,20.25
3466,3161,2149,12,10,22,54.55,0.0031136363636363627,54.72727272727273
3479,2679,-10079,5,5,10,50.0,-0.005859999999999999,64.6
3483,6632,9498,12,12,24,50.0,-0.005987500000000002,13.958333333333334
3484,3051,15679,11,7,18,61.11,0.016377777777777776,46.05555555555556
3489,1498,-8418,5,12,17,29.41,-0.04798823529411764,31.470588235294116
3490,2414,-2724,7,8,15,46.67,-0.012553333333333333,22.333333333333332
3491,4577,3383,6,5,11,54.55,0.003254545454545453,24.818181818181817
3492,889,2101,4,3,7,57.14,0.008400000000000003,44.57142857142857
3498,5164,24466,13,9,22,59.09,0.012309090909090908,20.954545454545453
3499,1703,17037,11,4,15,73.33,0.04020666666666666,22.733333333333334
3508,4505,45915,13,4,17,76.47,0.04713529411764705,17.58823529411765
3511,2061,8579,8,4,12,66.67,0.027483333333333332,19.583333333333332
3512,3525,10045,13,9,22,59.09,0.01209090909090909,26.59090909090909
3516,1204,-1124,8,7,15,53.33,-0.0002999999999999993,32.666666666666664
3520,2096,-2926,10,8,18,55.56,0.004283333333333335,22.61111111111111
3521,1831,3149,10,8,18,55.56,0.004833333333333335,36.111111111111114
3522,2327,15813,14,5,19,73.68,0.041157894736842095,23.736842105263158
3523,2675,10435,13,9,22,59.09,0.011472727272727272,23.636363636363637
3526,4251,38689,9,6,15,60.0,0.014139999999999998,28.933333333333334
3527,6897,-9767,6,7,13,46.15,-0.013561538461538462,20.615384615384617
3529,9742,111928,6,4,10,60.0,0.014179999999999998,20.7
3531,1672,3358,7,6,13,53.85,0.001753846153846154,75.38461538461539
3537,1302,-10262,3,7,10,30.0,-0.04605,15.0
3540,1965,5395,8,4,12,66.67,0.027458333333333338,35.583333333333336
3541,6258,52642,12,3,15,80.0,0.05172666666666667,26.933333333333334
3546,10082,79808,10,4,14,71.43,0.03707142857142858,38.5
3548,2537,9943,8,6,14,57.14,0.008392857142857141,23.5
3551,2001,13769,6,3,9,66.67,0.02753333333333333,80.66666666666667
3552,7803,21247,7,6,13,53.85,0.0018538461538461515,19.384615384615383
3555,2051,31079,8,2,10,80.0,0.0528,20.2
3556,3368,23682,7,4,11,63.64,0.030463636363636363,15.181818181818182
3558,7132,81168,7,2,9,77.78,0.049788888888888896,37.0
3564,2266,11444,6,4,10,60.0,0.014150000000000001,29.5
3567,772,-2742,3,4,7,42.86,-0.020699999999999996,59.142857142857146
3570,3835,-25765,3,7,10,30.0,-0.04593,76.6
3577,2457,-16157,4,8,12,33.33,-0.039266666666666665,46.25
3580,1838,14312,9,4,13,69.23,0.032192307692307694,22.076923076923077
3581,849,-2709,3,5,8,37.5,-0.03095,33.875
3587,4410,11520,7,4,11,63.64,0.021463636363636365,27.636363636363637
3594,1389,391,4,4,8,50.0,-0.005875000000000002,19.125
3597,1250,-4520,5,7,12,41.67,-0.022675000000000004,207.75
3609,1081,4169,7,4,11,63.64,0.021418181818181822,61.0
3611,11888,60742,6,5,11,54.55,0.003254545454545452,52.09090909090909
3615,2703,-20003,5,10,15,33.33,-0.03922666666666667,26.466666666666665
3623,1961,-881,7,7,14,50.0,-0.0060071428571428585,22.785714285714285
3624,1180,-3320,3,4,7,42.86,-0.020142857142857146,33.857142857142854
3625,933,4037,7,3,10,70.0,0.03314,19.6
3628,4814,26886,6,6,12,50.0,-0.00586666666666667,36.583333333333336
3629,1679,18411,9,2,11,81.82,0.05762727272727272,24.545454545454547
3630,3473,11617,7,6,13,53.85,0.0018615384615384605,14.692307692307692
3631,1864,13006,6,3,9,66.67,0.02748888888888889,21.22222222222222
3632,2936,11734,13,8,21,61.9,0.017628571428571427,19.857142857142858
3642,1499,10081,10,4,14,71.43,0.036692857142857145,30.428571428571427
3646,1438,10722,9,3,12,75.0,0.04410833333333333,35.666666666666664
3652,1453,4717,7,5,12,58.33,0.010824999999999996,58.833333333333336
3663,1278,-14488,2,9,11,18.18,-0.06973636363636364,50.18181818181818
3664,1981,2249,10,8,18,55.56,0.004655555555555556,20.944444444444443
3666,1697,3653,6,5,11,54.55,0.003254545454545452,19.636363636363637
3672,969,1861,5,3,8,62.5,0.0191375,33.625
3675,1670,14340,6,3,9,66.67,0.02758888888888889,27.444444444444443
3680,5337,-7257,5,3,8,62.5,0.019174999999999998,17.0
3684,1134,4116,3,2,5,60.0,0.014180000000000002,26.2
3685,2002,11958,8,4,12,66.67,0.027458333333333335,24.166666666666668
3687,7678,36082,7,7,14,50.0,-0.011449999999999997,17.142857142857142
3689,1197,5033,4,1,5,80.0,0.05416,34.4
3691,27175,32175,7,6,13,53.85,0.0018538461538461536,13.23076923076923
3693,5950,45160,9,5,14,64.29,0.02275000000000001,25.857142857142858
3707,427,4383,4,1,5,80.0,0.053259999999999995,12.4
3709,825,-1705,3,3,6,50.0,-0.020333333333333335,17.166666666666668
3710,506,-1366,4,4,8,50.0,-0.008337500000000005,21.875
3713,388,2872,1,1,2,50.0,0.036699999999999997,62.5
4102,1752,-9812,5,12,17,29.41,-0.04741764705882352,75.58823529411765
4105,7738,20312,12,8,20,60.0,0.014170000000000002,50.1
4107,3831,9439,7,6,13,53.85,0.0015153846153846194,33.69230769230769
4109,3000,-20110,8,18,26,30.77,-0.04448076923076923,44.57692307692308
4111,1678,1732,7,7,14,50.0,-0.006028571428571431,66.57142857142857
4113,1681,-161,9,10,19,47.37,-0.012478947368421056,32.73684210526316
4114,2484,-15834,5,10,15,33.33,-0.03933333333333334,54.266666666666666
4116,1175,195,3,3,6,50.0,-0.005833333333333332,41.0
4120,5229,-19219,8,11,19,42.11,-0.02166842105263158,43.89473684210526
4121,1893,1667,9,9,18,50.0,-0.006138888888888888,22.166666666666668
4123,3072,4708,6,5,11,54.55,0.0032181818181818158,64.72727272727273
4126,6250,7780,9,10,19,47.37,-0.011184210526315791,69.47368421052632
4127,1339,-2589,6,8,14,42.86,-0.020571428571428574,31.5
4128,3465,-24745,8,13,21,38.1,-0.02979523809523809,32.476190476190474
4129,3709,-2849,9,9,18,50.0,-0.005994444444444445,31.5
4130,1970,-13220,3,7,10,30.0,-0.04590999999999999,24.0
4131,2780,17600,17,7,24,70.83,0.034062499999999996,18.583333333333332
4138,3694,-23224,3,6,9,33.33,-0.039233333333333335,89.22222222222223
4139,4441,10139,8,6,14,57.14,0.008435714285714283,74.0
4147,6465,37335,6,4,10,60.0,0.014180000000000003,26.7
4153,2593,-26173,2,7,9,22.22,-0.06148888888888889,20.88888888888889
4154,1420,880,5,4,9,55.56,0.0052555555555555585,30.22222222222222
4157,1347,5823,7,3,10,70.0,0.034199999999999994,37.4
4160,2061,-14741,4,9,13,30.77,-0.044399999999999995,52.69230769230769
4161,2292,268,4,6,10,40.0,-0.025909999999999996,51.6
4162,7987,-53047,4,6,10,40.0,-0.025880000000000004,20.6
4163,5133,46187,6,2,8,75.0,0.044225,33.25
4167,768,942,3,3,6,50.0,-0.005933333333333335,29.0
4168,4105,8695,9,9,18,50.0,-0.005927777777777778,28.055555555555557
4171,5151,6439,7,6,13,53.85,0.0017923076923076903,29.384615384615383
4173,1694,-11754,4,8,12,33.33,-0.03926666666666666,41.5
4174,15950,44800,9,4,13,69.23,0.03266923076923077,23.615384615384617
4175,4506,-22316,4,7,11,36.36,-0.03316363636363637,111.72727272727273
4183,482,-782,2,2,4,50.0,-0.005899999999999999,17.75
4188,958,1682,4,3,7,57.14,0.008414285714285711,44.0
4192,2451,-2551,5,6,11,45.45,-0.014981818181818181,34.81818181818182
4198,1541,11279,11,6,17,64.71,0.02017058823529412,18.58823529411765
4205,2907,-5237,3,6,9,33.33,-0.029266666666666663,170.44444444444446
4207,1417,1763,11,9,20,55.0,0.0027749999999999975,76.85
4303,853,-2253,4,6,10,40.0,-0.03412,27.4
4304,1337,3983,12,8,20,60.0,0.011605,23.9
4305,1355,10415,8,4,12,66.67,0.027158333333333336,99.75
4401,3283,-4743,8,9,17,47.06,-0.012452941176470585,70.41176470588235
4402,1109,61,11,9,20,55.0,-0.0038049999999999994,19.3
4406,1101,-4091,6,11,17,35.29,-0.03804117647058823,48.88235294117647
4413,1246,-3346,12,9,21,57.14,-0.01385238095238095,126.42857142857143
4416,7154,13446,8,8,16,50.0,-0.0014500000000000012,67.375
4417,2313,11417,10,7,17,58.82,0.016941176470588234,96.82352941176471
4419,2131,-6861,10,11,21,47.62,-0.012804761904761906,23.333333333333332
4420,2112,-3392,6,9,15,40.0,-0.019166666666666665,88.8
4430,2210,-9890,5,8,13,38.46,-0.028961538461538462,59.92307692307692
4432,3060,16940,9,3,12,75.0,0.04416666666666667,46.083333333333336
4433,2161,129,7,5,12,58.33,0.010774999999999998,52.583333333333336
4502,4094,-3064,12,11,23,52.17,-0.003556521739130434,40.04347826086956
4503,1737,7263,8,10,18,44.44,-0.01971666666666667,20.22222222222222
4506,1597,-15007,5,10,15,33.33,-0.03999333333333333,90.26666666666667
4510,1789,4441,14,9,23,60.87,0.014408695652173911,43.17391304347826
4513,1198,-3168,6,9,15,40.0,-0.026806666666666663,50.333333333333336
4523,2656,6414,12,8,20,60.0,0.013870000000000004,42.05
4527,2399,161,10,10,20,50.0,-0.005979999999999998,87.15
4528,3114,1346,9,8,17,52.94,-0.00012352941176470698,41.35294117647059
4529,2167,4353,14,9,23,60.87,0.015300000000000003,27.217391304347824
4530,2047,3803,19,11,30,63.33,0.017550000000000003,20.333333333333332
4533,1176,-5416,6,8,14,42.86,-0.020578571428571425,96.0
4534,2494,11706,18,11,29,62.07,0.017079310344827587,22.275862068965516
4535,5649,24661,14,8,22,63.64,0.021459090909090914,102.54545454545455
4538,513,1177,3,2,5,60.0,0.014100000000000001,110.2
4541,1067,-7,3,4,7,42.86,-0.020214285714285716,74.85714285714286
4542,979,-519,3,4,7,42.86,-0.005614285714285716,44.285714285714285
4543,869,-8089,2,6,8,25.0,-0.056049999999999996,73.25
4549,3224,25726,4,2,6,66.67,0.04106666666666667,50.833333333333336
4550,454,-5704,1,3,4,25.0,-0.07935,129.5
4554,1535,-385,4,4,8,50.0,-0.005900000000000001,45.25
4556,954,-14,3,2,5,60.0,-0.0033599999999999993,192.2
4561,1271,-4791,3,5,8,37.5,-0.0309625,40.875
4563,1244,176,2,2,4,50.0,-0.005850000000000001,71.25
4568,1144,-9424,1,2,3,33.33,-0.039233333333333335,143.33333333333334
4580,1091,-411,1,1,2,50.0,-0.005850000000000001,214.5
4609,1368,-3618,8,11,19,42.11,-0.02343157894736842,32.63157894736842
4702,1638,8162,16,8,24,66.67,0.021624999999999995,24.291666666666668
4706,919,3451,6,5,11,54.55,0.0026454545454545468,180.27272727272728
4707,2224,-11234,8,13,21,38.1,-0.03045714285714286,55.666666666666664
4711,1715,4355,11,7,18,61.11,0.016144444444444447,90.44444444444444
4712,2687,11363,21,8,29,72.41,0.03744827586206896,17.24137931034483
4714,878,3592,8,4,12,66.67,0.026175000000000004,46.833333333333336
4716,1598,-1098,9,8,17,52.94,-0.0002823529411764713,61.64705882352941
4721,3437,10353,11,5,16,68.75,0.03168125,31.625
4726,1492,7838,5,3,8,62.5,0.019162499999999996,35.25
4728,1988,782,4,4,8,50.0,-0.0058750000000000035,44.625
4729,1348,5342,10,5,15,66.67,0.027159999999999997,18.4
4735,3474,-8874,6,7,13,46.15,-0.01363846153846154,26.384615384615383
4736,10218,-76728,4,9,13,30.77,-0.04436923076923078,35.23076923076923
4741,4595,31175,10,5,15,66.67,0.02752666666666666,62.333333333333336
4743,8572,50538,8,4,12,66.67,0.027491666666666668,21.666666666666668
4744,3066,-4216,6,7,13,46.15,-0.013607692307692308,20.307692307692307
4745,2865,3555,5,5,10,50.0,0.002400000000000001,60.0
4747,1937,13,4,3,7,57.14,0.00847142857142857,262.57142857142856
4754,1061,-10031,1,3,4,25.0,-0.055925,61.25
4760,1257,17543,3,1,4,75.0,0.044125,62.25
4767,274,-1364,1,1,2,50.0,-0.04145,62.5
4804,2296,10054,11,5,16,68.75,0.031287499999999996,27.375
4806,774,8316,4,2,6,66.67,0.026366666666666663,26.666666666666668
4903,1865,2275,17,10,27,62.96,0.016059259259259256,19.0
4905,2823,697,8,9,17,47.06,-0.006541176470588234,91.05882352941177
4907,1651,3319,10,9,19,52.63,0.0021789473684210485,35.63157894736842
4908,3858,-2798,9,14,23,39.13,-0.02795652173913044,27.82608695652174
4909,3413,2467,10,9,19,52.63,-0.0006578947368421051,19.263157894736842
4911,4109,47431,11,2,13,84.62,0.0635,22.76923076923077
4924,1203,-3193,6,7,13,46.15,-0.01506923076923077,44.46153846153846
4931,1554,13716,7,4,11,63.64,0.018900000000000004,45.36363636363637
4933,3611,-10401,8,5,13,61.54,0.017230769230769227,31.23076923076923
4939,671,3199,6,2,8,75.0,0.043225000000000006,16.5
4944,784,2116,6,4,10,60.0,0.013149999999999995,10.3
4945,0,0,0,0,0,0.0,,
4946,3153,20837,7,5,12,58.33,0.010691666666666669,25.416666666666668
4950,782,5008,6,2,8,75.0,0.043437500000000004,48.625
4953,1940,15340,4,1,5,80.0,0.054220000000000004,33.2
4966,27762,-46012,4,6,10,40.0,-0.029580000000000002,10.1
4971,2163,-14153,2,4,6,33.33,-0.039233333333333335,16.166666666666668
4972,1482,-6822,3,5,8,37.5,-0.030912500000000002,124.25
4973,1610,1130,7,5,12,58.33,0.010816666666666664,29.25
4974,890,-8850,1,3,4,25.0,-0.055874999999999994,57.25
4979,2984,-17944,6,9,15,40.0,-0.02593333333333334,18.266666666666666
4987,3201,25749,6,2,8,75.0,0.0442125,91.125
4991,3138,30202,8,2,10,80.0,0.05424,22.4
4995,1137,4213,4,2,6,66.67,0.027483333333333332,114.33333333333333
5009,1828,-10928,5,11,16,31.25,-0.04391875,32.0
5011,104,-22664,1,1,2,50.0,-6.2158500000000005,3176.0
5013,1596,-4646,6,8,14,42.86,-0.01385714285714285,65.35714285714286
5014,1462,4318,13,7,20,65.0,0.019309999999999997,36.35
5015,1540,1670,7,7,14,50.0,-0.006021428571428574,64.07142857142857
5016,1434,2496,5,4,9,55.56,0.005233333333333332,68.33333333333333
5201,1953,1707,11,7,18,61.11,0.015255555555555553,40.833333333333336
5202,1976,3444,13,11,24,54.17,0.0007208333333333325,37.666666666666664
5205,1707,11073,13,6,19,68.42,0.02900526315789474,17.263157894736842
5206,1597,5293,14,8,22,63.64,0.017800000000000003,39.86363636363637
5209,3570,13000,9,7,16,56.25,0.0064125000000000015,101.4375
5210,942,-1162,7,6,13,53.85,-0.0022538461538461545,42.07692307692308
5211,3388,22122,14,6,20,70.0,0.03411,43.0
5212,2964,-24084,6,16,22,27.27,-0.051481818181818184,34.90909090909091
5213,2242,-4492,9,12,21,42.86,-0.01646190476190476,41.285714285714285
5220,1369,3301,5,3,8,62.5,0.019100000000000002,60.625
5223,927,-5937,1,2,3,33.33,-0.039233333333333335,34.333333333333336
5227,2112,2418,6,6,12,50.0,-0.0059999999999999975,28.333333333333332
5230,1914,5556,4,4,8,50.0,-0.00016250000000000032,71.125
5245,4251,9999,6,4,10,60.0,0.01416,16.5
5251,2291,26199,9,2,11,81.82,0.05778181818181818,39.36363636363637
5263,10680,47820,6,3,9,66.67,0.027533333333333333,33.888888888888886
5272,683,-1143,2,2,4,50.0,-0.005975000000000001,19.5
5274,25454,-13154,2,3,5,40.0,-0.025880000000000004,9.0
5276,977,-7457,2,6,8,25.0,-0.056049999999999996,42.375
5278,3625,2655,6,5,11,54.55,0.003236363636363637,18.181818181818183
5281,976,-896,4,3,7,57.14,-0.0003285714285714301,59.285714285714285
5287,12608,55742,6,3,9,66.67,0.019755555555555554,38.77777777777778
5289,3028,-1298,3,2,5,60.0,0.014180000000000002,21.0
5291,727,-7097,2,4,6,33.33,-0.0394,23.166666666666668
5299,3308,-26698,5,5,10,50.0,-0.005979999999999999,17.4
5301,3432,6488,18,9,27,66.67,0.025266666666666666,27.59259259259259
5302,1451,7719,14,6,20,70.0,0.03201,20.5
5306,5241,16629,9,10,19,47.37,-0.01716315789473684,33.73684210526316
5309,1695,-4505,11,12,23,47.83,-0.011839130434782607,28.391304347826086
5310,2751,5079,12,8,20,60.0,0.012015,23.1
5312,6032,-15512,7,12,19,36.84,-0.03224210526315789,76.94736842105263
5314,1719,-1679,14,14,28,50.0,-0.008999999999999996,22.035714285714285
5315,1787,7053,16,8,24,66.67,0.022920833333333335,22.75
5321,2982,-12532,14,14,28,50.0,-0.011360714285714285,18.5
5324,400,-5050,6,2,8,75.0,-0.2613,642.625
5328,1398,-968,13,9,22,59.09,0.009231818181818176,18.363636363636363
5340,1962,9728,14,7,21,66.67,0.02077142857142857,25.952380952380953
5344,1772,-9092,10,15,25,40.0,-0.032312,23.88
5345,1772,2758,17,12,29,58.62,0.008051724137931033,22.448275862068964
5347,3885,-3565,8,9,17,47.06,-0.007647058823529412,24.176470588235293
5348,1637,9143,12,9,21,57.14,0.005580952380952381,22.38095238095238
5351,3026,604,13,13,26,50.0,-0.006469230769230767,16.73076923076923
5353,1538,-768,11,10,21,52.38,-0.00283333333333333,33.333333333333336
5355,1569,5781,14,9,23,60.87,0.013295652173913044,19.17391304347826
5356,2695,16985,13,8,21,61.9,0.02178095238095238,34.095238095238095
5364,2773,-9083,14,9,23,60.87,0.008434782608695653,45.52173913043478
5371,3719,-9059,9,11,20,45.0,-0.015895,31.75
5381,1713,-2023,15,17,32,46.88,-0.021159375,20.4375
5383,1992,4508,11,10,21,52.38,0.002785714285714285,28.0
5386,835,-13355,10,1,11,90.91,-0.0832909090909091,476.1818181818182
5392,5130,23180,12,6,18,66.67,0.027494444444444443,31.0
5398,1657,20703,14,1,15,93.33,0.07866000000000001,46.6
5403,1810,-22120,3,9,12,25.0,-0.05603333333333333,63.5
5410,1669,-5359,10,9,19,52.63,-0.0027210526315789426,51.10526315789474
5425,1904,13526,10,4,14,71.43,0.03668571428571428,32.92857142857143
5426,1129,-4819,5,9,14,35.71,-0.035228571428571435,46.785714285714285
5432,1436,1264,12,7,19,63.16,0.01566315789473684,16.105263157894736
5438,3214,21796,17,7,24,70.83,0.035770833333333335,42.458333333333336
5439,2154,9366,11,7,18,61.11,0.0159,24.22222222222222
5443,910,5880,5,4,9,55.56,0.0043111111111111084,26.333333333333332
5450,2397,8413,15,10,25,60.0,0.013432000000000001,33.92
5452,2234,7156,14,10,24,58.33,0.009566666666666666,25.25
5455,1373,9287,15,5,20,75.0,0.037954999999999996,14.35
5457,2822,-9402,11,11,22,50.0,-0.007450000000000001,21.818181818181817
5460,1679,7461,13,7,20,65.0,0.026654999999999995,37.25
5464,3220,790,13,12,25,52.0,-0.001955999999999996,47.56
5465,1477,-1387,11,11,22,50.0,-0.009863636363636364,28.59090909090909
5468,1960,6570,18,12,30,60.0,0.010226666666666665,16.766666666666666
5474,6520,29210,13,7,20,65.0,0.023815000000000003,21.25
5475,1965,8775,19,9,28,67.86,0.026260714285714287,21.75
5478,11511,36179,15,10,25,60.0,0.015519999999999996,27.24
5481,1821,15519,15,5,20,75.0,0.045335,26.25
5483,7643,20417,11,7,18,61.11,0.016394444444444448,19.666666666666668
5487,1547,-1937,7,7,14,50.0,-0.00620714285714286,60.857142857142854
5488,1664,5886,11,11,22,50.0,-0.008181818181818184,31.772727272727273
5489,4540,10660,12,9,21,57.14,0.00840952380952381,73.14285714285714
5490,4484,24206,14,9,23,60.87,0.015830434782608697,27.695652173913043
5493,2232,-6462,8,9,17,47.06,-0.011923529411764706,91.82352941176471
5498,1607,-4157,10,14,24,41.67,-0.025099999999999997,29.25
5508,3120,3780,7,6,13,53.85,0.0018230769230769218,84.0
5511,1754,-7564,6,10,16,37.5,-0.03187500000000001,70.125
5512,1621,-301,11,10,21,52.38,-0.0023428571428571413,53.38095238095238
5514,1176,-986,7,7,14,50.0,-0.006657142857142857,25.142857142857142
5516,1061,-6541,4,11,15,26.67,-0.05390666666666666,50.6
5520,1511,-2371,7,6,13,53.85,0.001707692307692315,123.15384615384616
5523,1949,4141,14,12,26,53.85,0.0005346153846153834,37.23076923076923
5529,2043,13477,15,7,22,68.18,0.029090909090909087,21.363636363636363
5530,3934,5986,6,6,12,50.0,-0.0007666666666666667,80.08333333333333
5536,5693,-21073,3,4,7,42.86,-0.020157142857142856,60.42857142857143
5543,749,-479,2,2,4,50.0,-0.023350000000000003,99.5
5601,1802,-8462,6,10,16,37.5,-0.0352875,63.75
5603,1091,1799,9,6,15,60.0,0.013053333333333328,58.93333333333333
5604,1706,9174,5,4,9,55.56,0.01561111111111111,49.77777777777778
5609,1301,2769,6,6,12,50.0,-0.0058583333333333334,90.83333333333333
5701,1033,-4463,8,9,17,47.06,-0.018394117647058825,45.1764705882353
5703,984,1496,5,3,8,62.5,0.019212499999999997,84.125
5704,2958,-24268,6,16,22,27.27,-0.05141363636363638,67.81818181818181
5820,1018,1582,10,6,16,62.5,0.014287499999999998,96.4375
5864,695,1295,5,5,10,50.0,-0.007930000000000003,78.5
5878,1043,-14783,0,4,4,0.0,-0.086,273.5
5902,1296,3114,12,6,18,66.67,0.025205555555555554,48.888888888888886
5903,7774,-26964,3,7,10,30.0,-0.04036,128.0
5904,19174,-229054,6,13,19,31.58,-0.042747368421052624,48.473684210526315
5905,1738,-568,10,11,21,47.62,-0.011780952380952378,32.04761904761905
6015,1443,-3513,9,14,23,39.13,-0.027104347826086953,31.82608695652174
6016,1007,2993,9,6,15,60.0,0.012113333333333332,26.666666666666668
6020,1088,-4068,5,7,12,41.67,-0.022699999999999998,114.25
6021,998,52,6,7,13,46.15,-0.007623076923076923,53.30769230769231
6023,2064,-14764,3,6,9,33.33,-0.04874444444444445,235.55555555555554
6026,429,-109,3,3,6,50.0,-0.007116666666666663,30.5
6101,2717,24203,18,6,24,75.0,0.04270833333333333,12.708333333333334
6103,1977,2923,8,10,18,44.44,-0.02287777777777778,18.944444444444443
6104,4990,29580,12,6,18,66.67,0.027500000000000004,16.5
6109,1540,-630,11,11,22,50.0,-0.007527272727272729,45.81818181818182
6111,2951,4759,9,7,16,56.25,0.006231249999999997,25.0
6113,1703,10917,17,7,24,70.83,0.03375833333333333,30.541666666666668
6114,613,-24183,4,5,9,44.44,-0.6776222222222222,575.8888888888889
6118,1875,-155,12,9,21,57.14,0.00752380952380952,24.761904761904763
6121,8596,-43496,4,6,10,40.0,-0.025879999999999997,52.0
6122,1339,881,10,8,18,55.56,0.0038722222222222244,38.388888888888886
6123,1966,9084,9,5,14,64.29,0.020435714285714286,30.928571428571427
6124,3886,19444,16,9,25,64.0,0.022160000000000003,29.92
6125,1879,-8239,5,9,14,35.71,-0.03487857142857143,23.357142857142858
6126,1663,-1983,8,7,15,53.33,0.0005466666666666685,27.4
6127,1589,8701,14,7,21,66.67,0.02629523809523809,17.333333333333332
6129,2596,26674,17,3,20,85.0,0.06303,14.3
6130,4513,30847,17,7,24,70.83,0.030970833333333336,25.125
6134,3502,17838,16,9,25,64.0,0.021403999999999996,31.68
6138,4868,9262,10,8,18,55.56,0.005233333333333333,11.0
6140,937,-4037,5,7,12,41.67,-0.023591666666666664,43.5
6143,5492,11268,11,11,22,50.0,-0.005909090909090909,26.954545454545453
6144,1082,-2402,8,8,16,50.0,-0.007724999999999999,68.8125
6146,6290,-9680,6,7,13,46.15,-0.013584615384615382,97.0
6147,2642,2268,7,6,13,53.85,0.001730769230769228,16.23076923076923
6148,1714,6316,19,8,27,70.37,0.03012962962962963,28.51851851851852
6150,6383,-17153,15,9,24,62.5,0.0159125,11.666666666666666
6151,1906,5414,8,5,13,61.54,0.017069230769230767,78.46153846153847
6154,2142,10038,9,5,14,64.29,0.02267857142857143,142.57142857142858
6156,1768,2322,16,6,22,72.73,0.03395454545454545,11.727272727272727
6158,4306,4474,14,11,25,56.0,0.006075999999999999,26.96
6160,3854,-29464,7,13,20,35.0,-0.03595999999999999,27.25
6161,1966,1934,12,12,24,50.0,-0.007183333333333332,21.833333333333332
6163,1462,5548,12,7,19,63.16,0.019410526315789475,25.263157894736842
6167,1647,4533,17,10,27,62.96,0.012848148148148145,31.22222222222222
6169,4832,-36272,11,18,29,37.93,-0.030310344827586207,21.06896551724138
6170,2961,24049,13,8,21,61.9,0.017657142857142857,38.19047619047619
6171,1328,-3398,7,10,17,41.18,-0.02455882352941177,34.705882352941174
6173,2897,-187,10,11,21,47.62,-0.011676190476190475,22.19047619047619
6174,1679,1541,12,10,22,54.55,0.001331818181818182,35.36363636363637
6175,2279,211,13,12,25,52.0,-0.006824,19.92
6179,3246,234,12,11,23,52.17,-0.006195652173913041,39.65217391304348
6180,6217,-19517,13,18,31,41.94,-0.022067741935483866,23.096774193548388
6182,2970,19190,10,6,16,62.5,0.01881875,32.0
6185,2588,6002,12,7,19,63.16,0.02036842105263158,33.73684210526316
6186,2838,29632,22,5,27,81.48,0.059611111111111115,31.88888888888889
6187,6395,-13635,11,17,28,39.29,-0.027382142857142862,19.5
6188,7984,45456,15,9,24,62.5,0.019170833333333335,24.916666666666668
6190,1762,9088,16,7,23,69.57,0.031439130434782615,30.434782608695652
6194,2614,-1824,8,9,17,47.06,-0.005982352941176472,87.76470588235294
6195,3945,15345,15,6,21,71.43,0.035404761904761904,29.476190476190474
6198,3224,10356,19,13,32,59.38,0.011700000000000002,23.65625
6199,2373,7737,16,9,25,64.0,0.021331999999999997,21.6
6203,3387,-917,6,9,15,40.0,-0.02589333333333333,74.4
6204,3749,14551,13,10,23,56.52,0.007147826086956521,55.130434782608695
6207,2465,3325,10,7,17,58.82,0.011700000000000004,37.705882352941174
6208,1775,3065,9,8,17,52.94,-0.00034117647058823364,35.294117647058826
6210,2486,-1336,9,6,15,60.0,0.007246666666666668,37.8
6212,2423,2827,11,6,17,64.71,0.02212941176470588,64.41176470588235
6217,2166,18354,12,6,18,66.67,0.02626666666666667,16.88888888888889
6218,2525,7395,12,8,20,60.0,0.014154999999999997,44.95
6219,1651,4559,14,8,22,63.64,0.018186363636363632,40.45454545454545
6220,1513,7487,10,5,15,66.67,0.027100000000000003,27.4
6221,1680,10,8,6,14,57.14,0.007628571428571432,45.357142857142854
6222,1433,1917,12,9,21,57.14,0.005695238095238098,25.0
6223,7236,39984,11,6,17,64.71,0.023594117647058828,23.0
6227,2754,-11564,9,13,22,40.91,-0.024281818181818182,39.5
6228,1580,9570,16,7,23,69.57,0.030865217391304347,18.347826086956523
6229,1807,11283,14,5,19,73.68,0.0411578947368421,36.78947368421053
6231,7803,-32223,10,13,23,43.48,-0.018908695652173912,20.217391304347824
6233,2301,2199,9,8,17,52.94,-0.0004411764705882357,29.41176470588235
6234,3147,-15177,7,15,22,31.82,-0.04240000000000001,33.90909090909091
6236,2550,12490,15,9,24,62.5,0.016612500000000006,13.5
6237,5617,27923,8,7,15,53.33,0.0008133333333333316,15.133333333333333
6240,596,-16306,4,4,8,50.0,-0.381025,687.625
6241,1764,-6104,7,11,18,38.89,-0.030527777777777772,30.27777777777778
6242,2950,-3580,8,8,16,50.0,-0.006743749999999999,47.75
6244,8488,-80418,10,12,22,45.45,-0.015263636363636363,15.727272727272727
6245,2271,619,7,5,12,58.33,0.010683333333333336,24.666666666666668
6246,2060,15120,17,10,27,62.96,0.016103703703703703,27.444444444444443
6247,1880,12310,14,7,21,66.67,0.02694761904761904,61.19047619047619
6248,2752,9518,18,11,29,62.07,0.017010344827586205,22.586206896551722
6259,2281,10789,20,10,30,66.67,0.02683333333333333,18.2
6261,3495,7095,6,5,11,54.55,0.0032454545454545475,65.54545454545455
6263,4161,-25391,6,12,18,33.33,-0.0393,60.166666666666664
6264,1959,3811,14,9,23,60.87,0.013434782608695654,46.34782608695652
6265,1427,-2767,8,10,18,44.44,-0.018044444444444446,31.61111111111111
6266,1627,-5487,9,11,20,45.0,-0.01747,37.95
6270,2138,972,8,7,15,53.33,0.000373333333333332,44.333333333333336
6274,2390,15040,8,6,14,57.14,0.00802857142857143,26.357142857142858
6275,1537,-187,9,7,16,56.25,0.006137499999999999,37.6875
6276,1880,8130,13,8,21,61.9,0.015919047619047617,21.952380952380953
6279,4809,-22869,6,10,16,37.5,-0.0309125,50.0625
6284,1695,3535,6,6,12,50.0,-0.0059416666666666645,7.166666666666667
6287,1418,-478,12,13,25,48.0,-0.01536,18.64
6290,3946,1734,14,10,24,58.33,0.010679166666666661,23.083333333333332
6291,1987,11333,13,10,23,56.52,0.0025130434782608675,16.043478260869566
6292,2536,-6616,8,10,18,44.44,-0.02182777777777778,56.22222222222222
6294,703,-103973,8,2,10,80.0,-7.73475,524.9
6404,1663,-713,5,6,11,45.45,-0.016536363636363637,14.272727272727273
6411,3933,-22163,3,4,7,42.86,-0.03277142857142857,21.142857142857142
6417,1068,-5288,2,2,4,50.0,-0.005874999999999998,87.25
6418,1214,14396,10,2,12,83.33,0.0608,73.0
6419,1326,1194,7,5,12,58.33,0.009933333333333332,46.5
6425,2070,22480,9,2,11,81.82,0.04997272727272727,32.27272727272727
6426,3519,-24759,3,6,9,33.33,-0.03924444444444444,13.0
6432,930,2140,3,3,6,50.0,-0.005899999999999998,27.0
6435,1784,8136,2,1,3,66.67,0.02753333333333333,13.333333333333334
6441,3578,34162,9,3,12,75.0,0.04423333333333335,41.25
6446,2448,-12548,1,2,3,33.33,-0.039233333333333335,108.33333333333333
6457,2620,21280,6,2,8,75.0,0.03296249999999999,41.5
6461,2403,19707,8,3,11,72.73,0.03969090909090909,34.36363636363637
6462,5751,37199,3,3,6,50.0,0.009066666666666667,8.166666666666666
6465,3043,-2753,6,6,12,50.0,-0.005866666666666669,35.916666666666664
6469,1319,8981,2,1,3,66.67,0.02753333333333333,95.0
6470,910,8740,3,1,4,75.0,0.0442,25.25
6472,1893,24507,2,1,3,66.67,0.02753333333333333,16.333333333333332
6482,1626,8644,4,3,7,57.14,0.008414285714285711,71.57142857142857
6485,1035,3345,3,2,5,60.0,0.01414,35.0
6486,1730,7610,3,2,5,60.0,0.0329,97.6
6488,4273,43907,1,2,3,33.33,-0.039233333333333335,23.666666666666668
6492,4483,19117,5,4,9,55.56,0.0052777777777777745,53.111111111111114
6494,2106,-13126,3,3,6,50.0,-0.005866666666666663,27.333333333333332
6496,1024,8436,3,1,4,75.0,0.044225,213.0
6499,4529,12821,5,4,9,55.56,0.005277777777777778,26.0
6506,735,-3515,3,5,8,37.5,-0.031112499999999998,104.5
6508,1789,4801,6,5,11,54.55,0.003245454545454545,73.72727272727273
6509,2221,10859,12,6,18,66.67,0.027283333333333333,44.611111111111114
6510,21163,53687,4,3,7,57.14,0.008457142857142854,20.142857142857142
6512,1137,5603,5,3,8,62.5,0.019124999999999996,76.5
6514,1673,12967,5,2,7,71.43,0.03708571428571428,44.285714285714285
6516,2651,23319,3,1,4,75.0,0.044225,21.5
6523,1442,7558,2,1,3,66.67,0.02753333333333333,34.333333333333336
6527,1096,-526,2,2,4,50.0,-0.005875000000000002,113.75
6530,486,-2536,2,3,5,40.0,-0.02604,46.0
6532,530,-9370,0,2,2,0.0,-0.106,32.0
6535,1675,-335,4,4,8,50.0,-0.005925,38.75
6538,3220,12550,5,3,8,62.5,0.0191875,31.0
6542,3291,8499,6,4,10,60.0,0.014179999999999998,21.6
6547,1972,-15962,1,2,3,33.33,-0.0392,178.0
6548,1733,28657,3,0,3,100.0,0.09426666666666667,13.333333333333334
6556,1366,-2866,3,3,6,50.0,-0.0058999999999999955,63.666666666666664
6560,1976,10924,5,2,7,71.43,0.03705714285714286,21.142857142857142
6561,3931,34069,2,1,3,66.67,0.02753333333333333,64.0
6568,4517,49183,4,1,5,80.0,0.05424,20.0
6569,5171,-26821,2,4,6,33.33,-0.039233333333333335,83.5
6570,1706,3154,5,4,9,55.56,0.005255555555555555,54.111111111111114
6574,4183,837,4,3,7,57.14,0.00844285714285714,98.42857142857143
6576,2266,4614,3,2,5,60.0,0.014180000000000002,26.6
6577,1808,-1548,2,3,5,40.0,-0.006860000000000001,46.6
6578,691,-2701,2,3,5,40.0,-0.02596,74.4
6588,390,-6900,0,1,1,0.0,-0.106,7.0
6589,604,336,2,1,3,66.67,0.02753333333333333,41.666666666666664
6590,297,-5247,0,1,1,0.0,-0.106,2.0
6593,580,9570,3,0,3,100.0,0.09426666666666667,66.0
6594,725,5555,3,1,4,75.0,0.044225,36.5
6596,1557,6063,3,2,5,60.0,0.014179999999999998,126.2
6603,1223,1857,8,7,15,53.33,-7.99999999999986e-05,26.333333333333332
6609,2353,-28453,3,14,17,17.65,-0.07071764705882354,60.588235294117645
6612,1908,-7148,2,3,5,40.0,-0.025880000000000004,77.8
6613,4567,10183,3,2,5,60.0,0.014179999999999998,86.6
6615,2641,31489,6,1,7,85.71,0.060714285714285714,93.28571428571429
6616,1101,-2451,5,4,9,55.56,-0.003977777777777779,28.666666666666668
6624,814,-194,2,2,4,50.0,-0.005800000000000003,68.5
6629,1421,10779,3,1,4,75.0,0.044225,68.0
6640,544,8996,1,0,1,100.0,0.0943,98.0
6642,399,-7059,0,1,1,0.0,-0.106,9.0
6643,1746,28854,1,0,1,100.0,0.0943,41.0
6649,535,2645,2,1,3,66.67,0.02753333333333333,72.0
6651,985,745,1,1,2,50.0,-0.005850000000000001,9.5
6654,2269,1841,3,4,7,42.86,-0.005700000000000003,18.857142857142858
6661,148,2442,1,0,1,100.0,0.0943,145.0
6662,774,2236,2,2,4,50.0,0.007999999999999995,170.0
6664,356,5864,1,0,1,100.0,0.0943,16.0
6667,348,-6148,0,1,1,0.0,-0.106,64.0
6679,1650,27250,1,0,1,100.0,0.0943,4.0
6680,689,11391,2,0,2,100.0,0.0943,98.5
6683,0,0,0,0,0,0.0,,
6690,2123,14577,2,1,3,66.67,0.02753333333333333,63.666666666666664
6697,231,3809,1,0,1,100.0,0.0943,10.0
6703,493,-8713,0,1,1,0.0,-0.106,33.0
6712,983,-17383,0,1,1,0.0,-0.106,29.0
6716,1779,-23009,0,3,3,0.0,-0.0741,23.333333333333332
6727,824,-434,1,1,2,50.0,-0.005850000000000001,29.5
6728,0,0,0,0,0,0.0,,
6732,4686,77414,2,0,2,100.0,0.0943,32.5
6733,417,2163,2,1,3,66.67,0.02753333333333333,44.0
6747,2796,32454,2,0,2,100.0,0.06295,27.5
6751,1200,8870,3,1,4,75.0,0.044175000000000006,43.5
6752,318,-5618,0,1,1,0.0,-0.106,135.0
6762,0,0,0,0,0,0.0,,
6767,175,-3085,0,1,1,0.0,-0.1058,17.0
6803,4742,-83892,0,4,4,0.0,-0.106,436.5
7402,2814,2826,5,5,10,50.0,-0.00586,36.2
7556,659,-11659,0,1,1,0.0,-0.106,25.0
8024,2753,4997,10,10,20,50.0,-0.006135,29.75
8027,1388,-8198,3,4,7,42.86,-0.020242857142857142,34.57142857142857
8032,2068,-7938,6,10,16,37.5,-0.03144375,80.125
8034,1510,-2490,10,11,21,47.62,-0.012423809523809524,23.19047619047619
8038,1983,-19823,2,6,8,25.0,-0.055925,22.375
8040,2418,-9098,10,12,22,45.45,-0.016204545454545454,27.454545454545453
8042,2999,12141,10,8,18,55.56,0.0051111111111111105,28.77777777777778
8043,1722,-4932,7,7,14,50.0,-0.006192857142857141,19.285714285714285
8044,12671,-28111,11,10,21,52.38,-0.005404761904761904,20.476190476190474
8047,1722,-1092,9,12,21,42.86,-0.022423809523809523,51.285714285714285
8048,2221,-8231,5,8,13,38.46,-0.028984615384615386,43.15384615384615
8049,1777,9493,15,6,21,71.43,0.03558095238095238,21.61904761904762
8050,5853,30637,13,6,19,68.42,0.03102631578947368,34.68421052631579
8054,2722,18628,8,3,11,72.73,0.039663636363636366,37.27272727272727
8059,1268,-2098,8,9,17,47.06,-0.013029411764705885,26.529411764705884
8064,2216,854,11,10,21,52.38,-0.0014095238095238089,18.523809523809526
8066,3048,7422,9,6,15,60.0,0.006946666666666668,23.466666666666665
8067,1274,-2444,7,12,19,36.84,-0.03421052631578948,38.8421052631579
8068,5143,10647,18,12,30,60.0,0.010446666666666665,14.7
8069,2267,-11397,6,7,13,46.15,-0.013753846153846151,22.692307692307693
8071,1847,10093,12,6,18,66.67,0.02561111111111111,25.333333333333332
8074,2396,7524,13,9,22,59.09,0.012027272727272727,56.0
8076,12405,42545,11,6,17,64.71,0.023588235294117646,29.705882352941178
8077,1878,932,14,9,23,60.87,0.009595652173913042,33.391304347826086
8080,1985,7665,11,10,21,52.38,-0.0036047619047619023,16.714285714285715
8083,6319,-7299,7,5,12,58.33,0.005,169.41666666666666
8084,3661,18359,15,10,25,60.0,0.013723999999999998,35.96
8085,1815,-945,13,10,23,56.52,0.004247826086956516,25.73913043478261
8086,4557,-22357,6,8,14,42.86,-0.020207142857142858,12.642857142857142
8087,1260,-2050,6,10,16,37.5,-0.037337499999999996,37.75
8088,1939,4011,11,8,19,57.89,0.008968421052631582,14.947368421052632
8089,293,1507,4,1,5,80.0,0.050039999999999994,19.2
8091,2272,-21882,3,9,12,25.0,-0.05594166666666667,21.166666666666668
8092,1606,4334,12,8,20,60.0,0.013005,32.4
8093,1704,15526,16,6,22,72.73,0.037490909090909096,21.363636363636363
8096,2398,10832,13,9,22,59.09,0.011818181818181816,16.681818181818183
8097,1468,-1578,11,7,18,61.11,0.014566666666666665,24.11111111111111
8099,2108,11342,11,5,16,68.75,0.031656250000000004,33.1875
8107,1953,5167,11,6,17,64.71,0.023305882352941176,23.235294117647058
8109,3497,9093,7,5,12,58.33,0.010841666666666666,83.16666666666667
8111,2143,-8323,10,12,22,45.45,-0.016849999999999997,26.363636363636363
8121,3777,11133,14,7,21,66.67,0.027171428571428572,15.19047619047619
8147,1761,5979,5,3,8,62.5,0.0090625,47.5
8155,2959,-749,5,3,8,62.5,0.0191625,22.25
8171,1606,-21266,3,10,13,23.08,-0.060630769230769224,20.076923076923077
8176,629,-3429,3,6,9,33.33,-0.0407,24.333333333333332
8182,2003,14287,11,5,16,68.75,0.03150625,34.1875
8183,1770,4840,13,7,20,65.0,0.021575,22.2
8234,2826,-15076,6,10,16,37.5,-0.030981250000000002,45.1875
8240,4288,8382,8,9,17,47.06,-0.011811764705882355,31.41176470588235
8255,9268,-57488,6,11,17,35.29,-0.03530588235294118,48.35294117647059
8277,1719,10081,12,6,18,66.67,0.025588888888888887,19.666666666666668
8279,3484,-18024,2,4,6,33.33,-0.039233333333333335,40.166666666666664
8284,2059,4831,5,3,8,62.5,0.019175,89.125
8289,931,799,6,6,12,50.0,-0.006516666666666666,49.333333333333336
8291,510,220,5,4,9,55.56,0.00037777777777777473,23.77777777777778
8299,13481,40769,6,6,12,50.0,-0.005849999999999998,19.833333333333332
8342,564,-994,1,1,2,50.0,-0.0058999999999999955,243.0
8349,4293,44307,9,6,15,60.0,0.014166666666666664,81.06666666666666
8354,1846,-2646,9,10,19,47.37,-0.011457894736842108,87.84210526315789
8358,2191,-5011,7,7,14,50.0,-0.0008785714285714277,54.5
8383,2310,-10970,5,9,14,35.71,-0.03447142857142856,45.142857142857146
8390,2382,8098,8,7,15,53.33,0.0007599999999999996,28.4
8401,1616,-5446,6,10,16,37.5,-0.0312375,72.75
8403,1627,12333,6,2,8,75.0,0.044187500000000005,56.875
8409,1376,924,5,5,10,50.0,-0.005849999999999999,50.4
8410,2162,1978,7,5,12,58.33,0.010833333333333334,35.166666666666664
8415,721,1629,2,2,4,50.0,0.007049999999999999,107.0
8416,5652,-63902,2,6,8,25.0,-0.0669125,65.0
8418,1150,11770,6,2,8,75.0,0.043887499999999996,68.125
8420,518,-3578,1,3,4,25.0,-0.055975,57.0
8421,1015,-5895,4,8,12,33.33,-0.0397,58.25
8423,2129,-9459,6,10,16,37.5,-0.03093125,45.75
8424,1847,-22007,1,6,7,14.29,-0.07744285714285715,90.71428571428571
8426,1626,3514,5,5,10,50.0,-0.005830000000000004,23.6
8431,2064,-5534,3,4,7,42.86,-0.020157142857142856,16.428571428571427
8432,4886,19194,8,5,13,61.54,0.01724615384615385,61.23076923076923
8433,3375,47775,6,1,7,85.71,0.06568571428571428,45.857142857142854
8435,1433,3477,3,2,5,60.0,0.01416,202.8
8436,7181,103889,5,1,6,83.33,0.06091666666666667,32.5
8437,6370,67680,6,1,7,85.71,0.06568571428571428,102.57142857142857
8440,1555,-10695,3,6,9,33.33,-0.039222222222222214,57.55555555555556
8444,3887,47113,5,1,6,83.33,0.06091666666666667,68.5
8446,6358,-12118,5,6,11,45.45,-0.014954545454545453,45.18181818181818
8450,2663,3707,6,5,11,54.55,0.003209090909090909,42.45454545454545
8455,1097,-13627,1,5,6,16.67,-0.07263333333333333,39.5
8472,2295,17365,6,3,9,66.67,0.02754444444444444,60.77777777777778
8476,1578,12932,6,3,9,66.67,0.02117777777777778,39.77777777777778
8477,2304,1716,5,4,9,55.56,0.005277777777777776,37.22222222222222
8489,5963,-1353,6,5,11,54.55,0.003227272727272726,17.0
8905,1621,789,8,8,16,50.0,-0.006012499999999999,94.4375
8906,1098,-3898,8,9,17,47.06,-0.014917647058823525,55.64705882352941
8908,977,2753,4,3,7,57.14,0.008342857142857141,133.0
8916,2224,-9214,5,10,15,33.33,-0.04004,46.93333333333333
8917,1594,-21174,1,6,7,14.29,-0.07738571428571428,241.57142857142858
8921,1164,-884,7,7,14,50.0,-0.012457142857142858,110.28571428571429
8923,1392,-21322,1,14,15,6.67,-0.09276666666666668,126.06666666666666
8924,3578,15342,10,6,16,62.5,0.019112500000000004,58.875
8927,1598,-7518,6,13,19,31.58,-0.043194736842105265,76.78947368421052
8928,2710,-10200,13,13,26,50.0,-0.00675,42.38461538461539
8929,3455,-18435,10,13,23,43.48,-0.02756521739130435,38.78260869565217
8930,1330,7490,13,5,18,72.22,0.037700000000000004,57.55555555555556
8931,1104,-9594,3,8,11,27.27,-0.04534545454545454,123.18181818181819
8932,1000,2290,8,6,14,57.14,0.006771428571428574,43.57142857142857
8933,1756,-1506,9,13,22,40.91,-0.02492727272727273,38.54545454545455
8935,1615,785,14,12,26,53.85,-0.0015576923076923075,20.923076923076923
8936,2957,5933,14,8,22,63.64,0.02102727272727273,32.86363636363637
8937,2102,1578,9,13,22,40.91,-0.024472727272727278,46.31818181818182
8938,5737,17203,14,9,23,60.87,0.015895652173913043,52.65217391304348
8941,7046,42104,17,7,24,70.83,0.034687499999999996,35.583333333333336
8942,5156,-19326,7,10,17,41.18,-0.027641176470588235,53.411764705882355
9949,2425,-5625,9,11,20,45.0,-0.011144999999999999,57.7
9950,1440,2170,7,6,13,53.85,0.008315384615384617,97.38461538461539
9951,5052,12808,8,7,15,53.33,0.0008133333333333326,45.53333333333333
9960,2027,-1187,9,7,16,56.25,0.0013187499999999987,65.9375
9962,1240,-4720,7,9,16,43.75,-0.019431249999999997,54.375
8916A,0,0,0,0,0,0.0,,
4148,1040,-18390,0,3,3,0.0,-0.106,22.0
6781,6221,102779,1,0,1,100.0,0.0943,11.0
6776,455,-4445,0,2,2,0.0,-0.057300000000000004,28.5
2211,287,-5087,0,1,1,0.0,-0.106,50.0
6768,0,0,0,0,0,0.0,,
3357,1531,11639,4,3,7,57.14,0.008385714285714286,347.42857142857144
6741,776,12824,1,0,1,100.0,0.0943,2.0
2250,2323,-18623,1,3,4,25.0,-0.055925,22.0
5236,846,-7026,1,1,2,50.0,-0.0489,3.0
1522A,0,0,0,0,0,0.0,,
6684,1218,18762,3,0,3,100.0,0.08616666666666667,5.333333333333333
2753,764,-13514,0,1,1,0.0,-0.106,90.0
2348A,217,-217,0,1,1,0.0,-0.0059,85.0
6790,461,4199,2,0,2,100.0,0.0508,13.0
6788,1043,-18443,0,1,1,0.0,-0.106,6.0
2947,611,5389,1,0,1,100.0,0.0508,66.0
4440,0,0,0,0,0,0.0,,
5222,615,3965,3,1,4,75.0,0.04425,48.0
2881C,0,0,0,0,0,0.0,,
6761,685,11315,1,0,1,100.0,0.0943,36.0
6806,588,-10388,0,1,1,0.0,-0.106,4.0
2945,625,7915,2,0,2,100.0,0.06985,36.0
6770,376,3144,1,1,2,50.0,0.045849999999999995,18.0
6792,0,0,0,0,0,0.0,,
4770,0,0,0,0,0,0.0,,
2883B,67,693,1,0,1,100.0,0.0759,139.0
6691,0,0,0,0,0,0.0,,
3592,10508,67902,6,5,11,54.55,-0.0019000000000000015,24.181818181818183
6719,3267,-29617,1,1,2,50.0,-0.052199999999999996,7.0
2756,0,0,0,0,0,0.0,,
5244,517,4043,5,2,7,71.43,0.03528571428571429,84.85714285714286
6693,0,0,0,0,0,0.0,,
8112A,0,0,0,0,0,0.0,,
8438,1014,-3284,2,4,6,33.33,-0.02395,63.833333333333336
6829,0,0,0,0,0,0.0,,
4923,843,-34503,2,3,5,40.0,-0.39484,750.6
6763,2996,49504,1,0,1,100.0,0.0943,7.0
4558,250,-1460,1,2,3,33.33,-0.039266666666666665,89.33333333333333
3349,1383,2627,8,6,14,57.14,0.0079,203.28571428571428
6804,296,104,1,0,1,100.0,0.002,24.0
4768,0,0,0,0,0,0.0,,
6807,0,0,0,0,0,0.0,,
6721,0,0,0,0,0,0.0,,
6735,0,0,0,0,0,0.0,,
4583,0,0,0,0,0,0.0,,
6799,711,-12561,0,1,1,0.0,-0.106,5.0
6585,357,5913,1,0,1,100.0,0.0943,70.0
5228,524,996,2,2,4,50.0,-0.00595,507.0
6546,312,2308,2,1,3,66.67,0.027733333333333336,44.666666666666664
6796,0,0,0,0,0,0.0,,
6550,832,1838,2,2,4,50.0,-0.005899999999999999,26.25
4577,0,0,0,0,0,0.0,,
6789,0,0,0,0,0,0.0,,
6823,0,0,0,0,0,0.0,,
2887Z1,0,0,0,0,0,0.0,,
6811,0,0,0,0,0,0.0,,
6854,0,0,0,0,0,0.0,,
3715,0,0,0,0,0,0.0,,
6830,0,0,0,0,0,0.0,,
6834,0,0,0,0,0,0.0,,
3430,866,2664,4,3,7,57.14,0.008471428571428569,87.0
6689,0,0,0,0,0,0.0,,
6592A,0,0,0,0,0,0.0,,
