代號,總成本,總損益(淨),獲利次數,損失次數,總交易次數,勝率%,平均報酬,平均持倉時間(日)
1101,2985,-11195,6,9,15,40.0,-0.025939999999999998,68.26666666666667
1102,1590,4720,5,4,9,55.56,0.005222222222222225,82.55555555555556
1103,1211,2669,8,6,14,57.14,0.00792142857142857,50.357142857142854
1104,1284,526,6,7,13,46.15,-0.013838461538461534,76.6923076923077
1108,855,1995,7,6,13,53.85,-0.0006230769230769217,96.38461538461539
1109,1414,-4184,7,12,19,36.84,-0.03323157894736842,65.3157894736842
1110,1086,-5966,5,9,14,35.71,-0.03554999999999999,69.28571428571429
1201,1689,-12869,4,8,12,33.33,-0.039475,75.41666666666667
1203,1420,-4850,5,7,12,41.67,-0.022949999999999998,77.58333333333333
1210,1918,5802,6,5,11,54.55,0.003072727272727274,116.27272727272727
1213,1821,9929,14,8,22,63.64,0.02508181818181818,54.31818181818182
1215,2889,1851,9,8,17,52.94,-0.001064705882352939,63.64705882352941
1216,1914,-15544,2,5,7,28.57,-0.04874285714285714,87.71428571428571
1217,1077,-2577,7,10,17,41.18,-0.026141176470588237,70.82352941176471
1218,1557,-14777,5,13,18,27.78,-0.05178333333333333,41.05555555555556
1219,1234,-5124,6,8,14,42.86,-0.021249999999999998,75.71428571428571
1220,897,-1697,6,7,13,46.15,-0.020938461538461538,87.46153846153847
1225,2017,-207,5,8,13,38.46,-0.030223076923076922,59.30769230769231
1227,4301,17639,8,3,11,72.73,0.031818181818181815,127.72727272727273
1229,1362,-12042,4,8,12,33.33,-0.03969166666666667,47.75
1231,3037,9763,10,8,18,55.56,0.004800000000000001,49.77777777777778
1232,2346,-966,3,5,8,37.5,-0.030975000000000003,154.375
1233,2256,-23456,2,8,10,20.0,-0.06597,206.5
1234,1547,703,7,5,12,58.33,0.010249999999999999,99.75
1235,2286,7794,9,6,15,60.0,0.014106666666666665,87.46666666666667
1236,1660,-2990,7,8,15,46.67,-0.017266666666666666,94.86666666666666
1256,12973,77927,7,4,11,63.64,0.021463636363636362,32.45454545454545
1301,3860,-22800,3,6,9,33.33,-0.039233333333333335,82.55555555555556
1303,5424,-9274,7,8,15,46.67,-0.012533333333333336,76.4
1304,2057,2033,11,8,19,57.89,0.009526315789473683,60.526315789473685
1305,1695,8535,9,7,16,56.25,0.006087500000000003,30.5625
1307,1354,2436,5,5,10,50.0,-0.005899999999999998,88.9
1308,1814,1166,9,6,15,60.0,0.014026666666666661,62.2
1309,1797,-1867,11,10,21,52.38,-0.0025238095238095245,29.333333333333332
1310,1773,-3873,8,11,19,42.11,-0.02219473684210526,45.05263157894737
1312,1648,2982,10,9,19,52.63,0.0035842105263157904,38.8421052631579
1313,1295,11705,13,3,16,81.25,0.056118749999999995,41.3125
1314,1681,4759,12,10,22,54.55,0.0014999999999999987,30.227272727272727
1315,1648,-2418,5,6,11,45.45,-0.015636363636363636,96.9090909090909
1316,1738,3102,14,10,24,58.33,0.009845833333333337,31.958333333333332
1319,4405,28495,15,6,21,71.43,0.036966666666666675,37.904761904761905
1321,1831,-3401,7,8,15,46.67,-0.01279333333333333,55.53333333333333
1323,1997,-7427,7,9,16,43.75,-0.023149999999999997,64.875
1324,1296,-936,9,8,17,52.94,-0.0009235294117647087,65.23529411764706
1325,2378,-13978,7,12,19,36.84,-0.03274736842105263,90.05263157894737
1326,5968,25192,9,5,14,64.29,0.02275714285714286,129.71428571428572
1337,1685,24345,11,1,12,91.67,0.076825,49.333333333333336
1338,2755,7235,4,3,7,57.14,0.008457142857142856,40.57142857142857
1339,972,-9002,1,3,4,25.0,-0.0559,66.25
1340,2668,35652,8,3,11,72.73,0.03929090909090908,83.0909090909091
1341,745,-13185,0,2,2,0.0,-0.106,197.0
1342,681,1819,1,0,1,100.0,0.0155,26.0
1402,1426,-5876,3,6,9,33.33,-0.039344444444444446,91.44444444444444
1409,1037,-1487,7,7,14,50.0,-0.012564285714285712,46.714285714285715
1410,1724,-2534,10,8,18,55.56,-0.0007388888888888898,64.72222222222223
1413,1546,2144,16,11,27,59.26,0.005248148148148146,48.0
1414,1507,-2247,12,14,26,46.15,-0.019284615384615386,29.03846153846154
1416,1126,3494,9,6,15,60.0,0.011466666666666665,37.13333333333333
1417,867,1003,8,6,14,57.14,0.005078571428571426,55.357142857142854
1418,1353,-6863,8,16,24,33.33,-0.046391666666666664,31.416666666666668
1419,2542,-7572,6,8,14,42.86,-0.020199999999999996,68.78571428571429
1423,911,-1701,7,8,15,46.67,-0.017206666666666665,81.6
1432,123,-11643,1,1,2,50.0,-1.0451000000000001,2727.5
1434,1834,-7214,5,7,12,41.67,-0.024533333333333327,133.66666666666666
1435,1064,656,11,7,18,61.11,0.010694444444444447,32.888888888888886
1436,2074,-17224,2,10,12,16.67,-0.07370833333333333,168.58333333333334
1437,1596,1814,10,8,18,55.56,0.004638888888888888,35.05555555555556
1438,284,-29294,4,2,6,66.67,-5.714916666666667,891.5
1439,2499,-19409,7,17,24,29.17,-0.04805416666666667,40.708333333333336
1440,1658,-3548,9,11,20,45.0,-0.01883499999999999,36.5
1441,1276,-1636,11,10,21,52.38,-0.009466666666666668,51.285714285714285
1442,2094,-12644,6,14,20,30.0,-0.046595,68.15
1443,685,1025,8,5,13,61.54,0.007530769230769234,40.84615384615385
1444,1231,-3611,9,11,20,45.0,-0.019774999999999997,35.05
1445,723,-2213,5,6,11,45.45,-0.018354545454545453,110.36363636363636
1446,1942,-9182,11,9,20,55.0,0.0014850000000000015,30.55
1447,994,56,7,8,15,46.67,-0.014520000000000002,30.466666666666665
1449,1309,701,15,11,26,57.69,-0.005746153846153845,24.615384615384617
1451,2854,15896,15,8,23,65.22,0.02438260869565217,56.78260869565217
1452,1847,6963,13,7,20,65.0,0.020365,61.95
1453,1200,-330,12,8,20,60.0,0.006890000000000002,66.2
1454,866,1024,8,6,14,57.14,0.005592857142857141,97.35714285714286
1455,1509,-3559,10,12,22,45.45,-0.019672727272727272,56.04545454545455
1456,578,-8068,6,6,12,50.0,-0.09358333333333334,282.5
1457,651,-1911,5,5,10,50.0,-0.014600000000000002,58.3
1459,1077,-3047,7,10,17,41.18,-0.02615882352941177,43.23529411764706
1460,1245,2855,11,8,19,57.89,0.007078947368421052,61.31578947368421
1463,1199,3431,9,9,18,50.0,-0.010122222222222223,17.444444444444443
1464,1725,7155,12,6,18,66.67,0.02625,58.5
1465,1320,-2010,8,9,17,47.06,-0.012535294117647058,102.41176470588235
1466,1849,-5899,12,12,24,50.0,-0.008945833333333333,55.708333333333336
1467,1478,-8768,7,13,20,35.0,-0.037395,33.2
1468,518,-5838,1,6,7,14.29,-0.07808571428571429,192.85714285714286
1470,748,-4188,3,8,11,27.27,-0.05532727272727272,55.63636363636363
1471,1704,10086,13,5,18,72.22,0.03627777777777778,17.11111111111111
1472,1930,12660,15,8,23,65.22,0.022621739130434793,28.043478260869566
1473,2653,4877,9,7,16,56.25,0.006662499999999998,117.5625
1474,876,3154,8,5,13,61.54,0.015046153846153846,85.84615384615384
1475,2807,7103,18,11,29,62.07,0.016724137931034482,19.06896551724138
1476,4081,-1631,4,3,7,57.14,0.00832857142857143,54.714285714285715
1477,10095,64585,11,5,16,68.75,0.0316875,52.6875
1503,2046,-30586,1,10,11,9.09,-0.08780909090909089,195.72727272727272
1504,1217,-317,5,6,11,45.45,-0.015190909090909093,58.54545454545455
1506,2271,-211,11,12,23,47.83,-0.012321739130434778,53.04347826086956
1512,1308,7192,17,5,22,77.27,0.04451363636363636,22.545454545454547
1513,1479,-7779,5,8,13,38.46,-0.029099999999999997,60.69230769230769
1514,1178,-2298,9,7,16,56.25,0.0043,48.0625
1515,3085,2505,13,8,21,61.9,0.015985714285714287,38.095238095238095
1516,1142,-2242,10,8,18,55.56,0.0011611111111111089,34.72222222222222
1517,1480,370,10,10,20,50.0,-0.00711,52.75
1519,2157,-12127,6,11,17,35.29,-0.03561176470588236,61.470588235294116
1521,3714,13486,9,4,13,69.23,0.03257692307692308,101.6923076923077
1522,2204,4466,9,9,18,50.0,-0.0060166666666666676,36.666666666666664
1524,1259,-2419,8,10,18,44.44,-0.01892222222222222,68.11111111111111
1525,5185,19405,11,5,16,68.75,0.0317,66.1875
1526,2145,15905,12,10,22,54.55,0.0005681818181818162,30.5
1527,3585,25995,10,4,14,71.43,0.03701428571428572,58.42857142857143
1528,1915,4915,16,10,26,61.54,0.016107692307692302,36.73076923076923
1529,1670,2510,17,10,27,62.96,0.01412962962962963,15.666666666666666
1530,3013,-13663,6,10,16,37.5,-0.030918749999999995,71.75
1531,2721,4179,11,9,20,55.0,0.004040000000000003,57.75
1532,3098,-2868,8,9,17,47.06,-0.011770588235294121,58.8235294117647
1533,4543,-7053,12,13,25,48.0,-0.009987999999999999,34.52
1535,3268,27452,9,5,14,64.29,0.022485714285714282,55.57142857142857
1536,3885,55985,13,1,14,92.86,0.0781357142857143,45.785714285714285
1537,3366,19814,6,3,9,66.67,0.027533333333333337,69.77777777777777
1538,2234,6966,12,11,23,52.17,-0.00343913043478261,19.043478260869566
1539,2055,7455,13,10,23,56.52,0.005295652173913042,40.52173913043478
1540,2305,3395,11,8,19,57.89,0.009931578947368423,41.63157894736842
1541,3286,-14636,12,16,28,42.86,-0.021146428571428573,32.107142857142854
1558,6493,9947,6,5,11,54.55,-0.003327272727272729,83.0
1560,7163,-29643,9,10,19,47.37,-0.011136842105263159,22.263157894736842
1568,1278,3752,6,4,10,60.0,0.014149999999999996,20.7
1582,6111,-7081,7,8,15,46.67,-0.012519999999999998,35.13333333333333
1583,3080,-2690,6,6,12,50.0,-0.005866666666666666,58.25
1587,1180,-7630,3,6,9,33.33,-0.03926666666666667,43.666666666666664
1589,6145,-42055,5,7,12,41.67,-0.02255,20.583333333333332
1590,17596,954,3,5,8,37.5,-0.0183625,14.375
1597,4266,22944,7,3,10,70.0,0.03302000000000001,35.1
1598,1815,-6765,3,4,7,42.86,-0.020142857142857146,17.0
1603,1749,-2729,10,11,21,47.62,-0.01360952380952381,60.76190476190476
1604,798,6642,8,3,11,72.73,0.036427272727272725,63.09090909090909
1605,1705,-5565,7,10,17,41.18,-0.024317647058823527,34.23529411764706
1608,1349,10161,15,4,19,78.95,0.050021052631578945,33.31578947368421
1609,1502,-1522,10,10,20,50.0,-0.008494999999999999,34.1
1611,1274,-2334,7,9,16,43.75,-0.019212499999999997,44.75
1612,1003,9647,9,3,12,75.0,0.04340833333333333,33.0
1614,2714,-6624,8,9,17,47.06,-0.011776470588235294,107.41176470588235
1615,1462,-952,8,9,17,47.06,-0.012958823529411764,108.05882352941177
1616,1229,-2409,9,11,20,45.0,-0.019475,30.2
1617,1182,-3912,7,10,17,41.18,-0.02543529411764706,108.23529411764706
1618,1338,-1758,8,9,17,47.06,-0.012952941176470585,56.11764705882353
1626,2045,6675,7,4,11,63.64,0.02141818181818182,21.181818181818183
1701,1729,-10629,5,11,16,31.25,-0.046081250000000004,77.5
1702,2389,23301,10,4,14,71.43,0.034992857142857145,80.71428571428571
1707,9252,-32872,6,11,17,35.29,-0.035529411764705886,67.58823529411765
1708,1938,-5758,6,7,13,46.15,-0.014123076923076926,78.76923076923077
1709,1407,2453,8,8,16,50.0,-0.006287499999999997,99.3125
1710,2548,10092,11,6,17,64.71,0.023523529411764707,63.94117647058823
1711,2101,-411,10,9,19,52.63,-0.0009578947368421028,43.21052631578947
1712,1012,-1662,6,6,12,50.0,-0.0011583333333333352,60.75
1713,1176,-7706,5,10,15,33.33,-0.040526666666666676,80.8
1714,1399,-6889,7,13,20,35.0,-0.037520000000000005,48.9
1717,1742,10478,8,3,11,72.73,0.03355454545454546,125.81818181818181
1718,1557,673,13,10,23,56.52,0.005395652173913042,34.04347826086956
1720,1495,-5795,4,6,10,40.0,-0.025929999999999998,68.0
1721,1486,-2706,9,12,21,42.86,-0.02222380952380952,45.857142857142854
1722,4688,11752,8,7,15,53.33,0.0008333333333333332,77.26666666666667
1723,7039,-9999,6,6,12,50.0,-0.005858333333333333,51.5
1725,1502,738,8,6,14,57.14,0.008335714285714288,33.42857142857143
1726,2672,-21092,2,6,8,25.0,-0.050375,183.625
1727,1592,-10272,5,11,16,31.25,-0.04383125,75.625
1730,2412,-13382,6,8,14,42.86,-0.02079285714285714,91.85714285714286
1731,910,4620,7,4,11,63.64,0.021054545454545458,86.45454545454545
1732,1990,17370,16,5,21,76.19,0.044,42.80952380952381
1733,4569,12561,12,7,19,63.16,0.020499999999999997,61.578947368421055
1734,2573,-1813,8,9,17,47.06,-0.011782352941176471,56.76470588235294
1735,1544,-44,9,9,18,50.0,-0.006427777777777779,75.61111111111111
1736,4489,27801,6,5,11,54.55,0.003236363636363637,55.63636363636363
1737,2340,-5530,7,9,16,43.75,-0.01845625,131.5625
1760,8858,-32458,7,9,16,43.75,-0.0185125,37.6875
1762,1420,-14480,2,4,6,33.33,-0.039266666666666665,44.333333333333336
1773,3790,24740,5,3,8,62.5,0.0191875,62.5
1776,501,-8841,0,5,5,0.0,-0.10611999999999999,118.0
1783,1810,-5290,5,5,10,50.0,-0.00584,27.6
1786,2435,-8635,3,5,8,37.5,-0.0309,49.625
1789,2418,13732,6,4,10,60.0,0.014149999999999996,70.6
1795,4178,-1228,6,6,12,50.0,-0.0058583333333333334,24.833333333333332
1802,2531,-271,11,10,21,52.38,-0.0013190476190476166,58.523809523809526
1805,1761,-611,14,12,26,53.85,-0.003169230769230772,32.42307692307692
1806,1387,-5557,7,11,18,38.89,-0.029722222222222223,58.111111111111114
1808,2067,17263,8,5,13,61.54,0.016446153846153846,45.84615384615385
1809,1381,2369,10,7,17,58.82,0.010511764705882347,41.0
1810,1293,-5363,7,12,19,36.84,-0.03375789473684211,48.8421052631579
1817,1057,9593,4,1,5,80.0,0.05417999999999999,179.0
1903,5595,-4585,13,13,26,50.0,-0.005884615384615383,51.26923076923077
1904,1440,-2010,8,7,15,53.33,-0.0001933333333333333,86.6
1905,910,3350,7,5,12,58.33,0.009791666666666666,80.5
1906,1596,-4836,10,12,22,45.45,-0.015436363636363635,31.727272727272727
1907,1694,-14264,5,14,19,26.32,-0.05423157894736843,37.94736842105263
1909,1632,10128,13,6,19,68.42,0.02999473684210527,34.89473684210526
2002,1562,18178,8,2,10,80.0,0.054200000000000005,159.3
2006,2329,-1129,7,8,15,46.67,-0.01259333333333333,65.4
2007,1213,5647,14,6,20,70.0,0.02962,31.5
2008,938,-4408,5,10,15,33.33,-0.042373333333333346,18.333333333333332
2009,1864,-4534,11,10,21,52.38,-0.0025571428571428577,53.61904761904762
2010,1711,-1111,10,10,20,50.0,-0.006440000000000001,87.0
2012,1327,-5277,7,10,17,41.18,-0.024688235294117646,66.11764705882354
2013,2690,-750,10,10,20,50.0,-0.005934999999999998,78.5
2014,1912,4018,12,9,21,57.14,0.006923809523809528,26.38095238095238
2015,3798,-12228,5,9,14,35.71,-0.03449285714285714,108.85714285714286
2017,1090,3870,10,6,16,62.5,0.016606250000000003,54.375
2020,2095,7585,11,8,19,57.89,0.009821052631578949,62.578947368421055
2022,1132,3698,12,7,19,63.16,0.016173684210526316,30.526315789473685
2023,1253,2927,8,7,15,53.33,-7.333333333333821e-05,75.33333333333333
2024,1043,1967,9,7,16,56.25,-0.0020937499999999993,31.25
2025,1459,2061,15,12,27,55.56,-0.00273703703703704,22.25925925925926
2027,2545,-6395,7,10,17,41.18,-0.023588235294117646,29.235294117647058
2028,1437,9103,14,6,20,70.0,0.027275,33.45
2029,1992,7198,9,5,14,64.29,0.022735714285714293,99.42857142857143
2030,1897,3043,9,9,18,50.0,-0.006349999999999997,34.94444444444444
2031,2874,16656,12,6,18,66.67,0.027488888888888886,41.27777777777778
2032,1977,7383,12,9,21,57.14,0.012185714285714286,23.142857142857142
2033,1187,-2487,6,9,15,40.0,-0.026813333333333342,58.8
2034,1504,14106,9,2,11,81.82,0.05179090909090909,86.81818181818181
2038,1276,4364,8,7,15,53.33,-0.0008533333333333338,44.86666666666667
2049,12636,157714,8,1,9,88.89,0.07204444444444445,19.444444444444443
2059,15347,-78167,5,7,12,41.67,-0.022541666666666668,34.916666666666664
2062,3555,2895,10,9,19,52.63,-0.005315789473684215,60.31578947368421
2069,1000,5130,6,3,9,66.67,0.02266666666666667,56.888888888888886
2101,2561,-361,7,6,13,53.85,0.0018076923076923072,57.30769230769231
2102,2126,3874,12,9,21,57.14,0.008309523809523812,35.333333333333336
2103,4576,-18036,9,13,22,40.91,-0.02408636363636363,43.45454545454545
2104,1667,-3287,5,7,12,41.67,-0.022841666666666666,45.75
2105,4008,-7088,7,8,15,46.67,-0.012573333333333332,67.2
2106,4092,12618,13,8,21,61.9,0.01796666666666667,54.76190476190476
2107,1950,-1720,9,11,20,45.0,-0.016099999999999996,49.8
2108,3667,32163,12,7,19,63.16,0.017436842105263157,52.526315789473685
2109,1400,4170,11,8,19,57.89,0.00846842105263158,50.0
2114,2716,-25836,2,5,7,28.57,-0.048799999999999996,66.0
2115,2135,22025,7,2,9,77.78,0.04974444444444445,79.22222222222223
2201,2081,7829,7,4,11,63.64,0.02142727272727273,76.9090909090909
2204,3368,-498,10,10,20,50.0,-0.005964999999999999,50.0
2206,1821,-20521,3,12,15,20.0,-0.06641333333333332,90.8
2207,13560,-70780,2,5,7,28.57,-0.04877142857142857,49.285714285714285
2208,1598,7662,9,5,14,64.29,0.022549999999999997,62.857142857142854
2227,16424,-131014,7,10,17,41.18,-0.019482352941176475,94.70588235294117
2228,5456,-31976,3,6,9,33.33,-0.039233333333333335,56.0
2231,15799,-3319,9,6,15,60.0,0.009006666666666666,17.0
2233,5287,4993,5,5,10,50.0,0.0018599999999999988,25.2
2236,1185,3495,4,2,6,66.67,0.027499999999999997,57.833333333333336
2239,3825,27335,5,3,8,62.5,0.019187499999999996,23.5
2241,2522,1958,4,3,7,57.14,0.008428571428571428,38.0
2243,872,6998,5,2,7,71.43,0.024871428571428572,15.428571428571429
2247,1438,23762,1,0,1,100.0,0.0943,17.0
2301,1448,472,3,3,6,50.0,-0.005883333333333333,81.0
2302,863,2797,9,6,15,60.0,0.007880000000000002,21.266666666666666
2303,1350,60,8,8,16,50.0,-0.0064687500000000005,41.3125
2305,1410,-660,14,10,24,58.33,0.004708333333333335,29.208333333333332
2308,8664,54406,8,3,11,72.73,0.039672727272727276,40.18181818181818
2312,931,5479,9,4,13,69.23,0.03117692307692307,74.23076923076923
2313,1296,3584,8,4,12,66.67,0.02616666666666666,38.833333333333336
2314,2564,13106,16,9,25,64.0,0.021471999999999998,18.88
2316,2105,-6525,9,12,21,42.86,-0.021238095238095236,38.76190476190476
2317,10195,-68225,5,11,16,31.25,-0.04340625,55.1875
2321,1564,836,16,10,26,61.54,0.008226923076923078,19.653846153846153
2323,975,595,7,8,15,46.67,-0.016226666666666667,30.333333333333332
2324,2141,-2871,6,8,14,42.86,-0.020185714285714286,71.28571428571429
2327,18473,37237,9,9,18,50.0,-0.007038888888888888,25.77777777777778
2328,2589,20381,10,5,15,66.67,0.027433333333333334,29.533333333333335
2329,1535,3785,13,12,25,52.0,-0.008031999999999997,19.56
2330,4491,-47611,3,5,8,37.5,-0.030887500000000002,28.25
2331,2088,7962,14,9,23,60.87,0.015052173913043478,29.304347826086957
2332,2244,-5454,7,12,19,36.84,-0.03259473684210526,35.0
2337,2603,17577,18,11,29,62.07,0.01556206896551724,25.0
2338,1077,-5217,5,8,13,38.46,-0.029792307692307687,82.3076923076923
2340,1721,-2531,9,10,19,47.37,-0.012594736842105261,23.842105263157894
2342,2061,1469,15,11,26,57.69,0.00046923076923077094,14.538461538461538
2344,1581,6009,12,8,20,60.0,0.011975,15.4
2345,5093,30107,9,4,13,69.23,0.032376923076923074,36.61538461538461
2347,3926,-10086,6,8,14,42.86,-0.02014285714285714,60.92857142857143
2348,899,-58259,7,4,11,63.64,-2.009454545454546,496.72727272727275
2349,1519,1061,13,12,25,52.0,-0.005935999999999997,35.56
2351,2411,16009,11,4,15,73.33,0.04072,24.866666666666667
2352,1786,-3626,9,6,15,60.0,0.01368666666666667,24.466666666666665
2353,4338,12022,13,8,21,61.9,0.017866666666666663,27.904761904761905
2354,9842,-3972,8,7,15,53.33,0.0008266666666666663,46.4
2355,3794,8696,13,10,23,56.52,0.007086956521739132,25.26086956521739
2356,1447,-12067,4,9,13,30.77,-0.04446923076923077,71.0
2357,16370,21620,9,8,17,52.94,3.529411764706065e-05,52.94117647058823
2358,2189,8011,18,11,29,62.07,0.016351724137931036,16.79310344827586
2359,1536,-10666,7,12,19,36.84,-0.03383684210526316,28.210526315789473
2360,8820,36750,11,8,19,57.89,0.009963157894736844,16.94736842105263
2362,3115,7985,10,8,18,55.56,0.0049888888888888865,27.38888888888889
2363,1727,-107,12,10,22,54.55,0.001631818181818183,15.863636363636363
2364,1987,5573,19,12,31,61.29,0.003983870967741934,25.677419354838708
2365,2683,11257,15,7,22,68.18,0.03016363636363636,36.63636363636363
2367,1724,4426,11,8,19,57.89,0.014563157894736839,24.31578947368421
2368,864,1506,6,5,11,54.55,0.002154545454545456,17.454545454545453
2369,1551,2869,11,8,19,57.89,0.00915263157894737,18.210526315789473
2371,1803,-5473,11,12,23,47.83,-0.012095652173913044,30.73913043478261
2373,3479,7631,6,7,13,46.15,-0.019884615384615386,116.84615384615384
2374,2455,12445,11,6,17,64.71,0.023488235294117643,31.11764705882353
2375,1894,17576,11,5,16,68.75,0.028312499999999997,22.875
2376,5225,11515,11,10,21,52.38,-0.0011380952380952377,28.571428571428573
2377,3813,37137,10,4,14,71.43,0.03702142857142857,21.142857142857142
2379,10388,-24498,5,9,14,35.71,-0.03446428571428571,38.142857142857146
2380,2059,-4929,12,16,28,42.86,-0.02218928571428572,25.678571428571427
2382,4232,2128,6,6,12,50.0,-0.00585,39.416666666666664
2383,1892,-2332,7,5,12,58.33,0.010133333333333336,49.5
2385,4603,23737,9,7,16,56.25,0.006656249999999997,43.6875
2387,3103,-7353,12,11,23,52.17,-0.0016695652173913033,33.130434782608695
2388,2814,4296,10,11,21,47.62,-0.011204761904761905,18.857142857142858
2390,2016,8874,14,8,22,63.64,0.02048181818181818,28.5
2392,3438,3032,8,4,12,66.67,0.027524999999999997,42.75
2393,5114,28656,12,5,17,70.59,0.035382352941176476,35.05882352941177
2395,6677,483,3,4,7,42.86,-0.02017142857142857,34.714285714285715
2397,4426,-31896,5,12,17,29.41,-0.047099999999999996,43.411764705882355
2399,1518,8032,11,6,17,64.71,0.022970588235294118,29.235294117647058
2401,3673,12587,15,11,26,57.69,0.009184615384615383,23.0
2402,2233,-6813,7,10,17,41.18,-0.02363529411764706,16.058823529411764
2404,6874,-13994,7,10,17,41.18,-0.02172941176470588,56.94117647058823
2405,1910,-5590,9,13,22,40.91,-0.025177272727272725,15.909090909090908
2406,2416,20624,17,7,24,70.83,0.032508333333333334,13.0
2408,3513,11407,15,7,22,68.18,0.027109090909090916,16.59090909090909
2409,2669,-21229,6,12,18,33.33,-0.039466666666666664,22.166666666666668
2412,3680,-43030,1,6,7,14.29,-0.07738571428571428,363.42857142857144
2413,2070,-9090,10,13,23,43.48,-0.019647826086956522,16.82608695652174
2414,997,-4897,4,7,11,36.36,-0.033736363636363634,61.09090909090909
2415,2697,15333,19,9,28,67.86,0.02936428571428571,22.071428571428573
2417,1710,-3450,7,6,13,53.85,0.0013307692307692315,39.38461538461539
2419,1551,199,10,8,18,55.56,0.00363888888888889,22.055555555555557
2420,2048,7842,8,6,14,57.14,0.008078571428571428,78.0
2421,2533,-12043,6,12,18,33.33,-0.03933888888888889,30.944444444444443
2423,2017,2563,10,8,18,55.56,0.005205555555555555,69.94444444444444
2424,2148,-15228,9,12,21,42.86,-0.02195238095238095,25.0
2425,2426,-2256,12,12,24,50.0,-0.008237500000000002,21.875
2426,2312,3188,14,9,23,60.87,0.015326086956521741,12.347826086956522
2427,970,980,7,7,14,50.0,-0.007821428571428573,20.857142857142858
2428,3163,1517,6,7,13,46.15,-0.013684615384615385,48.38461538461539
2429,385,-14985,3,5,8,37.5,-0.49926249999999994,688.375
2430,4145,16095,13,8,21,61.9,0.0179,69.28571428571429
2431,1158,7882,12,4,16,75.0,0.043024999999999994,30.9375
2433,2126,-18906,2,9,11,18.18,-0.0697090909090909,135.36363636363637
2434,2036,-6526,11,12,23,47.83,-0.01192173913043478,36.65217391304348
2436,2207,-12887,6,10,16,37.5,-0.0310625,24.75
2438,1537,3003,17,8,25,68.0,0.020672000000000003,28.44
2439,9433,15897,9,9,18,50.0,-0.005855555555555558,20.72222222222222
2440,1736,-2836,11,16,27,40.74,-0.027907407407407405,30.814814814814813
2441,2421,7459,6,6,12,50.0,-0.0059083333333333305,51.75
2442,1409,1311,12,10,22,54.55,0.0005181818181818186,27.681818181818183
2443,1572,4628,21,8,29,72.41,0.03100689655172413,25.482758620689655
2444,1471,-6561,8,13,21,38.1,-0.03155714285714286,25.904761904761905
2449,1831,-6761,7,9,16,43.75,-0.0187375,33.875
2450,3056,11464,6,6,12,50.0,-0.005916666666666667,91.25
2451,7293,-56033,5,11,16,31.25,-0.04340624999999999,83.6875
2453,1522,-3662,9,11,20,45.0,-0.016989999999999998,38.3
2454,31495,102405,9,7,16,56.25,0.006668749999999999,20.4375
2455,3729,14761,11,5,16,68.75,0.03146875,8.75
2457,1737,-347,11,8,19,57.89,0.00916842105263158,18.0
2458,4469,-2499,9,8,17,52.94,-5.882352941175823e-06,25.705882352941178
2459,3606,-9166,9,12,21,42.86,-0.02031904761904762,64.28571428571429
2460,2553,1277,11,13,24,45.83,-0.014629166666666667,35.75
2461,2166,7344,13,8,21,61.9,0.017723809523809524,28.238095238095237
2462,2325,4095,9,7,16,56.25,0.006531249999999999,33.625
2464,3120,-2160,9,9,18,50.0,-0.005877777777777772,49.833333333333336
2465,2415,16205,18,8,26,69.23,0.03005384615384616,24.076923076923077
2466,2629,-579,9,8,17,52.94,-0.0004411764705882357,111.76470588235294
2467,2348,-8898,8,12,20,40.0,-0.026135000000000002,37.3
2468,1591,-4281,10,12,22,45.45,-0.016231818181818184,54.04545454545455
2471,1314,-10574,5,11,16,31.25,-0.0449375,54.0625
2472,2693,-5733,10,11,21,47.62,-0.011333333333333332,17.571428571428573
2474,16306,-25026,8,9,17,47.06,-0.011741176470588236,22.647058823529413
2476,2863,-10453,7,13,20,35.0,-0.03223,34.4
2477,1634,11236,10,4,14,71.43,0.03670714285714285,26.857142857142858
2478,4997,11223,12,12,24,50.0,-0.0059208333333333335,29.791666666666668
2480,2056,-11446,6,7,13,46.15,-0.013723076923076923,41.76923076923077
2481,1802,16288,10,3,13,76.92,0.04790769230769231,18.23076923076923
2482,1688,-2998,7,10,17,41.18,-0.02388235294117647,46.294117647058826
2483,2032,5888,13,7,20,65.0,0.02386,41.5
2484,1360,-2710,6,7,13,46.15,-0.013753846153846155,35.0
2485,3662,19968,12,5,17,70.59,0.03534117647058824,38.94117647058823
2486,3568,26632,19,9,28,67.86,0.029471428571428575,19.785714285714285
2488,2783,11077,13,7,20,65.0,0.024,52.65
2489,2254,18386,16,4,20,80.0,0.05395000000000001,40.75
2491,917,1333,11,5,16,68.75,0.021256249999999997,20.0
2492,3846,51704,9,5,14,64.29,0.021571428571428568,30.214285714285715
2493,1376,-3566,6,7,13,46.15,-0.014600000000000005,31.76923076923077
2495,5384,-714,13,13,26,50.0,-0.006030769230769233,44.38461538461539
2496,5124,5196,12,9,21,57.14,0.0008619047619047654,50.142857142857146
2497,2368,17602,11,5,16,68.75,0.03164375,26.75
2498,40465,35125,11,13,24,45.83,-0.014204166666666669,22.375
2501,922,558,5,5,10,50.0,-0.0063500000000000015,94.7
2504,1306,11124,12,4,16,75.0,0.043143749999999995,29.25
2505,1725,-5225,10,9,19,52.63,-0.0013473684210526323,27.105263157894736
2506,1107,1913,12,6,18,66.67,0.017222222222222222,78.72222222222223
2509,1914,-114,9,8,17,52.94,-0.000688235294117648,33.588235294117645
2511,2085,-4645,11,14,25,44.0,-0.018964,56.48
2514,1380,-4850,6,9,15,40.0,-0.026266666666666664,68.26666666666667
2515,1026,-166,9,8,17,52.94,-0.0032117647058823536,51.35294117647059
2516,1257,3373,15,7,22,68.18,0.02557272727272727,57.04545454545455
2520,2147,3383,9,9,18,50.0,-0.006405555555555553,33.888888888888886
2524,3464,-3524,11,11,22,50.0,-0.010090909090909091,45.18181818181818
2527,1587,1943,11,7,18,61.11,0.014433333333333334,54.22222222222222
2528,1138,7822,12,5,17,70.59,0.009952941176470586,37.88235294117647
2530,1508,-3558,12,10,22,54.55,-0.0010000000000000009,40.31818181818182
2534,1568,-11528,4,11,15,26.67,-0.053126666666666676,29.066666666666666
2535,1386,-3236,7,7,14,50.0,-0.006378571428571426,64.21428571428571
2536,2440,-6960,7,9,16,43.75,-0.0184,119.8125
2537,1439,3031,12,8,20,60.0,0.012314999999999998,55.7
2538,1539,8591,12,6,18,66.67,0.026488888888888888,68.83333333333333
2539,504,-36314,3,3,6,50.0,-0.36295000000000005,903.6666666666666
2540,3243,-20773,9,11,20,45.0,-0.02531,28.45
2542,4014,-1354,9,8,17,52.94,-1.1764705882353279e-05,33.705882352941174
2543,1340,-1030,10,11,21,47.62,-0.01318571428571429,61.61904761904762
2545,4399,-13159,9,11,20,45.0,-0.015940000000000003,36.75
2546,2097,-20917,6,12,18,33.33,-0.0400111111111111,61.22222222222222
2547,2348,14162,13,7,20,65.0,0.02389,19.0
2548,3763,-6313,4,6,10,40.0,-0.025879999999999997,37.1
2597,3829,13581,7,5,12,58.33,0.010816666666666664,57.75
2601,2025,10025,12,8,20,60.0,0.012899999999999998,28.2
2603,1687,10023,6,5,11,54.55,0.0031090909090909073,71.54545454545455
2605,2052,12788,10,4,14,71.43,0.03704285714285715,52.92857142857143
2606,3438,20392,9,4,13,69.23,0.03265384615384615,28.53846153846154
2607,1487,2653,9,6,15,60.0,0.013986666666666666,52.93333333333333
2608,1353,-9853,4,6,10,40.0,-0.026899999999999997,67.8
2609,2841,17779,13,7,20,65.0,0.023435,38.0
2610,1171,-881,7,7,14,50.0,-0.006407142857142855,95.92857142857143
2611,1572,5518,13,7,20,65.0,0.023195,59.15
2612,3275,-6415,7,9,16,43.75,-0.018424999999999997,48.5
2613,1870,-2790,10,10,20,50.0,-0.009269999999999997,58.1
2614,1134,7146,10,5,15,66.67,0.024493333333333336,31.533333333333335
2615,3821,-4721,10,9,19,52.63,-0.0006578947368421036,33.78947368421053
2616,1228,2542,6,4,10,60.0,0.008749999999999999,174.5
2617,2264,8906,10,4,14,71.43,0.03705714285714286,60.642857142857146
2618,1494,-10184,5,11,16,31.25,-0.04388125,47.375
2630,338,1902,2,1,3,66.67,0.02763333333333333,59.0
2633,521,1369,2,1,3,66.67,0.027433333333333334,140.66666666666666
2634,983,-2773,2,3,5,40.0,-0.025839999999999995,120.8
2636,4510,14120,8,4,12,66.67,0.027491666666666668,41.75
2637,2694,6046,7,5,12,58.33,0.016050000000000002,109.33333333333333
2642,3008,15272,8,4,12,66.67,0.02751666666666666,38.25
2701,1004,-5844,4,9,13,30.77,-0.04510769230769231,153.76923076923077
2702,2299,2211,12,9,21,57.14,0.00827619047619048,67.71428571428571
2704,3208,-15568,7,12,19,36.84,-0.032210526315789474,106.42105263157895
2705,1459,-6229,8,10,18,44.44,-0.017927777777777775,36.22222222222222
2706,1652,-782,7,7,14,50.0,-0.005871428571428571,133.78571428571428
2707,26696,45754,10,8,18,55.56,0.005277777777777777,96.55555555555556
2712,458,-1078,1,2,3,33.33,-0.03933333333333333,92.33333333333333
2722,1530,4920,5,3,8,62.5,0.0191875,108.5
2723,14101,57319,8,5,13,61.54,0.01726153846153846,25.0
2727,6375,74215,7,2,9,77.78,0.04978888888888889,61.666666666666664
2731,4491,6569,5,4,9,55.56,0.005277777777777778,85.77777777777777
2739,969,11,3,3,6,50.0,-0.005883333333333338,44.333333333333336
2748,1452,3388,3,2,5,60.0,0.014120000000000004,70.8
2801,1509,-9549,5,10,15,33.33,-0.03935333333333334,80.93333333333334
2809,1245,5065,8,4,12,66.67,0.02665833333333333,42.833333333333336
2812,1028,-2278,6,9,15,40.0,-0.02754000000000001,93.73333333333333
2816,2005,-2495,11,11,22,50.0,-0.006499999999999998,36.09090909090909
2820,1106,-6056,5,10,15,33.33,-0.04050666666666668,120.13333333333334
2832,1334,-3784,5,7,12,41.67,-0.022624999999999996,166.66666666666666
2834,814,-2734,5,7,12,41.67,-0.024091666666666667,142.5
2836,1197,-1747,6,8,14,42.86,-0.015014285714285711,158.21428571428572
2838,523,-1013,4,4,8,50.0,-0.008212499999999998,146.0
2845,929,891,7,5,12,58.33,0.009725,79.33333333333333
2849,923,-23,7,6,13,53.85,0.00027692307692307847,40.69230769230769
2850,1845,-6265,6,8,14,42.86,-0.02060714285714286,80.07142857142857
2851,1195,5365,9,5,14,64.29,0.02195714285714286,81.85714285714286
2852,1640,3360,11,8,19,57.89,0.009610526315789472,89.84210526315789
2855,1295,5885,9,5,14,64.29,0.022549999999999997,94.07142857142857
2867,972,-1452,6,6,12,50.0,-0.0007916666666666702,86.33333333333333
2880,1552,-4762,5,8,13,38.46,-0.028999999999999995,156.07692307692307
2881,3307,-16947,5,10,15,33.33,-0.039266666666666665,54.2
2882,4250,-20240,6,10,16,37.5,-0.030906249999999996,85.3125
2883,1586,2364,12,10,22,54.55,0.002104545454545456,51.13636363636363
2884,1264,-7594,4,9,13,30.77,-0.04479230769230769,87.07692307692308
2885,1108,-10248,3,9,12,25.0,-0.05626666666666665,52.0
2886,1020,5330,5,2,7,71.43,0.03705714285714286,98.85714285714286
2887,1128,4162,8,5,13,61.54,0.01650769230769231,90.61538461538461
2888,1218,-6458,4,10,14,28.57,-0.05016428571428571,67.85714285714286
2889,479,-859,3,4,7,42.86,-0.02172857142857143,108.42857142857143
2890,988,2392,8,5,13,61.54,0.016330769230769225,80.84615384615384
2891,1414,11346,8,3,11,72.73,0.039609090909090906,77.54545454545455
2892,978,-3728,3,5,8,37.5,-0.030975,115.75
2897,194,616,2,1,3,66.67,0.025333333333333333,263.6666666666667
2901,2366,-2766,8,9,17,47.06,-0.011823529411764705,153.52941176470588
2903,2294,26876,13,3,16,81.25,0.0566875,81.9375
2904,1142,1038,5,5,10,50.0,-0.007569999999999999,117.4
2905,1708,-3958,8,9,17,47.06,-0.017452941176470588,60.35294117647059
2906,814,-1174,5,6,11,45.45,-0.01596363636363636,151.54545454545453
2908,1711,-7661,6,9,15,40.0,-0.030666666666666665,128.2
2910,1563,-3163,5,6,11,45.45,-0.014963636363636366,31.818181818181817
2911,1921,-11311,7,11,18,38.89,-0.028794444444444442,68.44444444444444
2912,11301,-50001,4,7,11,36.36,-0.02866363636363636,163.0
2913,1452,-1502,9,8,17,52.94,-0.001135294117647058,33.588235294117645
2915,3661,-13151,7,7,14,50.0,-0.006042857142857143,39.714285714285715
2923,744,156,3,3,6,50.0,-0.005816666666666664,58.166666666666664
2929,5263,337,9,6,15,60.0,0.00852,33.733333333333334
2939,453,-5223,0,3,3,0.0,-0.07276666666666666,16.333333333333332
3002,2133,-1643,12,12,24,50.0,-0.006320833333333331,54.333333333333336
3003,2892,14678,9,5,14,64.29,0.022742857142857138,24.571428571428573
3004,2965,-7665,5,8,13,38.46,-0.031276923076923084,26.153846153846153
3005,2342,-8022,9,7,16,56.25,0.006625000000000001,28.9375
3006,6403,32037,12,8,20,60.0,0.014179999999999998,15.65
3008,158169,-172619,8,7,15,53.33,0.0008266666666666672,17.866666666666667
3010,3741,-13551,6,8,14,42.86,-0.02017857142857143,80.64285714285714
3011,1492,-11722,5,18,23,21.74,-0.06562608695652174,25.130434782608695
3013,1838,-15098,5,13,18,27.78,-0.05075555555555556,34.77777777777778
3014,2576,8494,8,4,12,66.67,0.02745833333333333,31.75
3015,2357,1633,8,7,15,53.33,0.000739999999999998,57.4
3016,3594,12926,12,7,19,63.16,0.020305263157894732,20.157894736842106
3017,2089,-18509,4,12,16,25.0,-0.0559625,25.375
3018,2472,11948,17,8,25,68.0,0.027239999999999997,26.72
3019,5927,12743,8,8,16,50.0,-0.005862500000000001,17.3125
3021,1344,-4174,8,13,21,38.1,-0.044385714285714285,32.76190476190476
3022,3754,-8464,7,10,17,41.18,-0.023552941176470586,56.76470588235294
3023,2273,-16823,5,8,13,38.46,-0.029169230769230767,37.53846153846154
3024,1797,4593,12,11,23,52.17,-0.003847826086956521,50.869565217391305
3025,1260,-2100,8,7,15,53.33,-0.00040666666666667,18.0
3026,7268,-37258,7,14,21,33.33,-0.03923809523809524,50.23809523809524
3027,1562,5378,11,6,17,64.71,0.022741176470588237,42.294117647058826
3028,1210,3120,7,5,12,58.33,0.010199999999999999,85.08333333333333
3029,1477,-577,6,8,14,42.86,-0.02129285714285714,33.285714285714285
3030,3859,16231,11,5,16,68.75,0.03168125,55.625
3031,2355,15125,14,5,19,73.68,0.041242105263157885,21.63157894736842
3032,2611,8409,13,9,22,59.09,0.011681818181818182,30.954545454545453
3033,1725,5995,10,7,17,58.82,0.01131764705882353,128.7058823529412
3034,19105,-18115,9,12,21,42.86,-0.020142857142857136,23.714285714285715
3035,6420,8570,9,9,18,50.0,-0.00585,37.111111111111114
3036,2389,26431,10,2,12,83.33,0.06087499999999999,65.33333333333333
3037,2253,-16943,5,7,12,41.67,-0.022699999999999994,35.083333333333336
3038,2531,-6951,12,15,27,44.44,-0.018607407407407406,26.296296296296298
3040,2938,14892,15,8,23,65.22,0.02185217391304348,46.130434782608695
3041,3337,-1007,11,8,19,57.89,0.009831578947368419,30.526315789473685
3042,4798,3332,9,10,19,47.37,-0.011168421052631576,44.78947368421053
3043,3338,-558,15,12,27,55.56,0.0005222222222222212,12.074074074074074
3044,6270,77200,12,2,14,85.71,0.0656857142857143,16.0
3045,5390,-59340,2,8,10,20.0,-0.07022999999999999,240.9
3046,2515,5425,21,12,33,63.64,0.019406060606060607,21.242424242424242
3047,1700,800,11,8,19,57.89,0.00877368421052631,35.73684210526316
3048,2049,20581,13,4,17,76.47,0.046670588235294116,47.1764705882353
3049,928,1582,9,5,14,64.29,0.020214285714285716,20.357142857142858
3050,1499,-99,12,8,20,60.0,0.011365,28.8
3051,3180,31450,21,9,30,70.0,0.027886666666666667,14.833333333333334
3052,1226,7194,13,6,19,68.42,0.027478947368421054,54.421052631578945
3054,1789,1581,10,7,17,58.82,0.011164705882352943,34.35294117647059
3055,1974,-12184,5,12,17,29.41,-0.04737647058823529,55.64705882352941
3056,1841,4079,9,9,18,50.0,-0.008149999999999998,38.0
3057,1878,-1188,10,10,20,50.0,-0.006604999999999998,19.95
3058,1728,11262,16,6,22,72.73,0.03826363636363637,36.04545454545455
3059,4453,-3983,11,14,25,44.0,-0.017920000000000002,24.96
3060,6359,12071,14,7,21,66.67,0.027538095238095233,30.857142857142858
3062,2538,-3268,9,9,18,50.0,-0.005905555555555556,25.944444444444443
3090,2980,-5690,8,7,15,53.33,0.0008066666666666676,28.533333333333335
3094,2204,2286,7,8,15,46.67,-0.012593333333333335,27.8
3130,6656,7694,4,4,8,50.0,-0.005850000000000001,88.375
3138,4416,-4106,12,5,17,70.59,0.02987058823529412,45.294117647058826
3149,2412,5398,12,5,17,70.59,0.03500588235294117,22.352941176470587
3164,2920,-5000,7,9,16,43.75,-0.018437500000000002,38.9375
3167,1732,-8242,3,6,9,33.33,-0.04288888888888889,44.666666666666664
3189,7850,-32600,5,11,16,31.25,-0.043393749999999995,20.25
3209,2108,1732,8,9,17,47.06,-0.01182941176470588,52.588235294117645
3229,2272,11128,16,10,26,61.54,0.01633076923076923,26.73076923076923
3231,2159,2061,8,5,13,61.54,0.01721538461538461,42.46153846153846
3257,3451,11569,6,4,10,60.0,0.014159999999999997,26.2
3266,2391,4319,12,10,22,54.55,0.0028363636363636364,46.90909090909091
3296,3205,26335,14,8,22,63.64,0.021400000000000006,26.681818181818183
3305,5690,-12030,11,9,20,55.0,0.004170000000000001,42.9
3308,1101,-2331,7,8,15,46.67,-0.014526666666666665,23.133333333333333
3311,5469,6231,9,9,18,50.0,-0.005877777777777778,31.38888888888889
3312,993,2897,8,5,13,61.54,0.01621538461538461,34.61538461538461
3321,732,6988,7,2,9,77.78,0.04897777777777777,20.444444444444443
3338,2414,426,7,5,12,58.33,0.010833333333333334,19.0
3346,2331,-20601,3,5,8,37.5,-0.030937499999999996,26.0
3356,9148,-40948,8,9,17,47.06,-0.011758823529411766,32.529411764705884
3376,11863,65937,11,6,17,64.71,0.023605882352941174,32.411764705882355
3380,1772,-11522,5,8,13,38.46,-0.029,21.615384615384617
3406,23602,80288,14,5,19,73.68,0.04158947368421053,15.631578947368421
3413,4769,-57309,1,4,5,20.0,-0.06594,31.4
3416,4219,7361,7,6,13,53.85,0.0018538461538461577,58.61538461538461
3419,1911,-1441,9,7,16,56.25,0.006375000000000002,20.625
3432,1087,2333,6,6,12,50.0,-0.006391666666666666,23.583333333333332
3437,1588,12112,6,2,8,75.0,0.044137499999999996,10.5
3443,9498,-6748,6,5,11,54.55,0.003254545454545453,40.18181818181818
3450,5697,1903,9,9,18,50.0,-0.005894444444444446,21.22222222222222
3454,7151,-26541,6,11,17,35.29,-0.03531764705882353,30.470588235294116
3481,2418,10772,7,9,16,43.75,-0.0187,16.875
3494,1765,6505,11,8,19,57.89,0.008505263157894734,32.94736842105263
3501,3454,18636,9,5,14,64.29,0.022757142857142858,72.21428571428571
3504,8707,34483,12,12,24,50.0,-0.005850000000000004,16.541666666666668
3515,7805,35285,8,7,15,53.33,0.0008066666666666657,71.73333333333333
3518,4731,14009,11,10,21,52.38,-0.0011190476190476187,28.952380952380953
3528,1755,-12835,3,6,9,33.33,-0.03922222222222222,130.77777777777777
3530,3905,27745,9,5,14,64.29,0.021992857142857144,30.0
3532,5410,17930,9,7,16,56.25,0.006643749999999999,36.1875
3533,10831,-97791,6,9,15,40.0,-0.0259,32.46666666666667
3535,2216,-4396,11,9,20,55.0,0.0036349999999999993,15.3
3543,4067,38613,14,8,22,63.64,0.0212,30.363636363636363
3545,3525,-30455,4,9,13,30.77,-0.04435384615384615,14.461538461538462
3550,970,2800,6,5,11,54.55,0.00280909090909091,41.36363636363637
3557,1644,-2364,11,4,15,73.33,0.038566666666666666,18.8
3563,4403,72707,7,0,7,100.0,0.09429999999999998,30.571428571428573
3576,1999,-5559,6,7,13,46.15,-0.014469230769230769,44.15384615384615
3583,2105,23005,5,1,6,83.33,0.06091666666666667,77.33333333333333
3588,4618,-2778,7,5,12,58.33,0.010849999999999999,24.583333333333332
3591,1869,12911,8,4,12,66.67,0.02736666666666666,21.083333333333332
3593,1491,3009,11,8,19,57.89,0.008221052631578945,20.789473684210527
3596,4018,-1368,7,7,14,50.0,-0.005849999999999999,31.214285714285715
3605,1626,-3366,5,4,9,55.56,-0.0013222222222222246,35.666666666666664
3607,2414,7786,9,4,13,69.23,0.032600000000000004,52.23076923076923
3617,2398,9312,4,2,6,66.67,0.02753333333333333,95.16666666666667
3622,5863,-46853,10,6,16,62.5,0.01915,14.8125
3645,1588,8822,5,3,8,62.5,0.019125,16.875
3653,4963,2917,6,3,9,66.67,0.027544444444444444,38.111111111111114
3661,1064,3696,2,2,4,50.0,-0.005850000000000001,6.25
3665,6644,-43394,3,6,9,33.33,-0.039233333333333335,13.333333333333334
3669,2683,-3203,7,8,15,46.67,-0.014373333333333333,28.6
3673,14117,120823,8,4,12,66.67,0.027541666666666662,23.666666666666668
3679,2924,-10044,4,5,9,44.44,-0.01698888888888889,29.77777777777778
3682,1089,2581,10,6,16,62.5,0.017281249999999998,63.5625
3686,1564,-3774,9,8,17,52.94,-0.0012117647058823525,16.0
3694,1487,-9097,4,9,13,30.77,-0.04443846153846154,32.76923076923077
3701,1321,-551,12,7,19,63.16,0.015599999999999998,44.473684210526315
3702,2352,2848,7,4,11,63.64,0.02141818181818182,45.18181818181818
3703,629,-1049,4,4,8,50.0,-0.006725000000000002,124.125
3704,1566,2674,9,7,16,56.25,0.006443750000000002,38.0625
3705,1299,4961,3,2,5,60.0,0.01416,421.6
3706,937,-5617,2,4,6,33.33,-0.03933333333333333,67.66666666666667
3708,2811,-6921,3,3,6,50.0,-0.02125,36.0
3711,1250,-22080,0,3,3,0.0,-0.106,30.666666666666668
3712,89,1481,1,0,1,100.0,0.094,10.0
3714,835,13815,2,0,2,100.0,0.0943,11.0
4104,4669,-23069,7,10,17,41.18,-0.023541176470588236,123.88235294117646
4106,2829,-7499,8,9,17,47.06,-0.011770588235294114,32.588235294117645
4108,4008,-10118,11,12,23,47.83,-0.010195652173913041,32.0
4119,4232,-35722,4,9,13,30.77,-0.04783846153846153,62.76923076923077
4133,3596,-9106,6,8,14,42.86,-0.02475714285714285,78.85714285714286
4137,10650,80200,7,3,10,70.0,0.034210000000000004,30.2
4142,1646,-11996,2,6,8,25.0,-0.055975,18.25
4155,2213,11477,8,3,11,72.73,0.039636363636363636,33.45454545454545
4164,2679,27841,6,2,8,75.0,0.0441875,33.625
4190,4472,5028,5,4,9,55.56,0.005277777777777776,51.333333333333336
4306,1820,13130,13,6,19,68.42,0.028200000000000003,63.0
4414,1718,3332,13,10,23,56.52,0.004273913043478261,47.04347826086956
4426,7349,35411,18,10,28,64.29,0.022471428571428566,21.785714285714285
4438,6311,45239,6,3,9,66.67,0.034888888888888886,67.55555555555556
4439,1438,1412,1,1,2,50.0,-0.005850000000000001,149.5
4526,3242,15318,12,7,19,63.16,0.020484210526315785,56.0
4532,1988,8932,11,5,16,68.75,0.03124375,52.75
4536,5181,-14221,3,4,7,42.86,-0.020157142857142856,90.71428571428571
4540,2262,3288,6,4,10,60.0,0.00803,60.3
4545,1908,-11678,3,7,10,30.0,-0.045939999999999995,54.3
4551,5623,-39433,2,5,7,28.57,-0.04877142857142857,15.571428571428571
4552,3452,10638,6,3,9,66.67,0.02751111111111111,53.333333333333336
4555,1315,115,2,2,4,50.0,-0.005875000000000002,92.5
4557,1353,-10653,1,2,3,33.33,-0.039233333333333335,50.0
4560,1308,2252,3,2,5,60.0,0.00988,143.4
4562,1271,9029,6,2,8,75.0,0.0441875,128.0
4564,1501,19949,6,1,7,85.71,0.06567142857142856,45.142857142857146
4566,2137,1663,4,4,8,50.0,-0.005875000000000002,52.75
4571,1420,5010,2,1,3,66.67,0.02753333333333333,26.0
4572,2377,2583,2,2,4,50.0,-0.005850000000000001,19.5
4576,2270,-19830,1,3,4,25.0,-0.055925,24.0
4581,417,-567,1,1,2,50.0,-0.005950000000000004,119.5
4720,1224,13736,12,2,14,85.71,0.06535714285714286,83.92857142857143
4722,1886,1244,9,8,17,52.94,-0.0005117647058823553,64.70588235294117
4737,3987,10383,6,4,10,60.0,0.014180000000000003,45.2
4739,2297,2083,3,3,6,50.0,-0.005850000000000004,55.833333333333336
4746,4094,-4364,5,8,13,38.46,-0.028992307692307692,32.30769230769231
4755,1165,1955,3,3,6,50.0,-0.005850000000000004,43.166666666666664
4763,2978,3172,2,2,4,50.0,-0.005850000000000001,88.75
4764,2141,19429,5,1,6,83.33,0.05001666666666666,88.33333333333333
4766,1616,26684,2,0,2,100.0,0.0943,125.0
4807,1689,2171,5,3,8,62.5,0.013524999999999999,66.75
4904,2965,3205,4,4,8,50.0,-0.0058625,308.375
4906,2842,-15582,5,8,13,38.46,-0.02902307692307693,16.23076923076923
4912,3639,4691,4,3,7,57.14,0.008442857142857146,38.0
4915,1590,-13760,2,4,6,33.33,-0.03928333333333333,37.333333333333336
4916,1634,-3824,4,6,10,40.0,-0.02593,27.1
4919,2011,9289,6,4,10,60.0,0.014169999999999999,19.8
4927,1396,11554,3,1,4,75.0,0.044225,30.25
4930,1573,-7863,7,9,16,43.75,-0.0186875,40.0625
4934,448,252,4,2,6,66.67,0.025783333333333335,41.166666666666664
4935,2960,32810,8,2,10,80.0,0.054220000000000004,28.3
4938,2869,-13759,4,5,9,44.44,-0.016966666666666668,69.44444444444444
4942,1856,-626,5,5,10,50.0,-0.0059,81.5
4943,1323,21867,6,0,6,100.0,0.09425,24.833333333333332
4952,1923,18557,7,2,9,77.78,0.04978888888888889,34.22222222222222
4956,1015,7815,7,2,9,77.78,0.0496,32.55555555555556
4958,5563,-75833,1,10,11,9.09,-0.08779090909090909,42.36363636363637
4960,966,-2926,6,5,11,54.55,0.0024545454545454592,23.363636363636363
4961,4154,12926,8,5,13,61.54,0.017284615384615384,30.615384615384617
4967,1701,3199,7,6,13,53.85,0.0012076923076923091,20.76923076923077
4968,3826,29034,4,2,6,66.67,0.027533333333333337,14.666666666666666
4976,2121,26319,8,1,9,88.89,0.07207777777777777,24.0
4977,4233,-29363,3,6,9,33.33,-0.039233333333333335,17.77777777777778
4989,941,4459,8,3,11,72.73,0.03675454545454546,45.27272727272727
4994,9661,89449,12,6,18,66.67,0.02752777777777778,26.0
4999,1855,14005,5,2,7,71.43,0.037085714285714284,124.0
5007,3161,4139,7,6,13,53.85,0.001815384615384615,116.46153846153847
5203,8761,-34931,6,10,16,37.5,-0.030887500000000002,50.625
5215,3171,4279,6,6,12,50.0,-0.005883333333333334,45.083333333333336
5225,3387,5033,7,7,14,50.0,-0.005885714285714287,26.214285714285715
5234,5366,-15636,6,8,14,42.86,-0.020192857142857144,27.571428571428573
5243,1621,-5961,3,4,7,42.86,-0.02017142857142857,33.57142857142857
5258,1104,5666,5,3,8,62.5,0.019125000000000003,21.75
5269,23360,62050,4,3,7,57.14,0.00845714285714286,12.0
5283,1532,-4942,1,3,4,25.0,-0.05595,70.25
5284,2181,15419,5,2,7,71.43,0.03705714285714286,79.28571428571429
5285,2194,17796,6,1,7,85.71,0.06564285714285714,57.857142857142854
5288,2774,-13234,2,3,5,40.0,-0.025880000000000004,38.8
5388,3033,347,8,5,13,61.54,0.017169230769230773,37.46153846153846
5434,5181,-11241,7,9,16,43.75,-0.018375000000000002,38.0
5469,1863,-2283,7,8,15,46.67,-0.012933333333333333,26.466666666666665
5471,4709,-38419,5,10,15,33.33,-0.039246666666666666,28.2
5484,2179,13271,15,8,23,65.22,0.022821739130434778,34.04347826086956
5515,1638,-10488,7,13,20,35.0,-0.0365,84.5
5519,2231,9849,11,7,18,61.11,0.01612777777777778,73.38888888888889
5521,1871,-731,12,14,26,46.15,-0.014896153846153845,39.88461538461539
5522,3942,-6772,7,9,16,43.75,-0.018406250000000002,41.5625
5525,1320,2830,6,5,11,54.55,0.003145454545454546,122.9090909090909
5531,3374,7456,13,10,23,56.52,0.006747826086956522,56.17391304347826
5533,1141,-6221,4,8,12,33.33,-0.039483333333333336,186.58333333333334
5534,6799,1471,10,10,20,50.0,-0.005849999999999999,55.9
5538,1431,4359,4,3,7,57.14,0.00844285714285714,57.714285714285715
5546,2183,-5083,3,4,7,42.86,-0.020157142857142856,45.42857142857143
5607,2144,3706,9,7,16,56.25,0.006681249999999998,38.8125
5608,2467,34113,17,1,18,94.44,0.08245000000000001,65.5
5706,2644,-10304,3,7,10,30.0,-0.04591,141.4
5871,2853,27477,2,1,3,66.67,0.06256666666666666,30.0
5876,1046,4174,3,2,5,60.0,0.014139999999999996,109.8
5880,381,-3631,1,3,4,25.0,-0.056,131.5
5906,981,-6231,5,6,11,45.45,-0.018463636363636363,26.818181818181817
5907,3054,15226,8,6,14,57.14,0.008414285714285713,40.142857142857146
6005,1457,2033,10,9,19,52.63,-0.0014999999999999985,59.68421052631579
6024,1576,7264,5,3,8,62.5,0.0191375,149.25
6108,2572,-1902,11,10,21,52.38,-0.0012761904761904763,43.142857142857146
6112,2952,-1222,11,10,21,52.38,-0.0014333333333333327,83.28571428571429
6115,3158,9992,9,6,15,60.0,0.014160000000000004,92.4
6116,1362,4868,15,7,22,68.18,0.02479545454545454,19.5
6117,2274,5946,13,10,23,56.52,0.006943478260869566,40.52173913043478
6120,2855,21375,16,7,23,69.57,0.03274782608695652,24.52173913043478
6128,2926,-286,9,8,17,52.94,-2.9411764705883194e-05,56.88235294117647
6133,1605,3355,11,8,19,57.89,0.005384210526315792,48.578947368421055
6136,3227,17473,12,9,21,57.14,0.008376190476190473,74.28571428571429
6139,4890,-10520,11,12,23,47.83,-0.010199999999999997,39.30434782608695
6141,2804,6406,14,12,26,53.85,0.0006499999999999983,40.03846153846154
6142,1736,-1516,11,10,21,52.38,-0.003280952380952381,21.571428571428573
6152,2499,6721,13,8,21,61.9,0.017057142857142858,44.857142857142854
6153,3252,-16892,8,11,19,42.11,-0.021873684210526313,32.68421052631579
6155,2519,-29,8,10,18,44.44,-0.01703888888888889,63.27777777777778
6164,2212,5718,16,10,26,61.54,0.016396153846153845,27.884615384615383
6165,1248,5822,10,6,16,62.5,0.0170625,29.75
6166,4156,1654,10,9,19,52.63,-0.000584210526315788,35.578947368421055
6168,2149,14711,13,6,19,68.42,0.030747368421052627,11.473684210526315
6176,4386,22564,8,4,12,66.67,0.02754166666666667,16.25
6177,2117,-967,7,9,16,43.75,-0.018625,50.4375
6183,1853,-5413,9,6,15,60.0,0.013793333333333336,105.86666666666666
6184,2798,-10118,5,8,13,38.46,-0.029,119.38461538461539
6189,2017,-5397,6,6,12,50.0,-0.005891666666666667,55.75
6191,3004,-3914,9,12,21,42.86,-0.02085714285714286,27.80952380952381
6192,4259,-5589,6,8,14,42.86,-0.020149999999999998,60.07142857142857
6196,2714,14036,8,7,15,53.33,0.0006199999999999984,27.933333333333334
6197,3722,14728,9,7,16,56.25,0.0066500000000000005,30.6875
6201,2608,10642,9,6,15,60.0,0.014160000000000002,92.66666666666667
6202,4060,-7280,7,8,15,46.67,-0.012533333333333334,38.0
6205,3298,-10218,9,10,19,47.37,-0.011131578947368425,39.578947368421055
6206,7550,9820,10,8,18,55.56,0.005277777777777775,73.16666666666667
6209,3803,7607,11,10,21,52.38,-0.001176190476190477,21.904761904761905
6213,3336,-17556,8,9,17,47.06,-0.011758823529411763,20.11764705882353
6214,3331,13009,8,5,13,61.54,0.01723846153846154,38.38461538461539
6215,2135,12795,10,6,16,62.5,0.018924999999999997,25.8125
6216,3789,26391,12,6,18,66.67,0.027438888888888895,91.0
6224,6260,-1470,12,9,21,57.14,0.008466666666666667,60.476190476190474
6225,2228,13402,18,10,28,64.29,0.018550000000000004,17.392857142857142
6226,1522,5758,14,8,22,63.64,0.01977727272727273,29.59090909090909
6230,8022,7998,7,8,15,46.67,-0.012533333333333334,29.333333333333332
6235,1399,-3049,5,6,11,45.45,-0.01660909090909091,13.272727272727273
6239,3720,-47020,1,8,9,11.11,-0.08374444444444445,42.333333333333336
6243,3228,23532,14,6,20,70.0,0.033985,19.0
6257,2123,-3243,7,7,14,50.0,-0.006185714285714287,30.0
6269,6834,-24534,10,8,18,55.56,0.0009333333333333317,24.166666666666668
6271,6914,-5024,6,4,10,60.0,0.01416,13.2
6277,6861,22059,10,6,16,62.5,0.0191875,124.6875
6278,4657,-20057,6,10,16,37.5,-0.030887500000000002,40.5
6281,2850,5840,5,4,9,55.56,0.013033333333333333,242.77777777777777
6282,1411,6149,8,4,12,66.67,0.027425,51.916666666666664
6283,3423,24187,21,7,28,75.0,0.04321785714285714,17.392857142857142
6285,3440,10970,5,5,10,50.0,-0.005879999999999999,29.7
6288,1372,3628,11,5,16,68.75,0.0293625,29.0
6405,1213,5557,5,4,9,55.56,0.005222222222222221,18.0
6409,2756,45544,1,0,1,100.0,0.0943,20.0
6412,1935,-7345,3,3,6,50.0,-0.005849999999999998,66.33333333333333
6414,8678,-84928,1,4,5,20.0,-0.06594,9.8
6415,45749,-579349,3,5,8,37.5,-0.030887500000000002,11.25
6416,5598,30082,6,4,10,60.0,0.014179999999999998,25.2
6431,917,8833,6,2,8,75.0,0.044012499999999996,35.625
6438,1613,-17343,1,3,4,25.0,-0.05595,26.5
6442,1427,-977,3,3,6,50.0,-0.005849999999999998,34.0
6443,959,-3919,4,3,7,57.14,0.007742857142857144,24.428571428571427
6449,1507,8393,4,2,6,66.67,0.027499999999999997,34.166666666666664
6451,3007,-6337,2,3,5,40.0,-0.025880000000000004,25.4
6456,6145,-53215,3,5,8,37.5,-0.030887500000000002,20.5
6464,3188,30652,4,1,5,80.0,0.05424,191.6
6477,422,-4042,1,2,3,33.33,-0.039233333333333335,67.66666666666667
6491,9188,66602,6,2,8,75.0,0.044225,27.375
6504,9262,40658,7,4,11,63.64,0.021463636363636362,52.18181818181818
6505,6175,-4345,6,7,13,46.15,-0.013553846153846156,87.53846153846153
6515,1561,-27611,0,1,1,0.0,-0.106,5.0
6525,1711,-5071,2,3,5,40.0,-0.025880000000000004,60.4
6531,15597,5463,6,5,11,54.55,0.003254545454545453,18.818181818181817
6533,7840,28360,4,1,5,80.0,0.04446,21.2
6541,3324,29176,6,3,9,66.67,0.02753333333333333,23.77777777777778
6552,1029,16961,3,0,3,100.0,0.0943,43.0
6558,839,6941,3,1,4,75.0,0.044149999999999995,16.75
6573,1166,3234,4,3,7,57.14,0.00844285714285714,20.0
6579,2643,-713,3,3,6,50.0,-0.005850000000000001,80.0
6581,1664,10066,2,1,3,66.67,0.02753333333333333,82.66666666666667
6582,4928,8162,4,3,7,57.14,0.008457142857142854,35.714285714285715
6591,1319,1381,2,2,4,50.0,-0.005850000000000001,19.5
6592,584,-10324,0,1,1,0.0,-0.106,39.0
6598,2076,2704,5,4,9,55.56,0.0007888888888888868,13.333333333333334
6605,5769,-8419,6,7,13,46.15,-0.01355384615384615,72.15384615384616
6625,1807,2863,4,4,8,50.0,-0.0059000000000000025,52.25
6641,2137,9793,4,2,6,66.67,0.02753333333333333,57.833333333333336
6655,1288,7502,2,1,3,66.67,0.013366666666666666,124.33333333333333
6666,2464,40696,4,0,4,100.0,0.0943,31.5
6668,1246,-12816,1,3,4,25.0,-0.055925,31.0
6669,9132,150868,2,0,2,100.0,0.0943,4.5
6670,2344,-41444,0,2,2,0.0,-0.106,25.5
6671,656,2764,2,1,3,66.67,0.027499999999999997,110.0
6672,2284,11586,3,1,4,75.0,0.044225,32.5
6674,649,5081,3,1,4,75.0,0.044175,41.75
6698,1187,-14477,1,4,5,20.0,-0.06594,26.8
6706,2343,38707,3,0,3,100.0,0.0943,25.0
6715,593,-10493,0,1,1,0.0,-0.106,24.0
6743,1554,4066,2,1,3,66.67,0.02753333333333333,7.0
6754,241,-4271,0,1,1,0.0,-0.1061,60.0
6756,1366,-24166,0,1,1,0.0,-0.106,11.0
8011,2158,-1478,8,10,18,44.44,-0.018044444444444446,20.444444444444443
8016,7592,-34872,6,8,14,42.86,-0.020178571428571428,35.5
8021,2120,12420,6,5,11,54.55,0.0031272727272727233,41.54545454545455
8028,1405,-3555,6,6,12,50.0,-0.00909166666666667,9.583333333333334
8033,2170,2490,11,12,23,47.83,-0.011099999999999999,19.782608695652176
8039,5494,-1864,11,12,23,47.83,-0.010230434782608697,34.73913043478261
8046,6808,-15518,5,5,10,50.0,-0.005890000000000001,31.7
8070,7065,-9285,7,7,14,50.0,-0.005850000000000001,34.357142857142854
8072,7398,11682,10,10,20,50.0,-0.005850000000000002,78.15
8081,8797,59293,9,5,14,64.29,0.022764285714285713,27.571428571428573
8101,1898,3642,15,9,24,62.5,0.015375,25.458333333333332
8103,2272,6398,7,5,12,58.33,0.010766666666666666,32.333333333333336
8104,3030,-19180,5,10,15,33.33,-0.040913333333333336,16.466666666666665
8105,965,4735,8,4,12,66.67,0.026116666666666667,16.583333333333332
8110,1011,-1281,7,7,14,50.0,-0.007107142857142859,21.071428571428573
8112,1996,2424,9,9,18,50.0,-0.006344444444444444,30.333333333333332
8114,8268,-13988,7,7,14,50.0,-0.00585,55.142857142857146
8131,1661,3839,6,4,10,60.0,0.014130000000000004,36.9
8150,1564,-1974,4,4,8,50.0,-0.005874999999999998,36.375
8163,2488,13122,9,7,16,56.25,0.006643749999999999,16.5625
8201,1771,4529,9,9,18,50.0,-0.006833333333333334,41.666666666666664
8210,4053,-10333,9,9,18,50.0,-0.0059833333333333336,58.05555555555556
8213,2886,16344,9,4,13,69.23,0.03265384615384616,51.23076923076923
8215,1677,7293,8,5,13,61.54,0.017023076923076922,22.76923076923077
8222,880,680,4,4,8,50.0,-0.006087500000000003,39.0
8249,2328,25042,13,3,16,81.25,0.056525,33.1875
8261,2443,4737,8,8,16,50.0,-0.006006250000000001,23.5625
8271,1350,5930,5,3,8,62.5,0.019125,49.125
8341,7084,28266,4,2,6,66.67,0.02753333333333333,109.33333333333333
8367,1179,10101,4,1,5,80.0,0.044120000000000006,27.2
8374,2574,9816,11,6,17,64.71,0.02358235294117647,37.0
8404,1873,-14153,4,8,12,33.33,-0.039275000000000004,88.75
8411,2574,12256,10,3,13,76.92,0.048053846153846155,28.692307692307693
8422,4981,46819,4,1,5,80.0,0.05424,268.0
8429,2041,10389,8,3,11,72.73,0.03949090909090909,32.81818181818182
8442,1673,-8343,2,4,6,33.33,-0.03925,103.66666666666667
8443,842,4428,6,3,9,66.67,0.02702222222222222,108.11111111111111
8454,15208,174092,4,2,6,66.67,0.02753333333333333,46.0
8462,4824,5046,3,3,6,50.0,-0.005850000000000004,51.833333333333336
8463,1635,-12025,3,7,10,30.0,-0.04598000000000001,96.8
8464,11841,94759,5,2,7,71.43,0.03707142857142857,26.857142857142858
8466,3016,25854,6,1,7,85.71,0.06568571428571428,79.28571428571429
8467,1657,7353,5,3,8,62.5,0.019224999999999996,71.75
8473,2771,-19101,3,8,11,27.27,-0.043981818181818184,94.63636363636364
8478,3667,33783,6,1,7,85.71,0.06565714285714286,20.142857142857142
8481,1039,-3569,1,2,3,33.33,-0.039233333333333335,71.0
8482,1198,-6538,1,1,2,50.0,-0.005850000000000001,37.0
8488,986,6764,5,3,8,62.5,0.0191625,79.25
8499,3117,-10157,2,3,5,40.0,-0.01084,49.8
8926,1223,-8673,5,8,13,38.46,-0.02929230769230769,83.3076923076923
8940,2003,2407,10,8,18,55.56,0.005161111111111112,97.27777777777777
8996,4203,-7473,8,8,16,50.0,-0.005837500000000001,29.1875
9802,3295,-10385,4,3,7,57.14,0.008442857142857146,39.0
9902,1708,-4498,11,15,26,42.31,-0.023730769230769236,35.88461538461539
9904,2468,-808,8,7,15,53.33,-0.004859999999999998,80.66666666666667
9905,1709,-3749,5,9,14,35.71,-0.0294,91.14285714285714
9906,1812,-2422,11,5,16,68.75,0.021356249999999997,16.6875
9907,1514,-3424,8,11,19,42.11,-0.022494736842105262,62.05263157894737
9908,1207,-8737,3,8,11,27.27,-0.05161818181818181,215.27272727272728
9910,10666,-37626,9,8,17,52.94,2.352941176470574e-05,51.294117647058826
9911,1088,522,5,6,11,45.45,-0.015790909090909088,61.54545454545455
9912,1767,-2847,12,14,26,46.15,-0.015665384615384616,35.46153846153846
9914,12599,-319,8,6,14,57.14,0.008442857142857139,26.142857142857142
9917,2501,-16591,2,5,7,28.57,-0.04877142857142857,269.14285714285717
9918,1672,-6562,4,6,10,40.0,-0.031900000000000005,144.6
9919,2045,1205,10,10,20,50.0,-0.006214999999999998,68.3
9921,11234,-2434,7,6,13,53.85,0.0018538461538461515,41.07692307692308
9924,2524,-5704,7,7,14,50.0,-0.005914285714285715,74.78571428571429
9925,1246,-5836,3,5,8,37.5,-0.03095,138.125
9926,1248,-14218,1,6,7,14.29,-0.07740000000000001,191.0
9927,2991,-41,8,9,17,47.06,-0.011794117647058825,59.411764705882355
9928,2130,-2070,14,12,26,53.85,-0.0032653846153846127,33.84615384615385
9929,1462,-792,11,13,24,45.83,-0.019679166666666664,41.791666666666664
9930,2512,13698,6,3,9,66.67,0.027533333333333333,98.44444444444444
9931,1273,-9703,2,5,7,28.57,-0.04134285714285714,212.28571428571428
9933,3654,-9354,8,10,18,44.44,-0.017005555555555555,43.77777777777778
9934,2481,6499,13,9,22,59.09,0.01225,49.18181818181818
9935,2176,-8086,10,15,25,40.0,-0.027492000000000003,29.84
9937,2523,-17533,5,8,13,38.46,-0.028984615384615383,158.53846153846155
9938,4167,-2127,9,6,15,60.0,0.008226666666666667,39.13333333333333
9939,3768,-10278,5,7,12,41.67,-0.022574999999999998,33.083333333333336
9940,6431,1389,12,10,22,54.55,0.003236363636363637,42.31818181818182
9941,6062,23068,8,6,14,57.14,0.008421428571428571,63.785714285714285
9942,4084,-15164,5,7,12,41.67,-0.022541666666666668,94.16666666666667
9943,3078,-14438,6,10,16,37.5,-0.030918750000000002,135.8125
9944,2178,-5258,8,10,18,44.44,-0.01707777777777778,50.44444444444444
9945,2494,18706,10,4,14,71.43,0.03619285714285714,44.57142857142857
9946,1264,2446,10,7,17,58.82,0.010623529411764704,37.76470588235294
9955,2996,-3586,8,11,19,42.11,-0.021794736842105266,53.0
9958,3231,13269,9,5,14,64.29,0.022007142857142857,53.142857142857146
1312A,1221,-4611,4,6,10,40.0,-0.030330000000000003,180.7
2002A,1403,-7433,2,4,6,33.33,-0.03921666666666667,591.3333333333334
2836A,130,1470,1,0,1,100.0,0.0646,775.0
2838A,306,894,1,0,1,100.0,0.017,1057.0
2881A,366,2334,1,0,1,100.0,0.0369,1059.0
2881B,693,4487,1,1,2,50.0,0.0356,285.5
2882A,357,5893,1,0,1,100.0,0.0943,1506.0
2882B,683,97,1,1,2,50.0,-0.005850000000000001,341.0
2887E,304,5026,1,0,1,100.0,0.0943,781.0
2887F,299,4941,1,0,1,100.0,0.0943,786.0
2888A,433,4217,2,0,2,100.0,0.04895,337.0
2888B,430,6830,2,0,2,100.0,0.09055,277.0
2891B,718,6192,2,0,2,100.0,0.047599999999999996,438.0
2891C,357,2643,1,0,1,100.0,0.0428,968.0
2897A,0,0,0,0,0,0.0,,
3702A,279,1471,1,0,1,100.0,0.0306,47.0
5871A,0,0,0,0,0,0.0,,
9941A,297,3653,1,0,1,100.0,0.0708,992.0
1240,1178,-1808,2,2,4,50.0,-0.005850000000000001,93.75
1259,5620,-480,5,6,11,45.45,-0.007854545454545454,188.0
1264,10169,11881,4,4,8,50.0,-0.005850000000000001,112.75
1268,4004,11596,3,2,5,60.0,0.014180000000000002,190.2
1336,1073,5687,8,3,11,72.73,0.03918181818181817,43.63636363636363
1565,30374,12666,8,8,16,50.0,-0.010975000000000002,32.3125
1569,2770,-14050,9,11,20,45.0,-0.016120000000000002,19.35
1570,1528,4642,11,7,18,61.11,0.015322222222222225,32.55555555555556
1580,9430,-77650,5,10,15,33.33,-0.039246666666666666,52.86666666666667
1584,954,6956,8,3,11,72.73,0.03908181818181818,40.81818181818182
1586,1413,-343,4,4,8,50.0,-0.005862500000000001,117.375
1591,2001,16249,9,4,13,69.23,0.03257692307692308,32.76923076923077
1593,905,7045,2,1,3,66.67,0.02753333333333333,18.333333333333332
1595,2136,10154,5,3,8,62.5,0.019187500000000003,54.0
1599,2031,1329,5,4,9,55.56,-0.0026555555555555603,64.55555555555556
1742,3415,28705,18,6,24,75.0,0.044104166666666667,32.083333333333336
1752,2667,-9197,5,7,12,41.67,-0.028866666666666665,72.58333333333333
1777,3120,-31540,2,8,10,20.0,-0.06593999999999998,83.6
1781,3978,7822,16,11,27,59.26,0.012262962962962962,25.88888888888889
1784,3916,-42236,4,13,17,23.53,-0.05888823529411765,35.411764705882355
1785,5360,-5480,8,7,15,53.33,0.0008266666666666672,11.666666666666666
1788,3045,-23095,2,4,6,33.33,-0.039233333333333335,156.16666666666666
1796,2286,1384,5,3,8,62.5,0.012249999999999999,33.125
1799,1312,-2562,6,8,14,42.86,-0.020664285714285715,21.714285714285715
1813,1594,10286,7,2,9,77.78,0.039766666666666665,69.55555555555556
1815,1400,-1460,8,8,16,50.0,-0.006337499999999998,28.9375
2035,3037,-19067,5,11,16,31.25,-0.047775000000000005,112.8125
2061,1201,4079,8,6,14,57.14,0.007664285714285715,25.285714285714285
2063,2208,-3608,4,6,10,40.0,-0.0259,75.6
2064,752,4488,5,3,8,62.5,0.0297,83.0
2065,156,-2756,0,1,1,0.0,-0.106,12.0
2066,3246,7244,4,3,7,57.14,0.008457142857142856,71.28571428571429
2067,552,1018,4,3,7,57.14,0.007757142857142859,63.857142857142854
2070,1245,1935,3,2,5,60.0,0.01416,47.4
2221,1453,-8613,4,9,13,30.77,-0.044676923076923065,38.38461538461539
2230,614,-2164,3,4,7,42.86,-0.020628571428571434,80.57142857142857
2235,3665,-19245,4,6,10,40.0,-0.025869999999999997,53.8
2596,1081,4589,6,4,10,60.0,0.014169999999999999,126.5
2640,5220,-19020,5,7,12,41.67,-0.022541666666666668,33.416666666666664
2641,825,2865,8,4,12,66.67,0.025366666666666666,40.5
2643,1076,3714,2,1,3,66.67,0.02753333333333333,65.33333333333333
2718,2328,6942,9,5,14,64.29,0.022714285714285715,59.0
2719,1479,6421,9,7,16,56.25,0.0051750000000000025,33.625
2724,1504,9076,7,5,12,58.33,0.010091666666666665,55.166666666666664
2726,2465,10005,5,3,8,62.5,0.0192125,45.25
2729,7217,29233,3,2,5,60.0,0.014180000000000002,197.2
2732,1548,5702,2,1,3,66.67,0.02753333333333333,59.0
2734,1746,8874,8,7,15,53.33,0.0003466666666666627,15.6
2736,966,-3236,3,6,9,33.33,-0.039400000000000004,48.44444444444444
2740,1942,22608,10,2,12,83.33,0.060733333333333334,42.083333333333336
2743,706,-4336,2,3,5,40.0,-0.02592,23.0
2745,1413,1107,4,3,7,57.14,0.008442857142857139,37.857142857142854
2752,3224,-6674,2,2,4,50.0,-0.005850000000000001,36.5
2754,0,0,0,0,0,0.0,,
2755,332,-5852,0,1,1,0.0,-0.106,153.0
2916,1142,-6352,4,7,11,36.36,-0.03337272727272727,106.18181818181819
2924,2073,4097,4,4,8,50.0,-0.005862500000000003,140.5
2926,7516,76734,8,2,10,80.0,0.05424,103.8
2937,650,30,2,2,4,50.0,-0.005825,106.25
3064,7249,67971,18,8,26,69.23,0.0326,13.615384615384615
3066,1527,2883,12,8,20,60.0,0.011959999999999998,27.55
3067,2674,-18974,6,16,22,27.27,-0.05152272727272728,43.31818181818182
3071,1416,2464,11,8,19,57.89,0.007921052631578948,24.42105263157895
3073,2065,5005,11,12,23,47.83,-0.012569565217391302,17.73913043478261
3078,1720,7910,9,6,15,60.0,0.013899999999999997,21.266666666666666
3081,10577,46823,5,2,7,71.43,0.03707142857142857,7.285714285714286
3083,5920,16660,9,8,17,52.94,3.529411764705575e-05,25.058823529411764
3085,2900,-8200,16,12,28,57.14,0.009767857142857142,17.107142857142858
3086,4875,-8535,16,11,27,59.26,0.012170370370370375,14.37037037037037
3088,3742,-10502,8,8,16,50.0,-0.005862499999999998,59.75
3089,2162,12518,19,7,26,73.08,0.038773076923076924,23.96153846153846
3092,2434,11456,9,6,15,60.0,0.013913333333333331,29.266666666666666
3093,4096,3254,8,7,15,53.33,0.0008266666666666645,73.13333333333334
3095,2136,-5606,10,7,17,58.82,0.006729411764705883,10.823529411764707
3105,4479,21071,4,2,6,66.67,0.027500000000000007,8.333333333333334
3114,1981,99,9,10,19,47.37,-0.011521052631578946,39.63157894736842
3115,2037,4763,14,11,25,56.0,0.005364,44.48
3118,1771,16759,7,2,9,77.78,0.04977777777777778,85.22222222222223
3122,1238,-2468,5,7,12,41.67,-0.022658333333333332,9.083333333333334
3128,1838,7422,10,7,17,58.82,0.011311764705882358,29.352941176470587
3131,8245,-60045,3,6,9,33.33,-0.039233333333333335,34.666666666666664
3141,2148,-7948,5,3,8,62.5,0.019187499999999996,32.75
3147,1101,7819,5,3,8,62.5,0.0191375,98.125
3152,19302,57258,11,9,20,55.0,0.004165000000000001,14.05
3162,1991,9909,14,9,23,60.87,0.014504347826086957,36.17391304347826
3163,2508,23452,7,2,9,77.78,0.0498,14.444444444444445
3169,2958,-16068,6,5,11,54.55,0.003245454545454545,29.818181818181817
3171,1818,-7978,9,12,21,42.86,-0.021009523809523804,44.57142857142857
3176,5168,19952,9,4,13,69.23,0.032676923076923076,24.46153846153846
3178,2682,-14152,9,13,22,40.91,-0.025309090909090906,29.272727272727273
3188,2013,-1323,12,10,22,54.55,0.0025045454545454555,30.772727272727273
3191,1880,-2900,8,11,19,42.11,-0.0232421052631579,17.31578947368421
3202,2383,-16803,7,16,23,30.43,-0.04553478260869566,23.17391304347826
3205,6239,35571,16,10,26,61.54,0.01593846153846154,24.53846153846154
3206,1719,6091,9,6,15,60.0,0.013946666666666666,37.4
3207,1542,4488,14,7,21,66.67,0.02594285714285714,26.571428571428573
3211,6669,-6539,7,9,16,43.75,-0.01836875,34.375
3213,5498,20822,11,7,18,61.11,0.016405555555555555,41.111111111111114
3217,2621,5469,10,7,17,58.82,0.011611764705882354,23.0
3218,5108,-40758,7,11,18,38.89,-0.028105555555555557,41.166666666666664
3219,4286,23504,15,6,21,71.43,0.036557142857142864,16.428571428571427
3221,2771,8309,12,7,19,63.16,0.02036842105263158,38.0
3224,2294,-9734,9,10,19,47.37,-0.01393157894736842,30.68421052631579
3226,2229,13821,9,3,12,75.0,0.043941666666666664,57.333333333333336
3227,8380,-63830,4,7,11,36.36,-0.03316363636363637,27.272727272727273
3228,10676,37164,14,12,26,53.85,0.0018230769230769225,18.23076923076923
3230,1074,-5014,5,9,14,35.71,-0.03681428571428572,33.357142857142854
3232,2366,5644,11,9,20,55.0,0.0037150000000000004,33.15
3234,1839,-7129,4,5,9,44.44,-0.016999999999999998,23.0
3236,1900,-5930,10,11,21,47.62,-0.014861904761904762,23.761904761904763
3252,1979,-9199,6,11,17,35.29,-0.03567058823529412,60.8235294117647
3259,2036,18994,12,4,16,75.0,0.04416875,32.75
3260,5230,1280,10,6,16,62.5,0.01908125,13.0
3264,1524,6996,7,4,11,63.64,0.02137272727272727,37.18181818181818
3265,1706,-12536,5,10,15,33.33,-0.03998666666666666,15.6
3268,3846,16794,14,11,25,56.0,0.005723999999999998,21.64
3272,2460,-1740,5,4,9,55.56,0.005222222222222222,12.444444444444445
3276,1299,-829,9,7,16,56.25,0.0058187499999999975,33.5625
3284,1524,3696,12,7,19,63.16,0.019252631578947365,40.31578947368421
3285,1469,-12979,4,8,12,33.33,-0.03933333333333333,36.666666666666664
3287,1563,2567,11,7,18,61.11,0.01537777777777778,20.833333333333332
3288,1955,11945,16,5,21,76.19,0.04085714285714285,22.428571428571427
3289,5195,16995,12,7,19,63.16,0.020473684210526318,15.473684210526315
3290,1762,7028,11,8,19,57.89,0.009057894736842103,24.63157894736842
3293,21992,-43292,10,6,16,62.5,0.0191875,39.125
3294,2001,18779,10,5,15,66.67,0.027279999999999995,32.266666666666666
3297,2856,11314,12,7,19,63.16,0.020478947368421055,41.21052631578947
3303,2106,5594,9,8,17,52.94,-8.823529411764632e-05,40.588235294117645
3306,3602,-1372,9,12,21,42.86,-0.02015714285714286,36.38095238095238
3310,2609,1661,11,9,20,55.0,0.0035150000000000008,35.4
3313,3057,23173,15,8,23,65.22,0.02376086956521739,22.73913043478261
3317,3083,21137,10,6,16,62.5,0.01903125,18.0
3322,1453,-10383,6,13,19,31.58,-0.044163157894736835,34.421052631578945
3323,2493,2027,7,6,13,53.85,0.0017923076923076903,26.46153846153846
3324,5689,19201,14,11,25,56.0,0.006079999999999997,15.96
3325,2611,-3461,9,13,22,40.91,-0.02433181818181818,28.59090909090909
3332,2107,-1477,5,5,10,50.0,-0.00586,152.4
3339,2951,2489,17,15,32,53.12,-0.00190625,16.6875
3354,1593,47,6,10,16,37.5,-0.03150625,20.25
3360,1550,-7070,7,11,18,38.89,-0.028722222222222222,45.77777777777778
3362,2138,15412,11,4,15,73.33,0.04073333333333333,34.8
3363,2174,6106,7,6,13,53.85,0.0018615384615384627,37.69230769230769
3372,1280,1510,10,9,19,52.63,-0.00368421052631579,34.94736842105263
3373,3832,32108,15,4,19,78.95,0.05210000000000001,50.68421052631579
3374,2230,32510,6,1,7,85.71,0.06561428571428571,7.714285714285714
3379,1814,-1714,6,9,15,40.0,-0.02608,21.533333333333335
3388,6427,-14847,7,9,16,43.75,-0.02365625,77.0625
3390,941,-1771,5,4,9,55.56,0.00507777777777778,18.11111111111111
3402,2290,3400,10,7,17,58.82,0.011494117647058821,26.823529411764707
3426,1320,9270,3,2,5,60.0,0.0305,196.4
3434,1023,-2193,6,7,13,46.15,-0.014461538461538463,36.69230769230769
3438,11450,-2050,14,11,25,56.0,0.006139999999999999,30.24
3441,2576,11814,12,6,18,66.67,0.027355555555555557,10.88888888888889
3444,2433,-12473,7,9,16,43.75,-0.018362499999999997,46.875
3455,1700,1770,5,3,8,62.5,0.008387499999999994,28.25
3465,3207,-12527,9,7,16,56.25,0.0044375,20.25
3466,3161,2149,12,10,22,54.55,0.0031136363636363627,54.72727272727273
3479,2369,-4609,5,4,9,55.56,0.005266666666666668,62.55555555555556
3483,6632,9498,12,12,24,50.0,-0.005987500000000002,13.958333333333334
3484,3299,16431,12,7,19,63.16,0.016442105263157893,44.78947368421053
3489,1498,-8418,5,12,17,29.41,-0.04798823529411764,31.470588235294116
3490,2414,-2724,7,8,15,46.67,-0.012553333333333333,22.333333333333332
3491,4577,3383,6,5,11,54.55,0.003254545454545453,24.818181818181817
3492,1003,1937,4,4,8,50.0,0.006287499999999998,42.125
3498,4825,21625,12,8,20,60.0,0.014125000000000002,20.5
3499,1703,17037,11,4,15,73.33,0.04020666666666666,22.733333333333334
3508,4861,46429,14,5,19,73.68,0.041547368421052625,16.473684210526315
3511,2253,5187,8,5,13,61.54,0.017199999999999997,20.307692307692307
3512,3525,10045,13,9,22,59.09,0.01209090909090909,26.59090909090909
3516,1204,-1124,8,7,15,53.33,-0.0002999999999999993,32.666666666666664
3520,2200,-1580,11,8,19,57.89,0.007963157894736844,23.263157894736842
3521,1831,3149,10,8,18,55.56,0.004833333333333335,36.111111111111114
3522,2396,14764,14,6,20,70.0,0.033719999999999986,22.75
3523,2675,10435,13,9,22,59.09,0.011472727272727272,23.636363636363637
3526,4251,38689,9,6,15,60.0,0.014139999999999998,28.933333333333334
3527,6897,-9767,6,7,13,46.15,-0.013561538461538462,20.615384615384617
3529,9742,111928,6,4,10,60.0,0.014179999999999998,20.7
3531,1672,3358,7,6,13,53.85,0.001753846153846154,75.38461538461539
3537,1302,-10262,3,7,10,30.0,-0.04605,15.0
3540,2088,3212,8,5,13,61.54,0.017176923076923083,34.76923076923077
3541,6531,59469,13,3,16,81.25,0.0567625,26.875
3546,10082,79808,10,4,14,71.43,0.03707142857142858,38.5
3548,2537,9943,8,6,14,57.14,0.008392857142857141,23.5
3551,2001,13769,6,3,9,66.67,0.02753333333333333,80.66666666666667
3552,7803,21247,7,6,13,53.85,0.0018538461538461515,19.384615384615383
3555,1976,30004,7,2,9,77.78,0.04832222222222222,18.444444444444443
3556,3359,29731,8,3,11,72.73,0.03971818181818182,17.0
3558,9648,36652,7,4,11,63.64,0.021463636363636372,34.09090909090909
3564,2266,11444,6,4,10,60.0,0.014150000000000001,29.5
3567,932,-92,4,4,8,50.0,-0.006325000000000001,55.125
3570,3835,-25765,3,7,10,30.0,-0.04593,76.6
3577,3305,-31175,4,10,14,28.57,-0.048799999999999996,42.642857142857146
3580,1838,14312,9,4,13,69.23,0.032192307692307694,22.076923076923077
3581,849,-2709,3,5,8,37.5,-0.03095,33.875
3587,4410,11520,7,4,11,63.64,0.021463636363636365,27.636363636363637
3594,1389,391,4,4,8,50.0,-0.005875000000000002,19.125
3597,1250,-4520,5,7,12,41.67,-0.022675000000000004,207.75
3609,1619,-5349,7,6,13,53.85,0.0018076923076923114,59.46153846153846
3611,11888,60742,6,5,11,54.55,0.003254545454545452,52.09090909090909
3615,2703,-20003,5,10,15,33.33,-0.03922666666666667,26.466666666666665
3623,1961,-881,7,7,14,50.0,-0.0060071428571428585,22.785714285714285
3624,1180,-3320,3,4,7,42.86,-0.020142857142857146,33.857142857142854
3625,1012,2668,7,4,11,63.64,0.020445454545454548,25.90909090909091
3628,4814,26886,6,6,12,50.0,-0.00586666666666667,36.583333333333336
3629,1992,23588,10,2,12,83.33,0.06068333333333333,23.25
3630,3473,11617,7,6,13,53.85,0.0018615384615384605,14.692307692307692
3631,1864,13006,6,3,9,66.67,0.02748888888888889,21.22222222222222
3632,2936,11734,13,8,21,61.9,0.017628571428571427,19.857142857142858
3646,1433,10617,9,3,12,75.0,0.04405833333333333,39.5
3652,1453,4717,7,5,12,58.33,0.010824999999999996,58.833333333333336
3663,1278,-14488,2,9,11,18.18,-0.06973636363636364,50.18181818181818
3664,1981,2249,10,8,18,55.56,0.004655555555555556,20.944444444444443
3666,1816,1534,6,6,12,50.0,-0.005850000000000002,18.166666666666668
3672,1141,4689,6,3,9,66.67,0.02746666666666667,31.666666666666668
3675,2686,31124,7,3,10,70.0,0.03426,25.2
3680,5337,-7257,5,3,8,62.5,0.019174999999999998,17.0
3684,1204,9596,4,1,5,80.0,0.0413,25.6
3685,2002,11958,8,4,12,66.67,0.027458333333333335,24.166666666666668
3687,7668,43002,7,7,14,50.0,-0.005835714285714282,18.071428571428573
3689,1197,5033,4,1,5,80.0,0.05416,34.4
3691,28292,31168,8,7,15,53.33,0.0008266666666666663,13.333333333333334
3693,5950,45160,9,5,14,64.29,0.02275000000000001,25.857142857142858
3707,427,4383,4,1,5,80.0,0.053259999999999995,12.4
3709,822,488,3,3,6,50.0,-0.005966666666666669,20.166666666666668
3710,651,-2571,4,6,10,40.0,-0.01759,20.2
3713,543,8937,3,0,3,100.0,0.09423333333333334,64.0
4102,1850,-11570,5,12,17,29.41,-0.04743529411764706,62.470588235294116
4105,8176,6524,11,10,21,52.38,0.00279047619047619,45.0
4107,4496,-2326,7,7,14,50.0,-0.006164285714285711,33.642857142857146
4109,2822,-22762,7,18,25,28.0,-0.05003200000000001,43.96
4111,1678,1732,7,7,14,50.0,-0.006028571428571431,66.57142857142857
4113,1681,-161,9,10,19,47.37,-0.012478947368421056,32.73684210526316
4114,2661,-15391,5,10,15,33.33,-0.03348666666666667,55.333333333333336
4116,1175,195,3,3,6,50.0,-0.005833333333333332,41.0
4120,5229,-19219,8,11,19,42.11,-0.02166842105263158,43.89473684210526
4121,1893,1667,9,9,18,50.0,-0.006138888888888888,22.166666666666668
4123,3072,4708,6,5,11,54.55,0.0032181818181818158,64.72727272727273
4126,6250,7780,9,10,19,47.37,-0.011184210526315791,69.47368421052632
4127,1339,-2589,6,8,14,42.86,-0.020571428571428574,31.5
4128,3465,-24745,8,13,21,38.1,-0.02979523809523809,32.476190476190474
4129,3709,-2849,9,9,18,50.0,-0.005994444444444445,31.5
4130,1970,-13220,3,7,10,30.0,-0.04590999999999999,24.0
4131,2780,17600,17,7,24,70.83,0.034062499999999996,18.583333333333332
4138,3694,-23224,3,6,9,33.33,-0.039233333333333335,89.22222222222223
4139,4654,13646,9,6,15,60.0,0.014159999999999997,76.6
4147,6465,37335,6,4,10,60.0,0.014180000000000003,26.7
4153,2825,-30275,2,8,10,20.0,-0.06593,20.9
4154,1779,6781,7,4,11,63.64,0.02143636363636364,27.181818181818183
4157,1429,4381,7,4,11,63.64,0.021418181818181815,34.81818181818182
4160,2061,-14741,4,9,13,30.77,-0.044399999999999995,52.69230769230769
4161,2292,268,4,6,10,40.0,-0.025909999999999996,51.6
4162,9781,-23421,7,6,13,53.85,0.0018538461538461504,22.53846153846154
4163,5133,46187,6,2,8,75.0,0.044225,33.25
4167,880,2810,4,3,7,57.14,0.008385714285714285,31.571428571428573
4168,4105,8695,9,9,18,50.0,-0.005927777777777778,28.055555555555557
4171,5440,11200,8,6,14,57.14,0.008399999999999998,30.357142857142858
4173,1694,-11754,4,8,12,33.33,-0.03926666666666666,41.5
4174,16345,37805,9,5,14,64.29,0.022764285714285713,23.142857142857142
4175,4506,-22316,4,7,11,36.36,-0.03316363636363637,111.72727272727273
4183,482,-782,2,2,4,50.0,-0.005899999999999999,17.75
4188,956,1624,4,3,7,57.14,0.00837142857142857,42.0
4192,2561,-4481,5,7,12,41.67,-0.022566666666666665,36.583333333333336
4198,1683,13187,12,6,18,66.67,0.023316666666666666,21.5
4205,2821,-2751,3,5,8,37.5,-0.0184125,228.0
4207,1346,2874,11,8,19,57.89,0.008542105263157893,65.94736842105263
4303,802,-2582,3,6,9,33.33,-0.047477777777777785,30.0
4304,1271,3169,11,8,19,57.89,0.007347368421052632,23.736842105263158
4305,1528,7342,8,5,13,61.54,0.016915384615384617,101.84615384615384
4401,3434,-2254,9,9,18,50.0,-0.006522222222222219,80.77777777777777
4402,1088,-1018,10,9,19,52.63,-0.007505263157894735,23.894736842105264
4406,992,-3992,5,10,15,33.33,-0.04156666666666666,53.13333333333333
4413,1112,4908,12,7,19,63.16,0.010426315789473685,155.68421052631578
4416,6700,16000,8,7,15,53.33,0.0006599999999999976,69.86666666666666
4417,2317,8313,10,7,17,58.82,0.011570588235294117,97.05882352941177
4419,2197,-7787,10,12,22,45.45,-0.01711818181818182,22.318181818181817
4420,2016,-5026,5,9,14,35.71,-0.027392857142857142,111.0
4430,2210,-9890,5,8,13,38.46,-0.028961538461538462,59.92307692307692
4432,3060,16940,9,3,12,75.0,0.04416666666666667,46.083333333333336
4433,1940,-3520,6,5,11,54.55,0.003190909090909089,56.63636363636363
4502,4225,-1455,13,10,23,56.52,0.0011478260869565236,50.869565217391305
4503,1674,6556,7,10,17,41.18,-0.02624117647058824,18.529411764705884
4506,1463,-14933,4,9,13,30.77,-0.045,97.46153846153847
4510,1627,4953,13,8,21,61.9,0.016380952380952378,44.95238095238095
4513,1437,-2927,7,10,17,41.18,-0.024335294117647056,46.8235294117647
4523,2744,4866,12,8,20,60.0,0.013869999999999999,43.1
4527,2399,161,10,10,20,50.0,-0.005979999999999998,87.15
4528,3304,-2004,9,9,18,50.0,-0.0060055555555555565,43.77777777777778
4529,2213,2617,14,10,24,58.33,0.0093125,30.791666666666668
4530,1818,8182,19,10,29,65.52,0.02170689655172414,18.93103448275862
4533,1251,-4321,7,8,15,46.67,-0.012966666666666663,98.06666666666666
4534,2559,10811,18,12,30,60.0,0.01293,22.3
4535,5863,9347,13,10,23,56.52,0.010934782608695655,99.91304347826087
4538,513,1177,3,2,5,60.0,0.014100000000000001,110.2
4541,963,1847,3,3,6,50.0,-0.005883333333333335,86.83333333333333
4542,1137,-3387,3,5,8,37.5,-0.019649999999999997,50.625
4543,869,-8089,2,6,8,25.0,-0.056049999999999996,73.25
4549,3233,18877,4,2,6,66.67,0.027533333333333337,80.83333333333333
4550,457,-8087,0,4,4,0.0,-0.106075,151.75
4554,1683,2047,5,4,9,55.56,0.005211111111111111,47.0
4556,953,1287,3,2,5,60.0,0.0049,257.6
4561,1407,-2547,4,5,9,44.44,-0.017044444444444445,39.666666666666664
4563,1471,-3841,2,3,5,40.0,-0.025880000000000004,62.6
4568,1476,-9756,1,3,4,25.0,-0.0309,116.5
4580,1091,-411,1,1,2,50.0,-0.005850000000000001,214.5
4609,1298,-4558,7,11,18,38.89,-0.02993333333333333,28.77777777777778
4702,1588,7882,15,8,23,65.22,0.018886956521739127,25.17391304347826
4706,765,3515,5,4,9,55.56,0.004622222222222222,201.22222222222223
4707,2224,-11234,8,13,21,38.1,-0.03045714285714286,55.666666666666664
4711,1646,3454,10,7,17,58.82,0.011658823529411765,93.82352941176471
4712,2619,10491,20,8,28,71.43,0.03547142857142858,17.714285714285715
4714,878,3592,8,4,12,66.67,0.026175000000000004,46.833333333333336
4716,1598,-1098,9,8,17,52.94,-0.00031764705882353117,57.05882352941177
4721,3437,10353,11,5,16,68.75,0.03168125,31.625
4726,1721,3789,5,4,9,55.56,0.0052555555555555515,34.333333333333336
4728,2758,-12838,4,5,9,44.44,-0.017,43.333333333333336
4729,1350,5400,10,5,15,66.67,0.02711333333333333,20.6
4735,3698,-8398,7,7,14,50.0,-0.01177857142857143,31.785714285714285
4736,10218,-76728,4,9,13,30.77,-0.04436923076923078,35.23076923076923
4741,4595,31175,10,5,15,66.67,0.02752666666666666,62.333333333333336
4743,9710,49400,8,5,13,61.54,0.024923076923076923,20.0
4744,3208,-6728,6,8,14,42.86,-0.020221428571428574,20.071428571428573
4745,2861,6579,6,4,10,60.0,0.014169999999999999,62.2
4747,1937,13,4,3,7,57.14,0.00847142857142857,262.57142857142856
4754,1271,-13741,1,4,5,20.0,-0.06594,81.0
4760,1257,17543,3,1,4,75.0,0.044125,62.25
4767,429,-2179,1,2,3,33.33,-0.039233333333333335,59.666666666666664
4804,2471,8729,12,7,19,63.16,0.01618947368421052,24.42105263157895
4806,774,8316,4,2,6,66.67,0.026366666666666663,26.666666666666668
4903,1704,1956,15,9,24,62.5,0.015441666666666666,16.583333333333332
4905,2827,-6817,7,10,17,41.18,-0.024364705882352938,101.88235294117646
4907,1653,1047,10,9,19,52.63,-0.002700000000000005,40.26315789473684
4908,3962,-7142,8,15,23,34.78,-0.03662173913043478,29.217391304347824
4909,3413,2467,10,9,19,52.63,-0.0006578947368421051,19.263157894736842
4911,4109,47431,11,2,13,84.62,0.0635,22.76923076923077
4924,1363,-5993,6,9,15,40.0,-0.027253333333333334,42.06666666666667
4931,1554,13716,7,4,11,63.64,0.018900000000000004,45.36363636363637
4933,3801,-7271,9,5,14,64.29,0.02273571428571428,30.428571428571427
4939,757,1673,6,3,9,66.67,0.026611111111111117,15.555555555555555
4944,784,2116,6,4,10,60.0,0.013149999999999995,10.3
4945,0,0,0,0,0,0.0,,
4946,3406,25014,8,5,13,61.54,0.017123076923076925,25.692307692307693
4950,899,6941,7,2,9,77.78,0.049066666666666675,44.888888888888886
4953,1940,15340,4,1,5,80.0,0.054220000000000004,33.2
4966,31286,-79136,4,7,11,36.36,-0.03316363636363637,10.272727272727273
4971,2163,-14153,2,4,6,33.33,-0.039233333333333335,16.166666666666668
4972,1652,-5992,4,5,9,44.44,-0.024333333333333335,139.11111111111111
4973,1610,1130,7,5,12,58.33,0.010816666666666664,29.25
4974,890,-8850,1,3,4,25.0,-0.055874999999999994,57.25
4979,2984,-17944,6,9,15,40.0,-0.02593333333333334,18.266666666666666
4987,3533,19877,6,3,9,66.67,0.027522222222222226,104.11111111111111
4991,3330,33380,9,2,11,81.82,0.05787272727272728,21.545454545454547
4995,1137,4213,4,2,6,66.67,0.027483333333333332,114.33333333333333
5009,1706,-9406,5,9,14,35.71,-0.03460714285714286,34.642857142857146
5011,102,-21162,1,1,2,50.0,-5.8032,3339.5
5013,1600,-7590,6,8,14,42.86,-0.020335714285714283,68.57142857142857
5014,1481,5259,13,7,20,65.0,0.02039,35.75
5015,1274,1726,6,6,12,50.0,-0.00605,67.91666666666667
5016,1434,2496,5,4,9,55.56,0.005233333333333332,68.33333333333333
5201,2010,-1780,9,8,17,52.94,-0.00019411764705882338,47.0
5202,1834,1306,11,11,22,50.0,-0.007740909090909089,36.0
5205,1860,14080,13,6,19,68.42,0.029273684210526316,22.157894736842106
5206,1597,5293,14,8,22,63.64,0.017800000000000003,39.86363636363637
5209,3507,13823,9,6,15,60.0,0.014060000000000001,105.8
5210,958,-1008,7,6,13,53.85,-1.538461538461796e-05,35.38461538461539
5211,3356,25794,15,5,20,75.0,0.04066499999999999,38.75
5212,3186,-28006,6,17,23,26.09,-0.053852173913043484,38.0
5213,2167,-5257,9,11,20,45.0,-0.01677,49.7
5220,1369,3301,5,3,8,62.5,0.019100000000000002,60.625
5223,1154,-9954,1,3,4,25.0,-0.055925,35.0
5227,2112,2418,6,6,12,50.0,-0.0059999999999999975,28.333333333333332
5230,1916,4514,4,4,8,50.0,-0.005862500000000001,93.875
5245,5112,2788,7,6,13,53.85,0.00013076923076923131,18.384615384615383
5251,2416,28264,10,2,12,83.33,0.060825,43.083333333333336
5263,11366,35684,6,4,10,60.0,0.014179999999999998,33.3
5272,683,-1143,2,2,4,50.0,-0.005975000000000001,19.5
5274,25454,-13154,2,3,5,40.0,-0.025880000000000004,9.0
5276,977,-7457,2,6,8,25.0,-0.056049999999999996,42.375
5278,5694,16736,7,6,13,53.85,0.008669230769230771,24.615384615384617
5281,1062,-1382,4,4,8,50.0,-0.0058625,54.625
5287,12588,69662,6,3,9,66.67,0.027533333333333333,42.666666666666664
5289,3028,-1298,3,2,5,60.0,0.014180000000000002,21.0
5291,727,-7097,2,4,6,33.33,-0.0394,23.166666666666668
5299,3308,-26698,5,5,10,50.0,-0.005979999999999999,17.4
5301,3370,7290,18,8,26,69.23,0.030407692307692306,28.346153846153847
5302,1380,5100,12,7,19,63.16,0.018289473684210533,22.94736842105263
5306,5116,18274,9,8,17,52.94,-0.006400000000000002,35.64705882352941
5309,1924,-4544,11,13,24,45.83,-0.011474999999999999,28.75
5310,2820,1500,11,9,20,55.0,0.0020449999999999973,23.15
5312,6309,-20529,7,12,19,36.84,-0.03221052631578948,82.6842105263158
5314,1650,-720,14,13,27,51.85,-0.006170370370370363,22.14814814814815
5315,1717,6103,15,8,23,65.22,0.01984782608695652,23.17391304347826
5321,3698,-11648,14,13,27,51.85,-0.008177777777777779,19.40740740740741
5324,346,-6526,5,2,7,71.43,-0.36842857142857144,780.1428571428571
5328,1332,-1782,12,9,21,57.14,0.005266666666666664,18.61904761904762
5340,1959,11681,14,7,21,66.67,0.02392380952380952,26.476190476190474
5344,1871,-7471,11,15,26,42.31,-0.027446153846153846,26.076923076923077
5345,1714,3206,17,11,28,60.71,0.012264285714285715,24.107142857142858
5347,3815,4645,8,8,16,50.0,-0.006181250000000003,26.6875
5348,1659,10281,13,8,21,61.9,0.015704761904761905,22.476190476190474
5351,2978,1452,13,12,25,52.0,-0.002496,15.44
5353,1766,-646,12,10,22,54.55,-0.0025636363636363604,32.77272727272727
5355,1692,4958,14,11,25,56.0,0.007547999999999998,18.52
5356,2444,23546,14,5,19,73.68,0.04039473684210527,37.0
5364,2449,-3359,14,8,22,63.64,0.013636363636363636,44.86363636363637
5371,3584,-6664,9,10,19,47.37,-0.011152631578947367,32.63157894736842
5381,1653,-2623,14,17,31,45.16,-0.02475161290322581,21.0
5383,2288,2072,12,11,23,52.17,-0.0022521739130434777,29.347826086956523
5386,738,-43458,9,1,10,90.0,-0.32739,556.2
5392,5130,23180,12,6,18,66.67,0.027494444444444443,31.0
5398,1837,23023,16,1,17,94.12,0.07792941176470589,53.35294117647059
5403,2379,-25289,3,10,13,23.08,-0.05424615384615385,59.23076923076923
5410,1477,-3337,9,8,17,52.94,-0.0020411764705882333,48.05882352941177
5425,1755,15975,10,2,12,83.33,0.06055833333333333,33.5
5426,1062,-3862,5,8,13,38.46,-0.029669230769230767,46.23076923076923
5432,1238,-2018,10,7,17,58.82,0.006411764705882349,16.41176470588235
5438,2684,21926,16,6,22,72.73,0.03955454545454546,43.54545454545455
5439,2154,9366,11,7,18,61.11,0.0159,24.22222222222222
5443,849,6651,5,3,8,62.5,0.018525,26.625
5450,1875,4305,13,9,22,59.09,0.011509090909090908,33.31818181818182
5452,1685,-1615,11,10,21,52.38,-0.002438095238095237,22.666666666666668
5455,1319,9811,15,4,19,78.95,0.045857894736842104,14.68421052631579
5457,2658,-6488,11,10,21,52.38,-0.002757142857142856,20.666666666666668
5460,1679,6761,13,7,20,65.0,0.023614999999999994,51.3
5464,3000,-6140,11,13,24,45.83,-0.0143,48.375
5465,1414,-674,11,10,21,52.38,-0.005057142857142859,23.80952380952381
5468,2013,4427,17,13,30,56.67,0.003806666666666665,20.7
5474,6520,29210,13,7,20,65.0,0.023815000000000003,21.25
5475,1965,8775,19,9,28,67.86,0.026260714285714287,21.75
5478,9719,44801,14,8,22,63.64,0.021459090909090914,32.0
5481,1741,13889,14,5,19,73.68,0.04117894736842105,26.736842105263158
5483,8550,4360,11,8,19,57.89,0.009952631578947371,23.05263157894737
5487,1547,-1937,7,7,14,50.0,-0.00620714285714286,60.857142857142854
5488,1291,-281,9,11,20,45.0,-0.018430000000000002,33.9
5489,4683,8127,12,10,22,54.55,0.0032090909090909127,72.04545454545455
5490,3642,10308,12,9,21,57.14,0.008357142857142856,26.61904761904762
5493,2069,-3619,8,7,15,53.33,0.0006533333333333326,101.33333333333333
5498,1677,-5217,10,15,25,40.0,-0.028399999999999998,29.12
5508,3449,9211,8,6,14,57.14,0.008428571428571428,79.71428571428571
5511,1754,-7564,6,10,16,37.5,-0.03187500000000001,70.125
5512,1686,-1206,11,11,22,50.0,-0.007140909090909089,56.68181818181818
5514,1176,-986,7,7,14,50.0,-0.006657142857142857,25.142857142857142
5516,1061,-6541,4,11,15,26.67,-0.05390666666666666,50.6
5520,1425,-3775,6,6,12,50.0,-0.005999999999999994,124.33333333333333
5523,2094,3646,14,13,27,51.85,-0.00022962962962963082,47.77777777777778
5529,2199,13381,16,8,24,66.67,0.02613333333333333,23.5
5530,4140,10170,7,6,13,53.85,0.007253846153846152,78.0
5536,5693,-21073,3,4,7,42.86,-0.020157142857142856,60.42857142857143
5543,1023,2577,2,3,5,40.0,-0.009260000000000001,112.2
5601,2013,-4903,7,10,17,41.18,-0.027505882352941175,62.76470588235294
5603,1337,43,10,7,17,58.82,0.006464705882352943,60.411764705882355
5604,1696,15694,6,3,9,66.67,0.027466666666666664,51.77777777777778
5609,1301,2769,6,6,12,50.0,-0.0058583333333333334,90.83333333333333
5701,1021,-4041,8,9,17,47.06,-0.018964705882352943,52.1764705882353
5703,892,-22,4,3,7,57.14,0.008485714285714287,89.14285714285714
5704,2869,-22689,6,15,21,28.57,-0.04881428571428571,69.80952380952381
5864,696,1334,5,5,10,50.0,-0.007879999999999998,80.1
5878,1044,-15134,0,4,4,0.0,-0.08784999999999998,355.25
5902,1439,-1029,11,7,18,61.11,0.014283333333333334,49.388888888888886
5903,9026,-44766,3,8,11,27.27,-0.04487272727272728,130.9090909090909
5904,18827,-222927,6,11,17,35.29,-0.03530588235294118,50.11764705882353
5905,1810,1240,11,11,22,50.0,-0.006977272727272726,28.59090909090909
6015,1394,-2654,9,13,22,40.91,-0.027322727272727266,32.95454545454545
6016,1007,2993,9,6,15,60.0,0.012113333333333332,26.666666666666668
6020,1088,-4068,5,7,12,41.67,-0.022699999999999998,114.25
6021,1083,1697,7,7,14,50.0,-0.0017357142857142868,60.5
6023,2072,-20322,2,7,9,22.22,-0.06147777777777778,265.22222222222223
6026,500,-1210,3,4,7,42.86,-0.021442857142857135,38.142857142857146
6101,2643,23147,17,6,23,73.91,0.0405,13.08695652173913
6103,2034,2286,8,11,19,42.11,-0.02745263157894737,18.63157894736842
6104,5512,20348,12,7,19,63.16,0.020473684210526318,15.631578947368421
6109,1473,337,11,10,21,52.38,-0.0027714285714285697,47.19047619047619
6111,2757,8183,9,6,15,60.0,0.013713333333333333,24.0
6113,1724,11496,17,7,24,70.83,0.03383333333333333,28.791666666666668
6114,539,-25699,4,4,8,50.0,-0.8407125,685.25
6118,1875,-155,12,9,21,57.14,0.00752380952380952,24.761904761904763
6121,8596,-43496,4,6,10,40.0,-0.025879999999999997,52.0
6122,1137,-147,8,7,15,53.33,-0.0004599999999999984,44.4
6123,1966,9084,9,5,14,64.29,0.020435714285714286,30.928571428571427
6124,4038,16752,16,10,26,61.54,0.017223076923076924,29.576923076923077
6125,1876,-10266,4,10,14,28.57,-0.04913571428571428,23.214285714285715
6126,1355,3405,8,4,12,66.67,0.027225,30.833333333333332
6127,1508,7432,13,7,20,65.0,0.022924999999999997,18.0
6129,2490,23030,17,3,20,85.0,0.06007999999999998,15.25
6130,4340,31020,16,6,22,72.73,0.034340909090909096,25.545454545454547
6134,3502,17838,16,9,25,64.0,0.021403999999999996,31.68
6138,4868,9262,10,8,18,55.56,0.005233333333333333,11.0
6140,937,-4037,5,7,12,41.67,-0.023591666666666664,43.5
6143,5492,11268,11,11,22,50.0,-0.005909090909090909,26.954545454545453
6144,1014,-1374,8,7,15,53.33,-0.0011066666666666668,69.93333333333334
6146,5982,-14772,5,7,12,41.67,-0.022574999999999998,101.0
6147,2642,2268,7,6,13,53.85,0.001730769230769228,16.23076923076923
6148,1500,6220,18,7,25,72.0,0.033008,29.68
6150,6377,-12997,15,9,24,62.5,0.018874999999999996,12.416666666666666
6151,1906,5414,8,5,13,61.54,0.017069230769230767,78.46153846153847
6154,2142,10038,9,5,14,64.29,0.02267857142857143,142.57142857142858
6156,1768,2322,16,6,22,72.73,0.03395454545454545,11.727272727272727
6158,3639,3491,13,10,23,56.52,0.007113043478260868,28.26086956521739
6160,3853,-29463,7,13,20,35.0,-0.03594499999999999,25.05
6161,1833,-273,11,12,23,47.83,-0.011595652173913043,21.82608695652174
6163,1384,2696,10,8,18,55.56,0.004122222222222223,24.61111111111111
6167,1471,7649,17,8,25,68.0,0.022355999999999997,31.52
6169,4759,-35099,11,17,28,39.29,-0.027585714285714286,21.75
6170,2217,15523,11,7,18,61.11,0.016027777777777776,30.22222222222222
6171,1543,7,9,10,19,47.37,-0.012089473684210527,43.8421052631579
6173,2818,-1418,9,11,20,45.0,-0.01694,22.2
6174,1737,533,12,10,22,54.55,0.0013272727272727269,32.22727272727273
6175,2182,4508,13,11,24,54.17,0.0008708333333333323,19.583333333333332
6179,3242,2688,12,11,23,52.17,-0.002308695652173911,42.91304347826087
6180,6079,-31079,11,18,29,37.93,-0.030093103448275857,24.24137931034483
6182,2894,20466,10,5,15,66.67,0.02716,32.333333333333336
6185,2205,12785,12,6,18,66.67,0.027388888888888886,35.333333333333336
6186,2582,29008,21,3,24,87.5,0.0686,32.291666666666664
6187,6071,-7891,11,15,26,42.31,-0.021334615384615382,19.576923076923077
6188,5731,8209,13,9,22,59.09,0.01234090909090909,26.5
6190,1680,10540,16,6,22,72.73,0.03768636363636364,30.59090909090909
6194,2617,-3917,8,9,17,47.06,-0.011888235294117647,90.47058823529412
6195,3935,10435,14,7,21,66.67,0.030309523809523807,40.666666666666664
6198,2573,9737,17,12,29,58.62,0.010062068965517241,22.620689655172413
6199,2197,10863,16,8,24,66.67,0.026637499999999995,20.416666666666668
6203,3234,-3454,5,9,14,35.71,-0.03447857142857143,79.14285714285714
6204,3563,11477,12,10,22,54.55,0.0031863636363636347,56.36363636363637
6207,1971,12049,10,5,15,66.67,0.027393333333333315,36.2
6208,1678,1462,8,8,16,50.0,-0.006256249999999998,36.625
6210,2688,3712,10,6,16,62.5,0.015012499999999998,55.0
6212,1831,3719,10,5,15,66.67,0.025860000000000005,70.6
6217,2392,14368,12,7,19,63.16,0.019305263157894742,17.105263157894736
6218,2525,7395,12,8,20,60.0,0.014154999999999997,44.95
6219,1478,7252,14,6,20,70.0,0.030779999999999995,42.55
6220,1497,3533,9,6,15,60.0,0.013746666666666666,27.066666666666666
6221,1600,-1240,7,6,13,53.85,0.000984615384615386,48.38461538461539
6222,1426,-1206,11,10,21,52.38,-0.003852380952380948,27.0
6223,6976,44594,11,5,16,68.75,0.03169375,23.375
6227,2442,-6052,9,12,21,42.86,-0.020390476190476195,39.904761904761905
6228,1657,8263,16,8,24,66.67,0.025150000000000002,17.666666666666668
6229,1807,11283,14,5,19,73.68,0.0411578947368421,36.78947368421053
6231,7699,-30369,10,12,22,45.45,-0.014954545454545453,17.545454545454547
6233,2301,2199,9,8,17,52.94,-0.0004411764705882357,29.41176470588235
6234,3147,-15177,7,15,22,31.82,-0.04240000000000001,33.90909090909091
6236,2647,14083,16,9,25,64.0,0.019720000000000005,13.64
6237,5851,23789,8,8,16,50.0,-0.005856250000000002,15.75
6240,395,-17345,3,3,6,50.0,-0.5215,965.3333333333334
6241,1844,-3814,8,11,19,42.11,-0.023942105263157893,28.36842105263158
6242,2865,-4965,7,8,15,46.67,-0.013453333333333333,48.666666666666664
6244,8488,-80418,10,12,22,45.45,-0.015263636363636363,15.727272727272727
6245,2271,619,7,5,12,58.33,0.010683333333333336,24.666666666666668
6246,2144,9186,17,11,28,60.71,0.009314285714285714,27.357142857142858
6248,2752,9518,18,11,29,62.07,0.017010344827586205,22.586206896551722
6259,2277,13923,21,9,30,70.0,0.030806666666666663,18.866666666666667
6261,3495,7095,6,5,11,54.55,0.0032454545454545475,65.54545454545455
6263,4157,-25457,6,12,18,33.33,-0.0393,58.666666666666664
6264,2084,2176,14,11,25,56.0,0.003711999999999999,44.36
6265,1427,-2767,8,10,18,44.44,-0.018044444444444446,31.61111111111111
6266,1627,-5487,9,11,20,45.0,-0.01747,37.95
6270,2276,-1456,8,8,16,50.0,-0.006268750000000001,42.625
6274,2390,15040,8,6,14,57.14,0.00802857142857143,26.357142857142858
6275,1537,-187,9,7,16,56.25,0.006137499999999999,37.6875
6276,1880,8130,13,8,21,61.9,0.015919047619047617,21.952380952380953
6279,4809,-22869,6,10,16,37.5,-0.0309125,50.0625
6284,1695,3535,6,6,12,50.0,-0.0059416666666666645,7.166666666666667
6287,1556,-2926,12,14,26,46.15,-0.018846153846153846,20.384615384615383
6290,3946,1734,14,10,24,58.33,0.010679166666666661,23.083333333333332
6291,1987,11333,13,10,23,56.52,0.0025130434782608675,16.043478260869566
6292,2543,-11143,7,11,18,38.89,-0.028333333333333335,66.0
6294,705,-105475,8,2,10,80.0,-7.84281,557.6
6404,1663,-713,5,6,11,45.45,-0.016536363636363637,14.272727272727273
6411,3919,-13339,3,4,7,42.86,-0.020185714285714283,21.285714285714285
6417,1068,-5288,2,2,4,50.0,-0.005874999999999998,87.25
6418,1214,14396,10,2,12,83.33,0.0608,73.0
6419,1326,1194,7,5,12,58.33,0.009933333333333332,46.5
6425,2184,22326,9,3,12,75.0,0.044183333333333324,34.083333333333336
6426,3519,-24759,3,6,9,33.33,-0.03924444444444444,13.0
6432,930,2140,3,3,6,50.0,-0.005899999999999998,27.0
6435,1784,8136,2,1,3,66.67,0.02753333333333333,13.333333333333334
6441,3578,34162,9,3,12,75.0,0.04423333333333335,41.25
6446,4748,25452,2,2,4,50.0,-0.005850000000000001,82.75
6457,3243,35137,8,2,10,80.0,0.04898999999999999,39.1
6461,2586,16474,8,4,12,66.67,0.02755,34.583333333333336
6462,5739,45521,4,2,6,66.67,0.027533333333333337,11.333333333333334
6465,3043,-2753,6,6,12,50.0,-0.005866666666666669,35.916666666666664
6469,1319,8981,2,1,3,66.67,0.02753333333333333,95.0
6470,910,8740,3,1,4,75.0,0.0442,25.25
6472,1893,24507,2,1,3,66.67,0.02753333333333333,16.333333333333332
6482,1860,4510,4,4,8,50.0,-0.005887500000000004,63.375
6485,1035,3345,3,2,5,60.0,0.01414,35.0
6486,1738,1742,3,2,5,60.0,0.014160000000000002,121.2
6488,4273,43907,1,2,3,33.33,-0.039233333333333335,23.666666666666668
6492,4780,24010,6,4,10,60.0,0.014179999999999998,56.5
6494,2106,-13126,3,3,6,50.0,-0.005866666666666663,27.333333333333332
6496,1024,8436,3,1,4,75.0,0.044225,213.0
6499,4529,12821,5,4,9,55.56,0.005277777777777778,26.0
6506,847,-2527,4,5,9,44.44,-0.022,101.55555555555556
6508,2003,6037,7,5,12,58.33,0.0057666666666666665,72.75
6509,2221,10859,12,6,18,66.67,0.027283333333333333,44.611111111111114
6510,21163,53687,4,3,7,57.14,0.008457142857142854,20.142857142857142
6512,1259,3451,5,4,9,55.56,0.005222222222222219,71.0
6514,1673,12967,5,2,7,71.43,0.03708571428571428,44.285714285714285
6516,2651,23319,3,1,4,75.0,0.044225,21.5
6523,1442,7558,2,1,3,66.67,0.02753333333333333,34.333333333333336
6527,1096,-526,2,2,4,50.0,-0.005875000000000002,113.75
6530,486,-2536,2,3,5,40.0,-0.02604,46.0
6532,530,-9370,0,2,2,0.0,-0.106,32.0
6535,1675,-335,4,4,8,50.0,-0.005925,38.75
6538,3220,12550,5,3,8,62.5,0.0191875,31.0
6542,3291,8499,6,4,10,60.0,0.014179999999999998,21.6
6547,2416,-12806,2,2,4,50.0,-0.023199999999999995,125.5
6548,1733,28657,3,0,3,100.0,0.09426666666666667,13.333333333333334
6556,2031,8119,4,3,7,57.14,0.008414285714285718,61.42857142857143
6560,1976,10924,5,2,7,71.43,0.03705714285714286,21.142857142857142
6561,3931,34069,2,1,3,66.67,0.02753333333333333,64.0
6568,4517,49183,4,1,5,80.0,0.05424,20.0
6569,5171,-26821,2,4,6,33.33,-0.039233333333333335,83.5
6570,1706,3154,5,4,9,55.56,0.005255555555555555,54.111111111111114
6574,4183,837,4,3,7,57.14,0.00844285714285714,98.42857142857143
6576,3184,-1514,4,3,7,57.14,-0.0026428571428571417,23.571428571428573
6577,1815,-7155,2,3,5,40.0,-0.025880000000000004,84.4
6578,691,-2701,2,3,5,40.0,-0.02596,74.4
6588,568,-10048,0,2,2,0.0,-0.106,23.0
6589,604,336,2,1,3,66.67,0.02753333333333333,41.666666666666664
6590,297,-5247,0,1,1,0.0,-0.106,2.0
6593,580,9570,3,0,3,100.0,0.09426666666666667,66.0
6596,1557,6063,3,2,5,60.0,0.014179999999999998,126.2
6603,1320,2160,9,7,16,56.25,0.0010624999999999975,27.8125
6609,2558,-32078,3,15,18,16.67,-0.07268333333333335,60.55555555555556
6612,2726,-4966,3,3,6,50.0,-0.018983333333333335,65.5
6613,4567,10183,3,2,5,60.0,0.014179999999999998,86.6
6615,2858,29222,6,2,8,75.0,0.044225,99.75
6616,1267,-4067,5,6,11,45.45,-0.015090909090909089,37.45454545454545
6624,814,-194,2,2,4,50.0,-0.005800000000000003,68.5
6629,1705,13645,4,1,5,80.0,0.04698,109.8
6640,1068,-278,1,1,2,50.0,-0.005850000000000001,70.5
6642,399,-7059,0,1,1,0.0,-0.106,9.0
6643,1746,28854,1,0,1,100.0,0.0943,41.0
6649,535,2645,2,1,3,66.67,0.02753333333333333,72.0
6651,985,745,1,1,2,50.0,-0.005850000000000001,9.5
6654,2818,4582,5,4,9,55.56,0.000777777777777777,29.555555555555557
6661,148,2442,1,0,1,100.0,0.0943,145.0
6662,776,634,2,2,4,50.0,-0.005825000000000004,195.5
6664,356,5864,1,0,1,100.0,0.0943,16.0
6667,348,-6148,0,1,1,0.0,-0.106,64.0
6679,1650,27250,1,0,1,100.0,0.0943,4.0
6680,689,11391,2,0,2,100.0,0.0943,98.5
6683,0,0,0,0,0,0.0,,
6690,2123,14577,2,1,3,66.67,0.02753333333333333,63.666666666666664
6697,444,46,1,1,2,50.0,-0.005850000000000001,63.0
6703,493,-8713,0,1,1,0.0,-0.106,33.0
6712,983,-17383,0,1,1,0.0,-0.106,29.0
6716,2217,-21537,1,3,4,25.0,-0.055925,31.5
6727,824,-434,1,1,2,50.0,-0.005850000000000001,29.5
6728,0,0,0,0,0,0.0,,
6732,7684,86066,3,1,4,75.0,0.044225,22.5
6733,417,2163,2,1,3,66.67,0.02753333333333333,44.0
6747,2776,45874,2,0,2,100.0,0.0943,37.0
6751,1751,-881,3,2,5,60.0,0.014140000000000005,36.2
6752,318,-5618,0,1,1,0.0,-0.106,135.0
6762,0,0,0,0,0,0.0,,
6767,175,-3085,0,1,1,0.0,-0.1058,17.0
6803,4742,-83892,0,4,4,0.0,-0.106,436.5
7402,3040,6560,6,5,11,54.55,0.003245454545454545,34.27272727272727
7556,659,-11659,0,1,1,0.0,-0.106,25.0
8024,2753,4997,10,10,20,50.0,-0.006135,29.75
8027,1388,-8198,3,4,7,42.86,-0.020242857142857142,34.57142857142857
8032,2239,-10959,6,11,17,35.29,-0.03584117647058823,81.29411764705883
8034,1510,-2490,10,11,21,47.62,-0.012423809523809524,23.19047619047619
8038,1983,-19823,2,6,8,25.0,-0.055925,22.375
8040,2711,-4241,11,12,23,47.83,-0.011399999999999999,29.956521739130434
8042,2999,12141,10,8,18,55.56,0.0051111111111111105,28.77777777777778
8043,1722,-4932,7,7,14,50.0,-0.006192857142857141,19.285714285714285
8044,13290,-12930,13,10,23,56.52,0.007213043478260869,21.26086956521739
8047,1872,-1952,9,14,23,39.13,-0.023804347826086956,52.21739130434783
8048,2221,-8231,5,8,13,38.46,-0.028984615384615386,43.15384615384615
8049,1777,9493,15,6,21,71.43,0.03558095238095238,21.61904761904762
8050,5853,30637,13,6,19,68.42,0.03102631578947368,34.68421052631579
8054,2722,18628,8,3,11,72.73,0.039663636363636366,37.27272727272727
8059,1336,-3086,8,10,18,44.44,-0.018261111111111113,30.444444444444443
8064,2216,854,11,10,21,52.38,-0.0014095238095238089,18.523809523809526
8066,3048,7422,9,6,15,60.0,0.006946666666666668,23.466666666666665
8067,1422,-2612,8,13,21,38.1,-0.03370476190476191,37.38095238095238
8068,5285,10605,18,13,31,58.06,0.009677419354838708,14.96774193548387
8069,3250,-28780,6,8,14,42.86,-0.020342857142857138,23.928571428571427
8071,1932,8578,12,7,19,63.16,0.018689473684210523,25.157894736842106
8074,2504,5626,13,10,23,56.52,0.006895652173913044,57.65217391304348
8076,12405,42545,11,6,17,64.71,0.023588235294117646,29.705882352941178
8077,1941,1649,15,9,24,62.5,0.013041666666666665,33.291666666666664
8080,1985,7665,11,10,21,52.38,-0.0036047619047619023,16.714285714285715
8083,7170,-9900,7,6,13,53.85,0.0018461538461538468,164.3846153846154
8084,4228,8332,15,11,26,57.69,0.009119230769230768,35.07692307692308
8085,1815,-945,13,10,23,56.52,0.004247826086956516,25.73913043478261
8086,4557,-22357,6,8,14,42.86,-0.020207142857142858,12.642857142857142
8087,1256,354,6,10,16,37.5,-0.03256875,38.6875
8088,1939,4011,11,8,19,57.89,0.008968421052631582,14.947368421052632
8089,418,3682,5,0,5,100.0,0.07428,42.8
8091,2272,-21882,3,9,12,25.0,-0.05594166666666667,21.166666666666668
8092,1606,4334,12,8,20,60.0,0.013005,32.4
8093,1634,14606,15,6,21,71.43,0.03484761904761905,21.428571428571427
8096,2398,10832,13,9,22,59.09,0.011818181818181816,16.681818181818183
8097,2140,-13470,11,10,21,52.38,-0.0026619047619047577,22.38095238095238
8099,2323,14897,12,5,17,70.59,0.03534705882352942,32.0
8107,2052,5118,11,7,18,61.11,0.021849999999999998,26.5
8109,3497,9093,7,5,12,58.33,0.010841666666666666,83.16666666666667
8111,2143,-8323,10,12,22,45.45,-0.016849999999999997,26.363636363636363
8121,3777,11133,14,7,21,66.67,0.027171428571428572,15.19047619047619
8147,1769,-219,4,4,8,50.0,-0.0058625,51.625
8155,2959,-749,5,3,8,62.5,0.0191625,22.25
8171,1856,-20616,4,10,14,28.57,-0.05522142857142857,20.214285714285715
8176,629,-3429,3,6,9,33.33,-0.0407,24.333333333333332
8182,1919,15761,11,4,15,73.33,0.0407,29.2
8183,2070,4740,13,8,21,61.9,0.020457142857142858,22.142857142857142
8234,2826,-15076,6,10,16,37.5,-0.030981250000000002,45.1875
8240,4288,8382,8,9,17,47.06,-0.011811764705882355,31.41176470588235
8255,9268,-57488,6,11,17,35.29,-0.03530588235294118,48.35294117647059
8277,1784,9176,12,7,19,63.16,0.01857368421052631,21.63157894736842
8279,3484,-18024,2,4,6,33.33,-0.039233333333333335,40.166666666666664
8284,2059,4831,5,3,8,62.5,0.019175,89.125
8289,931,799,6,6,12,50.0,-0.006516666666666666,49.333333333333336
8291,567,63,5,5,10,50.0,-0.002460000000000003,24.7
8299,13481,40769,6,6,12,50.0,-0.005849999999999998,19.833333333333332
8342,564,-994,1,1,2,50.0,-0.0058999999999999955,243.0
8349,4293,44307,9,6,15,60.0,0.014166666666666664,81.06666666666666
8354,1846,-2646,9,10,19,47.37,-0.011457894736842108,87.84210526315789
8358,2734,-9684,8,8,16,50.0,-0.006299999999999997,52.1875
8383,2546,-9556,6,9,15,40.0,-0.02985333333333333,45.46666666666667
8390,2554,5066,8,8,16,50.0,-0.005925,27.6875
8401,1736,-5166,7,10,17,41.18,-0.028605882352941175,69.76470588235294
8403,1622,6108,5,3,8,62.5,0.019125,56.5
8409,1376,924,5,5,10,50.0,-0.005849999999999999,50.4
8410,2344,-1244,7,6,13,53.85,0.0018461538461538468,47.46153846153846
8415,926,1524,3,2,5,60.0,0.0044399999999999995,122.0
8416,5637,-53137,2,6,8,25.0,-0.055925,70.375
8418,1150,11770,6,2,8,75.0,0.043887499999999996,68.125
8420,518,-3578,1,3,4,25.0,-0.055975,57.0
8421,1015,-5895,4,8,12,33.33,-0.0397,58.25
8423,2129,-9459,6,10,16,37.5,-0.03093125,45.75
8424,1847,-22007,1,6,7,14.29,-0.07744285714285715,90.71428571428571
8426,1626,3514,5,5,10,50.0,-0.005830000000000004,23.6
8431,2064,-5534,3,4,7,42.86,-0.020157142857142856,16.428571428571427
8432,4886,19194,8,5,13,61.54,0.01724615384615385,61.23076923076923
8433,3375,47775,6,1,7,85.71,0.06568571428571428,45.857142857142854
8435,1433,3477,3,2,5,60.0,0.01416,202.8
8436,7181,103889,5,1,6,83.33,0.06091666666666667,32.5
8437,6971,74479,7,1,8,87.5,0.06561249999999999,97.75
8440,1799,-6689,4,6,10,40.0,-0.025869999999999994,54.6
8444,4125,42905,5,2,7,71.43,0.037071428571428575,69.85714285714286
8446,6299,-27869,4,7,11,36.36,-0.03316363636363636,45.0
8450,2663,3707,6,5,11,54.55,0.003209090909090909,42.45454545454545
8455,1097,-13627,1,5,6,16.67,-0.07263333333333333,39.5
8472,2771,14799,7,4,11,63.64,0.017454545454545452,56.72727272727273
8476,1842,11458,6,4,10,60.0,0.014140000000000003,37.7
8477,2408,3432,6,4,10,60.0,0.014179999999999998,40.3
8489,5963,-1353,6,5,11,54.55,0.003227272727272726,17.0
8905,1621,789,8,8,16,50.0,-0.006012499999999999,94.4375
8906,1140,-2790,8,9,17,47.06,-0.014682352941176473,51.05882352941177
8908,1384,2946,5,3,8,62.5,0.007649999999999999,120.625
8916,2151,-10241,4,10,14,28.57,-0.04953571428571426,46.714285714285715
8917,2071,-2891,3,4,7,42.86,-0.028285714285714286,228.42857142857142
8921,1163,387,7,7,14,50.0,-0.006485714285714285,113.28571428571429
8923,1328,-23328,0,14,14,0.0,-0.10619285714285716,141.21428571428572
8924,3200,22020,10,5,15,66.67,0.027453333333333337,61.86666666666667
8927,1726,-9886,6,13,19,31.58,-0.04317894736842105,76.89473684210526
8928,2616,-6676,13,11,24,54.17,-0.0008500000000000001,46.083333333333336
8929,3407,-20247,9,13,22,40.91,-0.028540909090909092,43.77272727272727
8930,1251,6269,12,5,17,70.59,0.034394117647058825,59.94117647058823
8931,1395,-4545,4,7,11,36.36,-0.03381818181818182,104.54545454545455
8932,938,1632,7,6,13,53.85,0.0002615384615384605,38.84615384615385
8933,1924,1126,11,13,24,45.83,-0.015020833333333332,36.791666666666664
8935,1539,-339,13,12,25,52.0,-0.005367999999999997,19.84
8936,2763,9367,14,7,21,66.67,0.027076190476190483,28.666666666666668
8937,1902,-1722,8,13,21,38.1,-0.03012857142857143,46.95238095238095
8938,5737,17203,14,9,23,60.87,0.015895652173913043,52.65217391304348
8941,7046,42104,17,7,24,70.83,0.034687499999999996,35.583333333333336
8942,5150,-14640,7,10,17,41.18,-0.023511764705882354,54.588235294117645
9949,2539,-9479,9,12,21,42.86,-0.020428571428571424,57.523809523809526
9950,1440,3460,8,5,13,61.54,0.017053846153846156,108.76923076923077
9951,4892,15628,8,6,14,57.14,0.008457142857142858,47.285714285714285
9960,2113,-6773,7,9,16,43.75,-0.0144625,76.6875
9962,1351,-4031,8,9,17,47.06,-0.016182352941176467,55.11764705882353
4148,1040,-18390,0,3,3,0.0,-0.106,22.0
6781,10272,31128,1,1,2,50.0,-0.005850000000000001,29.5
6776,460,-8140,0,2,2,0.0,-0.10605,104.0
2211,287,-5087,0,1,1,0.0,-0.106,50.0
6768,392,4508,1,0,1,100.0,0.0659,82.0
3357,1531,11639,4,3,7,57.14,0.008385714285714286,347.42857142857144
6741,1233,4747,1,1,2,50.0,-0.005850000000000001,13.5
2250,2734,-19034,1,4,5,20.0,-0.0459,20.6
5236,1605,-14925,1,3,4,25.0,-0.055925,6.5
1522A,255,-1355,0,1,1,0.0,-0.0312,268.0
6684,1486,15344,3,1,4,75.0,0.04425,7.5
2753,764,-13514,0,1,1,0.0,-0.106,90.0
2348A,212,3088,1,0,1,100.0,0.0835,413.0
6790,456,7534,2,0,2,100.0,0.0943,32.5
6788,1043,-18443,0,1,1,0.0,-0.106,6.0
2947,1155,16145,2,0,2,100.0,0.0793,185.0
4440,169,-19,0,1,1,0.0,-0.0007,8.0
5222,615,3965,3,1,4,75.0,0.04425,48.0
2881C,0,0,0,0,0,0.0,,
6761,685,11315,1,0,1,100.0,0.0943,36.0
6806,588,-10388,0,1,1,0.0,-0.106,4.0
2945,621,10259,2,0,2,100.0,0.0943,41.5
6770,533,3267,2,1,3,66.67,0.027466666666666664,20.666666666666668
6792,0,0,0,0,0,0.0,,
4770,1582,-27982,0,1,1,0.0,-0.106,14.0
2883B,130,1320,2,0,2,100.0,0.07769999999999999,201.0
6691,0,0,0,0,0,0.0,,
3592,10487,82223,6,5,11,54.55,0.003245454545454544,25.818181818181817
6719,3231,-4731,1,1,2,50.0,-0.005850000000000001,16.0
2756,0,0,0,0,0,0.0,,
5244,673,6607,6,2,8,75.0,0.042662500000000006,75.375
6693,368,-6518,0,1,1,0.0,-0.106,8.0
8112A,0,0,0,0,0,0.0,,
8438,1009,1,3,3,6,50.0,-0.005916666666666665,68.66666666666667
6829,0,0,0,0,0,0.0,,
4923,820,-17980,2,3,5,40.0,-0.22182000000000004,816.0
6763,2996,49504,1,0,1,100.0,0.0943,7.0
4558,415,1275,2,2,4,50.0,-0.005875000000000002,68.75
3349,1547,2613,9,7,16,56.25,0.00614375,181.0625
6804,622,-11002,0,2,2,0.0,-0.106,31.0
4768,0,0,0,0,0,0.0,,
6807,0,0,0,0,0,0.0,,
6721,261,-4631,0,1,1,0.0,-0.106,138.0
6735,382,6318,1,0,1,100.0,0.0943,14.0
4583,0,0,0,0,0,0.0,,
6799,711,-12561,0,1,1,0.0,-0.106,5.0
6585,357,5913,1,0,1,100.0,0.0943,70.0
5228,524,996,2,2,4,50.0,-0.00595,507.0
6546,312,2308,2,1,3,66.67,0.027733333333333336,44.666666666666664
6796,0,0,0,0,0,0.0,,
6550,1366,10664,3,2,5,60.0,0.01414,32.0
4577,0,0,0,0,0,0.0,,
6789,0,0,0,0,0,0.0,,
6823,508,-8968,0,1,1,0.0,-0.106,21.0
2887Z1,98,-448,0,1,1,0.0,-0.0272,240.0
6811,0,0,0,0,0,0.0,,
6854,0,0,0,0,0,0.0,,
3715,0,0,0,0,0,0.0,,
6830,0,0,0,0,0,0.0,,
6834,0,0,0,0,0,0.0,,
3430,866,2664,4,3,7,57.14,0.008471428571428569,87.0
6689,0,0,0,0,0,0.0,,
6592A,0,0,0,0,0,0.0,,
4584,277,3223,1,0,1,100.0,0.0669,22.0
6855,0,0,0,0,0,0.0,,
4951,436,2104,3,2,5,60.0,0.01326,65.2
6695,0,0,0,0,0,0.0,,
6835,249,-4399,0,1,1,0.0,-0.1059,13.0
6791,619,-10969,0,1,1,0.0,-0.106,14.0
6843,0,0,0,0,0,0.0,,
6782,1088,-19238,0,1,1,0.0,-0.106,4.0
6859,819,-14469,0,1,1,0.0,-0.106,7.0
6874,0,0,0,0,0,0.0,,
3447,274,-4844,0,1,1,0.0,-0.1061,19.0
6517,519,4721,6,1,7,85.71,0.06432857142857143,16.428571428571427
8227,580,-163130,1,4,5,20.0,-3.3308600000000004,1268.4
6708,577,223,1,1,2,50.0,-0.0059000000000000025,5.0
6865,0,0,0,0,0,0.0,,
6841,0,0,0,0,0,0.0,,
6873,730,12070,1,0,1,100.0,0.0943,17.0
6753,0,0,0,0,0,0.0,,
2645,0,0,0,0,0,0.0,,
6869,541,1859,1,0,1,100.0,0.02,15.0
6863,0,0,0,0,0,0.0,,
6606,526,-4946,1,6,7,14.29,-0.07854285714285714,25.0
6840,383,-83,0,1,1,0.0,-0.0013,41.0
6861,0,0,0,0,0,0.0,,
2432,445,7305,3,0,3,100.0,0.0942,18.0
6584,579,9571,1,0,1,100.0,0.0943,2242.0
6821,0,0,0,0,0,0.0,,
6846,0,0,0,0,0,0.0,,
6657,0,0,0,0,0,0.0,,
6877,0,0,0,0,0,0.0,,
2073,0,0,0,0,0,0.0,,
6902,0,0,0,0,0,0.0,,
4569,0,0,0,0,0,0.0,,
